acc,start,end,strand,chromosome,species,symbol,name,length
NP_032138.3,3538298,3565142,1,13,Mus_musculus,Gdi2,rab GDP dissociation inhibitor beta,26844
NP_598824.3,3566663,3599964,-1,13,Mus_musculus,Fam208b,protein FAM208B,33301
NP_001254653.1,3634132,3650215,1,13,Mus_musculus,Asb13,ankyrin repeat and SOCS box protein 13 isoform 3,16083
NP_081692.1,3803753,3804203,-1,13,Mus_musculus,Calml3,calmodulin-like protein 3,450
NP_064420.2,3837895,3838342,1,13,Mus_musculus,Calm4,calmodulin-4,447
NP_001008706.1,3854267,3854730,1,13,Mus_musculus,Calm5,calmodulin 5,463
NP_001040624.1,3884069,3893385,-1,13,Mus_musculus,Net1,neuroepithelial cell-transforming gene 1 protein isoform 2,9316
NP_001029051.2,3924734,3933562,1,13,Mus_musculus,Tubal3,tubulin alpha chain-like 3,8828
NP_112540.2,3941155,3941650,-1,13,Mus_musculus,Ucn3,urocortin-3 precursor,495
NP_598833.1,4059631,4088990,1,13,Mus_musculus,Akr1c14,3-alpha-hydroxysteroid dehydrogenase,29359
NP_598827.1,4132793,4150598,-1,13,Mus_musculus,Akr1c18,aldo-keto reductase family 1 member C18,17805
NP_038806.2,4191226,4205383,1,13,Mus_musculus,Akr1c13,aldo-keto reductase family 1 member C13,14157
NP_001013807.2,4233770,4248120,1,13,Mus_musculus,Akr1c19,"aldo-keto reductase family 1, member C19",14350
NP_038805.2,4268387,4279356,-1,13,Mus_musculus,Akr1c12,"aldo-keto reductase family 1, member C12",10969
NP_085114.1,4434390,4457191,1,13,Mus_musculus,Akr1c6,estradiol 17 beta-dehydrogenase 5,22801
NP_001298061.1,4487182,4523314,-1,13,Mus_musculus,Akr1c20,"aldo-keto reductase family 1, member C20 isoform 1",36132
NP_084177.2,4574148,4586380,1,13,Mus_musculus,Akr1c21,aldo-keto reductase family 1 member C21,12232
NP_061347.2,4593255,4609123,-1,13,Mus_musculus,Akr1e1,"1,5-anhydro-D-fructose reductase",15868
NP_035933.2,5861638,5867283,1,13,Mus_musculus,Klf6,Krueppel-like factor 6,5645
NP_660113.1,6548173,6579743,1,13,Mus_musculus,Pitrm1,"presequence protease, mitochondrial precursor",31570
NP_001278000.1,6581459,6648679,-1,13,Mus_musculus,Pfkp,"ATP-dependent 6-phosphofructokinase, platelet type isoform 2",67220
NP_001276459.1,8203220,8757275,1,13,Mus_musculus,Adarb2,double-stranded RNA-specific editase B2 isoform 2,554055
NP_766033.1,8805814,8861225,-1,13,Mus_musculus,Wdr37,WD repeat-containing protein 37 isoform a,55411
NP_663335.2,8885859,8890635,1,13,Mus_musculus,Idi1,isopentenyl-diphosphate Delta-isomerase 1,4776
NP_796171.1,8956810,8959432,1,13,Mus_musculus,Idi2,isopentenyl-diphosphate delta-isomerase 2,2622
NP_081276.2,8973121,8995996,-1,13,Mus_musculus,Gtpbp4,nucleolar GTP-binding protein 1,22875
NP_766173.1,9122145,9170942,1,13,Mus_musculus,Larp4b,la-related protein 4B isoform 1,48797
NP_001074895.2,9276981,9666030,1,13,Mus_musculus,Dip2c,disco-interacting protein 2 homolog C,389049
NP_653099.2,9686861,9735447,-1,13,Mus_musculus,Zmynd11,zinc finger MYND domain-containing protein 11 isoform alpha,48586
NP_150372.1,9877228,9878998,-1,13,Mus_musculus,Chrm3,muscarinic acetylcholine receptor M3,1770
NP_076357.2,11554515,12106446,-1,13,Mus_musculus,Ryr2,ryanodine receptor 2,551931
NP_001074597.1,12187004,12253973,-1,13,Mus_musculus,Mtr,methionine synthase,66969
NP_150371.4,12269493,12340500,-1,13,Mus_musculus,Actn2,alpha-actinin-2,71007
NP_659084.3,12395771,12438677,1,13,Mus_musculus,Heatr1,HEAT repeat-containing protein 1,42906
NP_001277986.1,12440844,12454797,-1,13,Mus_musculus,Lgals8,galectin-8 isoform 3,13953
NP_598398.3,12478182,12519948,-1,13,Mus_musculus,Edaradd,ectodysplasin-A receptor-associated adapter protein isoform 1,41766
NP_080460.2,12566076,12606887,1,13,Mus_musculus,Ero1lb,ERO1-like protein beta precursor,40811
NP_035248.2,12790930,12800012,-1,13,Mus_musculus,Prl2c3,prolactin-2C3 precursor,9082
NP_112468.1,12996234,13005326,-1,13,Mus_musculus,Prl2c2,prolactin-2C2 precursor,9092
NP_862900.1,13182781,13191815,1,13,Mus_musculus,Prl2c5,"prolactin family 2, subfamily c, member 5 isoform 2 precursor",9034
XP_006516887.1,13320937,13322532,-1,13,Mus_musculus,Gm7040,prolactin-2C3-like,1595
NP_114388.2,13359311,13393493,-1,13,Mus_musculus,Gpr137b,integral membrane protein GPR137B,34182
NP_035047.2,13437701,13510067,1,13,Mus_musculus,Nid1,nidogen-1 precursor,72366
NP_034878.2,13616553,13777179,1,13,Mus_musculus,Lyst,lysosomal-trafficking regulator,160626
NP_034447.1,13806071,13825375,1,13,Mus_musculus,Gng4,guanine nucleotide-binding protein G(I)/G(S)/G(O) subunit gamma-4 precursor,19304
NP_848755.1,13954804,13997033,1,13,Mus_musculus,B3galnt2,"UDP-GalNAc:beta-1, 3-N-acetylgalactosaminyltransferase 2 precursor",42229
NP_848027.1,13998088,14029375,-1,13,Mus_musculus,Tbce,tubulin-specific chaperone E,31287
NP_034412.1,14053693,14057865,-1,13,Mus_musculus,Ggps1,geranylgeranyl pyrophosphate synthase,4172
NP_919238.1,14064873,14197733,1,13,Mus_musculus,Arid4b,AT-rich interactive domain-containing protein 4B isoform 1,132860
NP_001074817.3,14230648,14434460,-1,13,Mus_musculus,Hecw1,E3 ubiquitin-protein ligase HECW1,203812
NP_083547.1,14610485,14613018,-1,13,Mus_musculus,Mrpl32,"39S ribosomal protein L32, mitochondrial",2533
NP_032970.2,14613274,14625465,1,13,Mus_musculus,Psma2,proteasome subunit alpha type-2,12191
NP_598828.3,14636563,14637829,1,13,Mus_musculus,AW209491,UPF0415 protein C7orf25 homolog,1266
NP_032156.2,15478040,15726781,1,13,Mus_musculus,Gli3,transcriptional activator GLI3,248741
NP_032406.1,16017295,16027129,1,13,Mus_musculus,Inhba,inhibin beta A chain precursor,9834
NP_619595.3,16857854,17694732,-1,13,Mus_musculus,Sugct,succinate--hydroxymethylglutarate CoA-transferase,836878
NP_079755.1,17695484,17697042,1,13,Mus_musculus,Mplkip,M-phase-specific PLK1-interacting protein,1558
NP_081394.1,17718060,17804651,-1,13,Mus_musculus,Cdk13,cyclin-dependent kinase 13 isoform 2,86591
NP_062364.3,17882378,17897066,-1,13,Mus_musculus,Rala,ras-related protein Ral-A precursor,14688
NP_080180.1,17989379,17993306,-1,13,Mus_musculus,Yae1d1,yae1 domain-containing protein 1,3927
NP_778171.2,18125161,18382044,-1,13,Mus_musculus,Pou6f2,"POU domain, class 6, transcription factor 2",256883
NP_742118.3,18717315,18866200,1,13,Mus_musculus,Vps41,vacuolar protein sorting-associated protein 41 homolog,148885
NP_001276475.1,18948432,19149843,1,13,Mus_musculus,Amph,amphiphysin isoform 2,201411
NP_077232.2,19358992,19376603,-1,13,Mus_musculus,Stard3nl,MLN64 N-terminal domain homolog,17611
NP_598826.3,19593151,19619562,-1,13,Mus_musculus,Epdr1,mammalian ependymin-related protein 1 precursor,26411
NP_057896.1,19623432,19632379,1,13,Mus_musculus,Sfrp4,secreted frizzled-related sequence protein 4 precursor,8947
NP_001161381.1,19645219,19697036,-1,13,Mus_musculus,Nme8,thioredoxin domain-containing protein 3 isoform 2,51817
NP_783619.2,19728980,19729880,-1,13,Mus_musculus,A530099J19Rik,G protein-coupled receptor-like,900
NP_861419.3,19751685,19752603,-1,13,Mus_musculus,Gpr141,probable G-protein coupled receptor 141,918
NP_525027.1,20185426,20605299,1,13,Mus_musculus,Elmo1,engulfment and cell motility protein 1 isoform 3,419873
NP_001268783.1,20794393,20851690,1,13,Mus_musculus,Aoah,acyloxyacyl hydrolase isoform 2 preproprotein,57297
NP_666746.1,21072348,21073299,-1,13,Mus_musculus,Olfr1370,olfactory receptor 1370,951
NP_035114.1,21132776,21133730,1,13,Mus_musculus,Olfr263,olfactory receptor 263,954
NP_666745.1,21142110,21143055,-1,13,Mus_musculus,Olfr1368,olfactory receptor 1368,945
NP_033080.2,21180494,21192625,1,13,Mus_musculus,Trim27,zinc finger protein RFP,12131
NP_034473.2,21287365,21292660,-1,13,Mus_musculus,Gpx5,epididymal secretory glutathione peroxidase precursor,5295
NP_663426.2,21312257,21319083,1,13,Mus_musculus,Gpx6,glutathione peroxidase 6 precursor,6826
NP_666744.1,21346929,21347880,1,13,Mus_musculus,Olfr1367,olfactory receptor 1367,951
NP_057893.2,21363649,21369513,1,13,Mus_musculus,Zscan12,zinc finger and SCAN domain-containing protein 12,5864
NP_076174.3,21387798,21396516,-1,13,Mus_musculus,Zkscan3,zinc finger protein with KRAB and SCAN domains 3,8718
NP_001012311.2,21422774,21434485,-1,13,Mus_musculus,Pgbd1,piggyBac transposable element-derived protein 1 isoform b,11711
NP_001013808.2,21444930,21449455,-1,13,Mus_musculus,Zscan26,zinc finger and SCAN domain-containing protein 26,4525
NP_079995.2,21467253,21468441,-1,13,Mus_musculus,Nkapl,NKAP-like protein,1188
NP_001034204.1,21479092,21484736,1,13,Mus_musculus,Zkscan4,zinc finger protein with KRAB and SCAN domains 4,5644
NP_001238762.1,21520000,21526938,-1,13,Mus_musculus,Zkscan8,zinc finger protein 192 isoform 2,6938
NP_666395.2,21537016,21538003,-1,13,Mus_musculus,Olfr1366,olfactory receptor 1366,987
NP_997455.1,21555039,21556020,-1,13,Mus_musculus,Olfr1535,olfactory receptor 1535,981
NP_666751.2,21573509,21574454,-1,13,Mus_musculus,Olfr1364,olfactory receptor 1364,945
NP_666955.2,21611040,21611967,-1,13,Mus_musculus,Olfr1362,olfactory receptor 1362,927
NP_666753.2,21638579,21639521,-1,13,Mus_musculus,Olfr11,olfactory receptor 11,942
NP_666752.1,21658367,21659321,-1,13,Mus_musculus,Olfr1361,olfactory receptor 1361,954
NP_666754.2,21674000,21674942,-1,13,Mus_musculus,Olfr1360,olfactory receptor 1360,942
NP_001011820.1,21703002,21703944,1,13,Mus_musculus,Olfr1359,olfactory receptor 1359,942
NP_835506.1,21715762,21716143,-1,13,Mus_musculus,Hist1h2bl,histone H2B type 1-F/J/L,381
NP_835489.1,21716421,21716814,1,13,Mus_musculus,Hist1h2ai,histone H2A type 1,393
NP_835513.1,21717658,21718069,1,13,Mus_musculus,Hist1h3h,histone H3.1,411
NP_835507.1,21722097,21722478,1,13,Mus_musculus,Hist1h2bm,histone H2B type 1-M,381
NP_835582.1,21735095,21735407,1,13,Mus_musculus,Hist1h4j,histone H4,312
NP_835583.1,21750193,21750505,-1,13,Mus_musculus,Hist1h4k,histone H4,312
NP_835490.1,21753434,21753827,-1,13,Mus_musculus,Hist1h2ak,histone H2A type 1-K,393
NP_835508.1,21754122,21754503,1,13,Mus_musculus,Hist1h2bn,histone H2B type 1-F/J/L,381
NP_064418.1,21779882,21780554,-1,13,Mus_musculus,Hist1h1b,histone H1.5,672
NP_835514.1,21782959,21783370,-1,13,Mus_musculus,Hist1h3i,histone H3.1,411
NP_835491.1,21786825,21787218,-1,13,Mus_musculus,Hist1h2an,histone H2A type 1,393
NP_001277395.1,21787514,21787895,1,13,Mus_musculus,Hist1h2bp,histone H2B type 1-P isoform 2,381
NP_001091448.2,21808099,21810171,-1,13,Mus_musculus,Hist1h2bq,"H2b histone family, member A isoform 1",2072
NP_001171015.1,21810466,21810859,1,13,Mus_musculus,Hist1h2ao,histone H2A type 1,393
NP_001182350.1,21811783,21812095,1,13,Mus_musculus,Hist1h4m,histone H4,312
NP_783588.1,21831846,21832158,-1,13,Mus_musculus,Hist1h4n,histone H4,312
NP_835492.1,21833082,21833475,-1,13,Mus_musculus,Hist1h2ap,histone H2A type 1,393
NP_001300807.1,21833770,21834151,1,13,Mus_musculus,Hist1h2br,histone cluster 1 H2br isoform 2,381
NP_898835.1,21945792,21960339,1,13,Mus_musculus,Zfp184,zinc finger protein 184,14547
NP_001156400.1,21981560,21984479,1,13,Mus_musculus,Pom121l2,POM121-like protein 2 isoform 1,2919
NP_062302.1,22002753,22009697,-1,13,Mus_musculus,Prss16,thymus-specific serine protease precursor,6944
NP_783590.1,22035165,22035552,-1,13,Mus_musculus,Hist1h2ah,histone H2A type 1-H,387
NP_783596.1,22035886,22036267,1,13,Mus_musculus,Hist1h2bk,histone H2B type 1-K,381
NP_783587.1,22041011,22041323,-1,13,Mus_musculus,Hist1h4i,histone H4,312
NP_835493.1,22042534,22042927,-1,13,Mus_musculus,Hist1h2ag,histone H2A type 1,393
NP_835505.1,22043229,22043610,1,13,Mus_musculus,Hist1h2bj,histone H2B type 1-F/J/L,381
NP_665849.1,22087877,22088804,1,13,Mus_musculus,Vmn1r188,vomeronasal 1 receptor 188,927
NP_665843.1,22101726,22102665,-1,13,Mus_musculus,Vmn1r189,vomeronasal 1 receptor 189,939
NP_665848.1,22178685,22179582,-1,13,Mus_musculus,Vmn1r191,vomeronasal 1 receptor 191,897
NP_665844.1,22187145,22188048,-1,13,Mus_musculus,Vmn1r192,vomeronasal 1 receptor 192,903
NP_598986.1,22218860,22219820,-1,13,Mus_musculus,Vmn1r193,vomeronasal 1 receptor 193,960
NP_001074441.1,22244214,22245105,1,13,Mus_musculus,Vmn1r194,vomeronasal 1 receptor 194,891
NP_598984.2,22278361,22279312,1,13,Mus_musculus,Vmn1r195,"vomeronasal 1 receptor, I6",951
NP_001161013.1,22293192,22294098,1,13,Mus_musculus,Vmn1r196,vomeronasal 1 receptor 196,906
NP_599005.1,22327910,22328807,1,13,Mus_musculus,Vmn1r197,vomeronasal 1 receptor 197,897
NP_598981.1,22354345,22355248,1,13,Mus_musculus,Vmn1r198,vomeronasal 1 receptor 198,903
NP_598974.1,22382537,22383641,1,13,Mus_musculus,Vmn1r199,vomeronasal 1 receptor 199,1104
NP_598973.1,22395028,22395967,1,13,Mus_musculus,Vmn1r200,vomeronasal 1 receptor 200,939
NP_598972.2,22441271,22442243,1,13,Mus_musculus,Vmn1r-ps103,"vomeronasal 1 receptor, H1",972
NP_598982.1,22474617,22475520,1,13,Mus_musculus,Vmn1r201,vomeronasal 1 receptor 201,903
NP_598985.1,22501336,22502245,-1,13,Mus_musculus,Vmn1r202,vomeronasal 1 receptor 202,909
NP_598997.1,22524050,22524986,1,13,Mus_musculus,Vmn1r203,vomeronasal 1 receptor 203,936
NP_001039009.1,22556200,22557109,1,13,Mus_musculus,Vmn1r204,vomeronasal 1 receptor 204,909
NP_598978.1,22591979,22592930,-1,13,Mus_musculus,Vmn1r205,vomeronasal 1 receptor 205,951
NP_598977.1,22620096,22621035,-1,13,Mus_musculus,Vmn1r206,vomeronasal 1 receptor 206,939
NP_001160181.1,22725683,22726622,-1,13,Mus_musculus,Vmn1r207-ps,"vomeronasal 1 receptor 207, pseudogene",939
NP_598979.1,22772398,22773325,-1,13,Mus_musculus,Vmn1r208,vomeronasal 1 receptor 208,927
NP_001013809.1,22805579,22806518,-1,13,Mus_musculus,Vmn1r209,vomeronasal 1 receptor 209,939
NP_598996.1,22827193,22828114,-1,13,Mus_musculus,Vmn1r210,vomeronasal 1 receptor 210,921
NP_599004.1,22851598,22852495,-1,13,Mus_musculus,Vmn1r211,vomeronasal 1 receptor 211,897
NP_599002.1,22883087,22884161,-1,13,Mus_musculus,Vmn1r212,vomeronasal 1 receptor 212,1074
NP_598976.1,23011248,23012403,1,13,Mus_musculus,Vmn1r213,vomeronasal 1 receptor 213,1155
NP_598975.1,23034337,23035441,1,13,Mus_musculus,Vmn1r214,vomeronasal 1 receptor 214,1104
NP_598980.1,23075791,23076694,1,13,Mus_musculus,Vmn1r215,vomeronasal 1 receptor 215,903
NP_599006.1,23099148,23100045,1,13,Mus_musculus,Vmn1r216,vomeronasal 1 receptor 216,897
NP_599000.1,23113833,23114730,-1,13,Mus_musculus,Vmn1r217,vomeronasal 1 receptor 217,897
NP_598983.1,23136484,23137381,1,13,Mus_musculus,Vmn1r218,vomeronasal 1 receptor 218,897
NP_598999.1,23162642,23163581,1,13,Mus_musculus,Vmn1r219,vomeronasal 1 receptor 219,939
NP_598998.1,23183627,23184524,-1,13,Mus_musculus,Vmn1r220,vomeronasal 1 receptor 220,897
NP_001161014.1,23217372,23218311,1,13,Mus_musculus,Vmn1r221,vomeronasal 1 receptor 221,939
NP_599001.1,23232114,23233041,-1,13,Mus_musculus,Vmn1r222,vomeronasal 1 receptor 222,927
NP_001076780.1,23249237,23250323,1,13,Mus_musculus,Vmn1r223,vomeronasal 1 receptor 223,1086
NP_001104577.1,23356337,23357570,-1,13,Mus_musculus,Zfp322a,zinc finger protein 322,1233
NP_038952.1,23421972,23423832,-1,13,Mus_musculus,Abt1,activator of basal transcription 1,1860
NP_038511.1,23458702,23465180,-1,13,Mus_musculus,Btn1a1,butyrophilin subfamily 1 member A1 precursor,6478
NP_001276543.1,23478233,23487917,-1,13,Mus_musculus,Btn2a2,butyrophilin subfamily 2 member A2 isoform 2 precursor,9684
NP_694813.1,23531114,23531426,1,13,Mus_musculus,Hist1h4h,histone H4,312
NP_783592.1,23533910,23534303,1,13,Mus_musculus,Hist1h2af,histone H2A type 1-F,393
NP_659539.1,23535445,23535856,1,13,Mus_musculus,Hist1h3g,histone H3.1,411
NP_835504.1,23542971,23543352,-1,13,Mus_musculus,Hist1h2bh,histone H2B type 1-H,381
NP_038576.1,23544484,23544895,1,13,Mus_musculus,Hist1h3f,histone H3.2,411
NP_783586.1,23551331,23551643,-1,13,Mus_musculus,Hist1h4f,histone H4,312
NP_663759.3,23555089,23555755,1,13,Mus_musculus,Hist1h1d,histone H1.3,666
NP_835512.1,23561954,23562365,-1,13,Mus_musculus,Hist1h3e,histone H3.2,411
NP_835494.1,23570715,23571108,-1,13,Mus_musculus,Hist1h2ae,histone H2A type 1,393
NP_835503.1,23571432,23571813,1,13,Mus_musculus,Hist1h2bg,histone H2B type 1-C/E/G,381
NP_835502.1,23573809,23574190,-1,13,Mus_musculus,Hist1h2bf,histone H2B type 1-F/J/L,381
NP_835495.1,23574470,23574863,1,13,Mus_musculus,Hist1h2ad,histone H2A type 1,393
NP_835511.1,23575801,23576212,1,13,Mus_musculus,Hist1h3d,histone H3.2,411
NP_783585.1,23581601,23581913,1,13,Mus_musculus,Hist1h4d,histone H4,312
NP_001171124.1,23585575,23585956,-1,13,Mus_musculus,Hist1h2be,histone H2B type 1-C/E/G,381
NP_056602.1,23621837,23622497,-1,13,Mus_musculus,Hist1h1e,histone H1.4,660
NP_835496.1,23683524,23683917,-1,13,Mus_musculus,Hist1h2ac,histone H2A type 1,393
NP_001277309.1,23684231,23684612,1,13,Mus_musculus,Hist1h2bc,histone H2B type 1-C/E/G,381
NP_034507.2,23695865,23696495,1,13,Mus_musculus,Hist1h1t,histone H1t,630
NP_835515.1,23698137,23698449,-1,13,Mus_musculus,Hist1h4c,histone H4,312
NP_034554.2,23704385,23710714,-1,13,Mus_musculus,Hfe,hereditary hemochromatosis protein homolog precursor,6329
NP_056601.1,23738848,23739487,1,13,Mus_musculus,Hist1h1c,histone H1.2,639
NP_783584.1,23745086,23745497,-1,13,Mus_musculus,Hist1h3c,histone H3.2,411
NP_783595.1,23746794,23747175,1,13,Mus_musculus,Hist1h2bb,histone H2B type 1-B,381
NP_783591.2,23751132,23751525,1,13,Mus_musculus,Hist1h2ab,histone H2A type 1,393
NP_835510.1,23752379,23752790,1,13,Mus_musculus,Hist1h3b,histone H3.2,411
NP_835500.1,23757020,23757332,1,13,Mus_musculus,Hist1h4b,histone H4,312
NP_835499.1,23760845,23761157,-1,13,Mus_musculus,Hist1h4a,histone H4,312
NP_038578.2,23761942,23762353,-1,13,Mus_musculus,Hist1h3a,histone H3.1,411
NP_085112.1,23763716,23764358,1,13,Mus_musculus,Hist1h1a,histone H1.1,642
NP_001025106.1,23782571,23791495,1,13,Mus_musculus,Trim38,E3 ubiquitin-protein ligase TRIM38,8924
NP_659085.1,23810799,23822302,1,13,Mus_musculus,Slc17a2,sodium-dependent phosphate transport protein 3,11503
NP_598830.2,23842449,23858113,1,13,Mus_musculus,Slc17a3,sodium-dependent phosphate transport protein 4 isoform 1,15664
NP_001164109.1,23872599,23892669,1,13,Mus_musculus,Slc17a1,sodium-dependent phosphate transport protein 1,20070
NP_795990.2,23898774,23908847,-1,13,Mus_musculus,Slc17a4,probable small intestine urate exporter,10073
NP_783594.1,23933772,23934156,-1,13,Mus_musculus,Hist1h2ba,histone H2B type 1-A,384
NP_783589.1,23934461,23934851,1,13,Mus_musculus,Hist1h2aa,"histone cluster 1, H2aa",390
NP_663374.1,23953855,23991033,-1,13,Mus_musculus,Scgn,secretagogin,37178
NP_081101.3,24013326,24280600,-1,13,Mus_musculus,Lrrc16a,F-actin-uncapping protein LRRC16A isoform 1,267274
NP_031743.3,24416999,24468622,1,13,Mus_musculus,Cmah,cytidine monophosphate-N-acetylneuraminic acid hydroxylase isoform a,51623
NP_848773.3,24614689,24704841,1,13,Mus_musculus,Fam65b,protein FAM65B isoform 3,90152
XP_011242665.1,24741274,24746489,1,13,Mus_musculus,1700016G14Rik,uncharacterized protein C6orf229 homolog,5215
NP_065592.1,24752068,24760210,-1,13,Mus_musculus,Gmnn,geminin,8142
NP_077793.1,24803380,24812762,1,13,Mus_musculus,BC005537,uncharacterized protein C6orf62 homolog,9382
NP_080066.1,24818034,24831306,-1,13,Mus_musculus,Acot13,acyl-coenzyme A thioesterase 13,13272
NP_062424.1,24831731,24841362,1,13,Mus_musculus,Tdp2,tyrosyl-DNA phosphodiesterase 2,9631
NP_001074520.1,24854500,24899799,1,13,Mus_musculus,D130043K22Rik,dyslexia-associated protein KIAA0319 homolog precursor,45299
NP_766120.1,24911560,24937568,-1,13,Mus_musculus,Aldh5a1,"succinate-semialdehyde dehydrogenase, mitochondrial precursor",26008
NP_032182.2,24943616,24990122,1,13,Mus_musculus,Gpld1,phosphatidylinositol-glycan-specific phospholipase D precursor,46506
NP_001013407.2,24993077,25020244,-1,13,Mus_musculus,Mrs2,"magnesium transporter MRS2 homolog, mitochondrial precursor",27167
NP_001182546.1,25056270,25120552,1,13,Mus_musculus,Dcdc2a,doublecortin domain-containing protein 2 isoform 2,64282
NP_033539.1,25253352,25262391,-1,13,Mus_musculus,Nrsn1,neurensin-1,9039
NP_032258.2,26769236,26770088,-1,13,Mus_musculus,Hdgfl1,hepatoma-derived growth factor-like protein 1,852
NP_035294.2,27057623,27065050,1,13,Mus_musculus,Prl,prolactin isoform 1 precursor,7427
NP_001192251.1,27094252,27100121,1,13,Mus_musculus,Prl3d1,prolactin-3D1 isoform 1 precursor,5869
NP_742167.1,27121741,27127418,1,13,Mus_musculus,Prl3d2,"prolactin family 3, subfamily d, member 1 precursor",5677
NP_742168.1,27156836,27162456,1,13,Mus_musculus,Prl3d3,"prolactin family 3, subfamily d, member 3 precursor",5620
NP_038794.1,27196705,27203612,1,13,Mus_musculus,Prl3c1,prolactin-3C1 isoform 1 precursor,6907
NP_032891.1,27242488,27249532,1,13,Mus_musculus,Prl3b1,prolactin-3B1 precursor,7044
NP_080172.1,27259644,27276218,1,13,Mus_musculus,Prl3a1,"prolactin family 3, subfamily a, member 1 precursor",16574
NP_035296.1,27312664,27319115,1,13,Mus_musculus,Prl6a1,prolactin-6A1 precursor,6451
NP_034218.1,27345736,27354064,1,13,Mus_musculus,Prl8a2,"prolactin family 8, subfamily a, member 2 isoform 1 precursor",8328
NP_079808.1,27383451,27390776,-1,13,Mus_musculus,Prl2b1,prolactin-2B1 precursor,7325
NP_035297.1,27432982,27438588,-1,13,Mus_musculus,Prl8a6,prolactin-8A6 isoform b precursor,5606
NP_076230.1,27507181,27513154,-1,13,Mus_musculus,Prl8a8,prolactin-8A8 isoform 2 precursor,5973
NP_001303650.1,27558150,27564546,-1,13,Mus_musculus,Prl8a9,prolactin-8A9 isoform 2 precursor,6396
NP_082753.1,27574001,27582110,-1,13,Mus_musculus,Prl8a1,"prolactin family 8, subfamily a, member 1 precursor",8109
NP_083631.1,27601927,27610522,-1,13,Mus_musculus,Prl7b1,prolactin-7B1 precursor,8595
NP_032956.1,27633478,27642450,-1,13,Mus_musculus,Prl7a1,prolactin-7A1 isoform 2 precursor,8972
NP_035298.1,27659056,27667994,-1,13,Mus_musculus,Prl7a2,prolactin-7A2 precursor,8938
NP_035250.1,27709191,27716669,-1,13,Mus_musculus,Prl7d1,prolactin-7D1 precursor,7478
NP_080482.1,27773699,27780749,-1,13,Mus_musculus,Prl7c1,prolactin-7C1 precursor,7050
NP_064375.1,27801702,27808581,1,13,Mus_musculus,Prl2a1,prolactin-2A1 precursor,6879
NP_001038997.1,27849401,27857683,1,13,Mus_musculus,Prl2c1,"Prolactin family 2, subfamily c, member 1 precursor",8282
NP_035295.1,28016272,28023428,1,13,Mus_musculus,Prl4a1,prolactin-4A1 precursor,7156
NP_076235.1,28142542,28151302,1,13,Mus_musculus,Prl5a1,prolactin-5A1 precursor,8760
NP_033264.2,28951698,28953021,-1,13,Mus_musculus,Sox4,transcription factor SOX-4,1323
NP_653119.1,29326036,29850108,-1,13,Mus_musculus,Cdkal1,threonylcarbamoyladenosine tRNA methylthiotransferase isoform 1,524072
NP_001276849.1,29909902,29984145,-1,13,Mus_musculus,E2f3,transcription factor E2F3 isoform E2f3b,74243
NP_705774.1,30136666,30245469,1,13,Mus_musculus,Mboat1,lysophospholipid acyltransferase 1,108803
NP_796296.1,30380953,30382033,1,13,Mus_musculus,Agtr1a,type-1A angiotensin II receptor,1080
NP_079986.1,30540730,30545247,-1,13,Mus_musculus,Uqcrfs1,"cytochrome b-c1 complex subunit Rieske, mitochondrial",4517
NP_001033044.1,30660125,30708859,1,13,Mus_musculus,Dusp22,dual specificity protein phosphatase 22 isoform a,48734
NP_038702.1,30750579,30763667,1,13,Mus_musculus,Irf4,interferon regulatory factor 4,13088
NP_079864.1,30815297,30940727,-1,13,Mus_musculus,Exoc2,exocyst complex component 2,125430
NP_694712.1,30946843,30947674,-1,13,Mus_musculus,Hus1b,checkpoint protein HUS1B,831
NP_032265.3,31558916,31560119,1,13,Mus_musculus,Foxq1,forkhead box protein Q1,1203
NP_034355.2,31626079,31630645,1,13,Mus_musculus,Foxf2,forkhead box protein F2,4566
NP_032618.2,31807207,31808869,1,13,Mus_musculus,Foxc1,forkhead box protein C1,1662
NP_666153.1,31819915,32338483,-1,13,Mus_musculus,Gmds,"GDP-mannose 4,6 dehydratase",518568
NP_001159502.1,32708904,32781716,-1,13,Mus_musculus,Mylk4,myosin light chain kinase family member 4,72812
NP_084491.3,32802237,32822159,1,13,Mus_musculus,Wrnip1,ATPase WRNIP1,19922
NP_079705.2,32842817,32850406,-1,13,Mus_musculus,Serpinb1a,leukocyte elastase inhibitor A,7589
NP_766639.2,32881832,32897098,-1,13,Mus_musculus,Serpinb1c,leukocyte elastase inhibitor C,15266
NP_035584.1,32968509,32978353,1,13,Mus_musculus,Serpinb6b,"serine (or cysteine) proteinase inhibitor, clade B, member 6b",9844
NP_033282.1,33006542,33015848,1,13,Mus_musculus,Serpinb9,"serine (or cysteine) proteinase inhibitor, clade B, member 9",9306
NP_035582.1,33029461,33039960,1,13,Mus_musculus,Serpinb9b,"serine (or cysteine) proteinase inhibitor, clade B, member 9b",10499
NP_766640.1,33085285,33093934,1,13,Mus_musculus,Serpinb1b,leukocyte elastase inhibitor B,8649
NP_035583.1,33149977,33157824,-1,13,Mus_musculus,Serpinb9c,"serine (or cysteine) proteinase inhibitor, clade B, member 9c isoform 2",7847
NP_035590.1,33194572,33203084,1,13,Mus_musculus,Serpinb9d,"serine (or cysteine) proteinase inhibitor, clade B, member 9d",8512
NP_035586.1,33251585,33260132,1,13,Mus_musculus,Serpinb9e,"serine (or cysteine) proteinase inhibitor, clade B, member 9e",8547
NP_899020.1,33325826,33334652,1,13,Mus_musculus,Serpinb9f,"serine (or cysteine) proteinase inhibitor, clade B, member 9f",8826
XP_619089.4,33395770,33404567,1,13,Mus_musculus,Gm11397,serpin B9,8797
NP_035585.2,33486530,33495282,1,13,Mus_musculus,Serpinb9g,"serine (or cysteine) proteinase inhibitor, clade B, member 9g",8752
NP_001070258.1,33664054,33671472,1,13,Mus_musculus,Serpinb6d,"serine (or cysteine) peptidase inhibitor, clade B, member 6d",7418
NP_001039000.2,33832458,33841306,-1,13,Mus_musculus,Serpinb6e,"serine (or cysteine) peptidase inhibitor, clade B, member 6e",8848
NP_683744.2,33879930,33899429,-1,13,Mus_musculus,Serpinb6c,serine proteinase inhibitor member 6C,19499
NP_001157590.1,33918040,33931636,-1,13,Mus_musculus,Serpinb6a,serpin B6 isoform b,13596
NP_001156713.1,33968270,33985492,1,13,Mus_musculus,Nqo2,ribosyldihydronicotinamide dehydrogenase [quinone] isoform 1,17222
NP_033094.3,34009656,34032782,1,13,Mus_musculus,Ripk1,receptor-interacting serine/threonine-protein kinase 1,23126
NP_080788.1,34037662,34073763,1,13,Mus_musculus,Bphl,valacyclovir hydrolase precursor,36101
NP_033476.1,34074467,34077929,-1,13,Mus_musculus,Tubb2a,tubulin beta-2A chain,3462
NP_076205.1,34127470,34130233,-1,13,Mus_musculus,Tubb2b,tubulin beta-2B chain,2763
NP_001103985.1,34163075,34178055,1,13,Mus_musculus,Psmg4,proteasome assembly chaperone 4 isoform a,14980
NP_001028339.1,34182953,34344797,-1,13,Mus_musculus,Slc22a23,solute carrier family 22 member 23,161844
NP_080107.3,34628770,34652435,-1,13,Mus_musculus,Pxdc1,PX domain-containing protein 1,23665
NP_620085.2,34746542,34747547,1,13,Mus_musculus,Fam50b,protein FAM50B,1005
NP_038858.2,34875653,34901596,1,13,Mus_musculus,Prpf4b,serine/threonine-protein kinase PRP4 homolog,25943
NP_082243.1,34910241,34915716,-1,13,Mus_musculus,Fam217a,protein FAM217A,5475
NP_080026.2,34924536,34952964,1,13,Mus_musculus,4933417A18Rik,uncharacterized protein C6orf201 homolog,28428
NP_081223.1,34946928,34960478,-1,13,Mus_musculus,Eci3,"enoyl-CoA delta isomerase 3, peroxisomal",13550
NP_035998.2,34977910,34993175,-1,13,Mus_musculus,Eci2,"enoyl-CoA delta isomerase 2, mitochondrial isoform b",15265
NP_034011.1,35669945,35872670,1,13,Mus_musculus,Cdyl,chromodomain Y-like protein isoform 1,202725
NP_666050.3,35896726,35906326,-1,13,Mus_musculus,Rpp40,ribonuclease P protein subunit p40,9600
NP_083904.1,35968598,35969642,1,13,Mus_musculus,Ppp1r3g,protein phosphatase 1 regulatory subunit 3G,1044
NP_958746.1,35979838,36117160,-1,13,Mus_musculus,Lyrm4,LYR motif-containing protein 4,137322
NP_077236.1,36204529,36537439,1,13,Mus_musculus,Fars2,"phenylalanine--tRNA ligase, mitochondrial isoform 1",332910
NP_705757.1,36726627,36734290,-1,13,Mus_musculus,Nrn1,neuritin precursor,7663
NP_001159863.1,36868764,37047486,-1,13,Mus_musculus,F13a1,coagulation factor XIII A chain precursor,178722
NP_034875.1,37345438,37418622,1,13,Mus_musculus,Ly86,lymphocyte antigen 86 precursor,73184
NP_001171339.1,37893813,37932542,1,13,Mus_musculus,Rreb1,ras-responsive element-binding protein 1 isoform 1,38729
NP_080241.3,37979738,37994083,-1,13,Mus_musculus,Ssr1,translocon-associated protein subunit alpha precursor,14345
NP_082000.2,38006088,38032472,-1,13,Mus_musculus,Cage1,cancer-associated gene 1 protein homolog,26384
NP_077204.2,38037460,38060865,1,13,Mus_musculus,Riok1,serine/threonine-protein kinase RIO1,23405
NP_076331.2,38151588,38197932,1,13,Mus_musculus,Dsp,desmoplakin,46344
NP_080658.2,38204972,38226922,1,13,Mus_musculus,Snrnp48,U11/U12 small nuclear ribonucleoprotein 48 kDa protein,21950
NP_031582.1,38345932,38499068,1,13,Mus_musculus,Bmp6,bone morphogenetic protein 6 preproprotein,153136
NP_001276527.1,38501585,38523417,-1,13,Mus_musculus,Txndc5,thioredoxin domain-containing protein 5 isoform 2,21832
NP_620702.1,38603848,38635041,-1,13,Mus_musculus,Bloc1s5,biogenesis of lysosome-related organelles complex 1 subunit 5,31193
NP_079656.1,38646169,38658993,-1,13,Mus_musculus,Eef1e1,eukaryotic translation elongation factor 1 epsilon-1,12824
NP_598821.1,38932765,38955849,-1,13,Mus_musculus,Slc35b3,adenosine 3'-phospho 5'-phosphosulfate transporter 2 isoform 2,23084
NP_742155.2,40001888,40287983,-1,13,Mus_musculus,Ofcc1,orofacial cleft 1 candidate gene 1 protein homolog,286095
NP_001116420.1,40717114,40730065,-1,13,Mus_musculus,Tfap2a,transcription factor AP-2-alpha isoform 3,12951
XP_017171142.1,40846732,40852426,1,13,Mus_musculus,Gm35160,"LOW QUALITY PROTEIN: N-acetyllactosaminide beta-1,6-N-acetylglucosaminyl-transferase",5694
NP_076376.3,40860354,40958342,1,13,Mus_musculus,Gcnt2,"N-acetyllactosaminide beta-1,6-N-acetylglucosaminyl-transferase isoform B",97988
NP_080826.2,41001329,41012749,1,13,Mus_musculus,Pak1ip1,p21-activated protein kinase-interacting protein 1,11420
NP_079663.1,41017150,41022160,1,13,Mus_musculus,Tmem14c,transmembrane protein 14C,5010
NP_001139274.1,41026407,41070237,-1,13,Mus_musculus,Mak,serine/threonine-protein kinase MAK isoform 3,43830
NP_032130.2,41102756,41109954,-1,13,Mus_musculus,Gcm2,chorion-specific transcription factor GCMb,7198
NP_001311454.1,41114418,41174351,1,13,Mus_musculus,Sycp2l,synaptonemal complex protein 2-like,59933
NP_001298050.1,41185293,41197150,-1,13,Mus_musculus,Elovl2,elongation of very long chain fatty acids protein 2 isoform 2,11857
NP_001129049.1,41250238,41272756,1,13,Mus_musculus,Smim13,small integral membrane protein 13,22518
NP_059492.3,41311660,41358864,-1,13,Mus_musculus,Nedd9,enhancer of filamentation 1 isoform 2,47204
NP_001157044.1,41606215,41634586,1,13,Mus_musculus,Tmem170b,transmembrane protein 170B,28371
NP_808476.2,41656011,41656428,1,13,Mus_musculus,Gm5082,uncharacterized protein LOC328231,417
NP_001139347.1,41764757,41828295,-1,13,Mus_musculus,Adtrp,androgen-dependent TFPI-regulating protein isoform 2,63538
NP_031798.2,42055502,42184513,1,13,Mus_musculus,Hivep1,zinc finger protein 40,129011
NP_034234.1,42301894,42306879,1,13,Mus_musculus,Edn1,endothelin-1 preproprotein,4985
NP_001289564.1,42682697,43135189,1,13,Mus_musculus,Phactr1,phosphatase and actin regulator 1 isoform 4,452492
NP_001239569.1,43151893,43169913,-1,13,Mus_musculus,Tbc1d7,TBC1 domain family member 7 isoform 2,18020
NP_001028571.1,43200324,43303497,-1,13,Mus_musculus,Gfod1,glucose-fructose oxidoreductase domain-containing protein 1 precursor,103173
NP_849179.1,43370753,43394812,1,13,Mus_musculus,Sirt5,"NAD-dependent protein deacylase sirtuin-5, mitochondrial",24059
NP_076043.2,43398404,43401841,1,13,Mus_musculus,Nol7,nucleolar protein 7,3437
NP_064314.2,43403558,43480928,-1,13,Mus_musculus,Ranbp9,ran-binding protein 9,77370
NP_001074528.1,43541673,43560126,-1,13,Mus_musculus,Mcur1,mitochondrial calcium uniporter regulator 1,18453
NP_899027.1,43667974,43668718,1,13,Mus_musculus,Rnf182,E3 ubiquitin-protein ligase RNF182,744
NP_001276844.1,43785213,43799688,1,13,Mus_musculus,Cd83,CD83 antigen isoform 2 precursor,14475
NP_068678.1,44731871,44919952,1,13,Mus_musculus,Jarid2,protein Jumonji,188081
NP_080048.2,44922206,45001972,-1,13,Mus_musculus,Dtnbp1,dysbindin,79766
NP_722484.2,45389956,45410510,1,13,Mus_musculus,Mylip,E3 ubiquitin-protein ligase MYLIP,20554
NP_079784.1,45507656,45546053,1,13,Mus_musculus,Gmpr,GMP reductase 1,38397
NP_001186233.1,45557054,45568417,-1,13,Mus_musculus,Atxn1,ataxin-1 isoform b,11363
NP_001005422.1,46273817,46299689,1,13,Mus_musculus,Stmnd1,stathmin domain-containing protein 1,25872
NP_001074894.1,46419030,46429317,1,13,Mus_musculus,Rbm24,RNA-binding protein 24,10287
NP_080332.1,46525415,46648364,1,13,Mus_musculus,Cap2,adenylyl cyclase-associated protein 2,122949
NP_001028364.1,46669585,46675656,1,13,Mus_musculus,Fam8a1,protein FAM8A1,6071
NP_786925.2,46681157,46727473,-1,13,Mus_musculus,Nup153,nuclear pore complex protein Nup153,46316
NP_034747.2,46750605,46929621,-1,13,Mus_musculus,Kif13a,kinesin-like protein KIF13A,179016
NP_780549.1,47013573,47014779,-1,13,Mus_musculus,Nhlrc1,E3 ubiquitin-protein ligase NHLRC1,1206
NP_058065.2,47025364,47041523,-1,13,Mus_musculus,Tpmt,thiopurine S-methyltransferase,16159
NP_758466.1,47047915,47082958,1,13,Mus_musculus,Kdm1b,lysine-specific histone demethylase 1B,35043
NP_080176.2,47086067,47105728,-1,13,Mus_musculus,Dek,protein DEK,19661
NP_666154.3,47207385,47244501,1,13,Mus_musculus,Rnf144b,E3 ubiquitin-protein ligase RNF144B,37116
NP_112443.1,48261497,48262329,1,13,Mus_musculus,Id4,DNA-binding protein inhibitor ID-4,832
NP_001158048.1,48489201,48506939,-1,13,Mus_musculus,Zfp169,zinc finger protein 169 isoform b,17738
XP_001473814.1,48514223,48514727,1,13,Mus_musculus,A830005F24Rik,uncharacterized protein A830005F24Rik,504
NP_997115.1,48579735,48606354,-1,13,Mus_musculus,Ptpdc1,protein tyrosine phosphatase domain-containing protein 1 isoform 2,26619
NP_031552.2,48663116,48665992,1,13,Mus_musculus,Barx1,homeobox protein BarH-like 1,2876
NP_035208.2,48803598,48870765,-1,13,Mus_musculus,Phf2,lysine-specific demethylase PHF2,67167
NP_001028440.2,48880795,48967828,-1,13,Mus_musculus,Fam120a,constitutive coactivator of PPAR-gamma-like protein 1,87033
NP_083637.2,49036479,49147232,-1,13,Mus_musculus,Wnk2,serine/threonine-protein kinase WNK2 isoform c,110753
NP_038638.1,49187562,49195048,1,13,Mus_musculus,Ninj1,ninjurin-1,7486
NP_081014.1,49203119,49215943,-1,13,Mus_musculus,Card19,caspase recruitment domain-containing protein 19,12824
NP_079767.2,49231135,49248132,-1,13,Mus_musculus,Susd3,sushi domain-containing protein 3 isoform 1,16997
NP_056574.2,49263783,49296771,-1,13,Mus_musculus,Fgd3,"FYVE, RhoGEF and PH domain-containing protein 3",32988
NP_001034268.1,49341670,49383352,1,13,Mus_musculus,Bicd2,protein bicaudal D homolog 2 isoform 1,41682
NP_951011.1,49421385,49461759,1,13,Mus_musculus,Ippk,inositol-pentakisphosphate 2-kinase isoform a,40374
NP_079771.1,49464209,49652689,-1,13,Mus_musculus,Cenpp,centromere protein P,188480
NP_001012324.1,49514822,49531431,1,13,Mus_musculus,Ecm2,extracellular matrix protein 2 precursor,16609
NP_079987.2,49551663,49566631,1,13,Mus_musculus,Aspn,asporin preproprotein,14968
NP_036180.1,49589475,49592387,1,13,Mus_musculus,Omd,osteomodulin precursor,2912
NP_032786.1,49609183,49622983,1,13,Mus_musculus,Ogn,mimecan precursor,13800
NP_001258326.1,49653645,49678436,1,13,Mus_musculus,Nol8,nucleolar protein 8,24791
NP_742012.2,49687392,49733741,1,13,Mus_musculus,Iars,"isoleucine--tRNA ligase, cytoplasmic",46349
XP_011242736.2,49750605,49752536,1,13,Mus_musculus,Gm19334,LOW QUALITY PROTEIN: zinc finger protein 484,1931
XP_006517059.1,49784899,49790200,-1,13,Mus_musculus,Gm30302,spermatogenesis-associated protein 31A6-like,5301
XP_006517055.1,49820662,49828950,1,13,Mus_musculus,LOC102631805,serine/threonine-protein kinase par-1-like,8288
XP_006517054.1,49858763,49864130,-1,13,Mus_musculus,Gm8672,spermatogenesis-associated protein 31A6-like,5367
XP_017171148.1,49899188,49902212,-1,13,Mus_musculus,Gm8674,uncharacterized protein Gm8674,3024
XP_017171143.1,50162321,50163398,-1,13,Mus_musculus,Gm19470,uncharacterized protein Gm19470,1077
NP_001028610.1,50245234,50250264,-1,13,Mus_musculus,Gm906,uncharacterized protein LOC380882,5030
XP_006517068.1,50399484,50400423,-1,13,Mus_musculus,Gm19536,uncharacterized protein Gm19536,939
NP_780610.2,50417897,50433406,1,13,Mus_musculus,Fbxw17,F-box and WD-40 domain protein 17,15509
NP_001028572.1,50467400,50475103,1,13,Mus_musculus,Nutm2,NUT family member 2,7703
NP_001028942.1,50643271,50645542,1,13,Mus_musculus,Gm904,uncharacterized protein LOC380845,2271
NP_001231578.1,50698355,50703381,1,13,Mus_musculus,Gm8765,uncharacterized protein LOC667693,5026
XP_017171159.1,50885886,50891283,1,13,Mus_musculus,Gm8777,spermatogenesis-associated protein 31A6-like,5397
NP_666155.1,51123236,51149161,1,13,Mus_musculus,Spin1,spindlin-1 isoform 2,25925
NP_083449.1,51171322,51174793,1,13,Mus_musculus,Nxnl2,nucleoredoxin-like protein 2,3471
NP_034231.1,51418784,51419921,1,13,Mus_musculus,S1pr3,sphingosine 1-phosphate receptor 3,1137
NP_033193.2,51431152,51567084,-1,13,Mus_musculus,Shc3,SHC-transforming protein 3,135932
NP_079691.1,51645412,51650389,1,13,Mus_musculus,Cks2,cyclin-dependent kinases regulatory subunit 2,4977
NP_083555.1,51651784,51683381,1,13,Mus_musculus,Secisbp2,selenocysteine insertion sequence-binding protein 2 isoform 1,31597
NP_038688.2,51702608,51725329,-1,13,Mus_musculus,Sema4d,semaphorin-4D precursor,22721
NP_035947.2,51846779,51847979,1,13,Mus_musculus,Gadd45g,growth arrest and DNA damage-inducible protein GADD45 gamma,1200
NP_001019645.1,52507669,52508269,-1,13,Mus_musculus,Diras2,GTP-binding protein Di-Ras2,600
NP_001185906.1,52610838,52645795,1,13,Mus_musculus,Syk,tyrosine-protein kinase SYK,34957
NP_057918.2,52835473,52929641,-1,13,Mus_musculus,Auh,"methylglutaconyl-CoA hydratase, mitochondrial precursor",94168
NP_059069.1,52967477,52968866,-1,13,Mus_musculus,Nfil3,nuclear factor interleukin-3-regulated protein,1389
NP_038874.3,53110219,53285877,-1,13,Mus_musculus,Ror2,tyrosine-protein kinase transmembrane receptor ROR2 precursor,175658
NP_033295.2,53333883,53377349,-1,13,Mus_musculus,Sptlc1,serine palmitoyltransferase 1,43466
XP_011242734.1,53415983,53419007,-1,13,Mus_musculus,Gm38564,spermatogenesis-associated protein 31A3-like,3024
NP_038629.2,53468168,53472710,-1,13,Mus_musculus,Msx2,homeobox protein MSX-2,4542
NP_034206.1,54052852,54054193,-1,13,Mus_musculus,Drd1,D(1A) dopamine receptor,1341
NP_081600.1,54085459,54106603,1,13,Mus_musculus,Sfxn1,sideroflexin-1,21144
NP_032312.2,54214006,54215083,1,13,Mus_musculus,Hrh2,histamine H2 receptor isoform 2,1077
NP_034076.1,54378668,54379709,1,13,Mus_musculus,Cplx2,complexin-2,1041
NP_082873.2,54460073,54468807,-1,13,Mus_musculus,Thoc3,THO complex subunit 3,8734
NP_795961.3,54503875,54550633,1,13,Mus_musculus,Simc1,SUMO-interacting motif-containing protein 1,46758
NP_001239577.1,54552611,54552982,-1,13,Mus_musculus,4833439L19Rik,putative monooxygenase p33MONOX isoform 4,371
NP_064352.2,54575094,54580894,1,13,Mus_musculus,Arl10,ADP-ribosylation factor-like protein 10,5800
NP_848720.1,54585280,54589967,-1,13,Mus_musculus,Nop16,nucleolar protein 16,4687
NP_080209.1,54590265,54590890,1,13,Mus_musculus,Higd2a,HIG1 domain family member 2A,625
NP_083146.1,54593870,54611264,-1,13,Mus_musculus,Cltb,clathrin light chain B,17394
NP_848484.2,54621840,54661136,1,13,Mus_musculus,Faf2,FAS-associated factor 2,39296
NP_598825.2,54681748,54684014,-1,13,Mus_musculus,Rnf44,RING finger protein 44 isoform 4,2266
NP_001028536.2,54712627,54736580,1,13,Mus_musculus,Cdhr2,cadherin-related family member 2 precursor,23953
NP_036144.2,54737660,54740459,-1,13,Mus_musculus,Gprin1,G protein-regulated inducer of neurite outgrowth 1,2799
NP_291088.1,54759508,54765683,-1,13,Mus_musculus,Sncb,beta-synuclein,6175
NP_001273109.1,54784015,54786955,1,13,Mus_musculus,Eif4e1b,eukaryotic translation initiation factor 4E type 1B isoform 5,2940
NP_083117.2,54789594,54796222,1,13,Mus_musculus,Tspan17,tetraspanin-17,6628
NP_694771.1,54949661,55004971,1,13,Mus_musculus,Unc5a,netrin receptor UNC5A isoform 1 precursor,55310
NP_001193321.1,55006170,55015060,-1,13,Mus_musculus,Hk3,hexokinase-3 isoform 3,8890
NP_001280589.1,55028519,55093273,-1,13,Mus_musculus,Uimc1,BRCA1-A complex subunit RAP80 isoform 2,64754
NP_036147.1,55105343,55132394,1,13,Mus_musculus,Zfp346,zinc finger protein 346,27051
XP_017171160.1,55127775,55128183,-1,13,Mus_musculus,LOC108168084,60S ribosomal protein L30-like,408
NP_032037.2,55155489,55168175,1,13,Mus_musculus,Fgfr4,fibroblast growth factor receptor 4 precursor,12686
NP_032765.3,55213220,55313728,1,13,Mus_musculus,Nsd1,"histone-lysine N-methyltransferase, H3 lysine-36 and H4 lysine-20 specific",100508
NP_033026.1,55320149,55321654,-1,13,Mus_musculus,Rab24,ras-related protein Rab-24,1505
NP_079872.4,55322189,55324972,1,13,Mus_musculus,Prelid1,"PRELI domain-containing protein 1, mitochondrial precursor",2783
NP_057871.2,55325782,55329667,-1,13,Mus_musculus,Mxd3,max dimerization protein 3,3885
NP_080104.2,55346876,55362589,-1,13,Mus_musculus,Lman2,vesicular integral-membrane protein VIP36 precursor,15713
NP_058038.2,55369891,55384135,1,13,Mus_musculus,Rgs14,regulator of G-protein signaling 14,14244
NP_035522.2,55400457,55413637,1,13,Mus_musculus,Slc34a1,sodium-dependent phosphate transport protein 2A,13180
NP_083579.1,55414752,55415166,-1,13,Mus_musculus,Pfn3,profilin-3,414
NP_067464.2,55418098,55426768,-1,13,Mus_musculus,F12,coagulation factor XII preproprotein,8670
NP_036068.2,55445508,55459338,1,13,Mus_musculus,Grk6,G protein-coupled receptor kinase 6 isoform b,13830
NP_001025467.1,55472024,55472990,1,13,Mus_musculus,Prr7,proline-rich protein 7,966
NP_062787.2,55474222,55487948,-1,13,Mus_musculus,Dbn1,drebrin isoform 3,13726
NP_001107560.1,55498647,55512407,-1,13,Mus_musculus,Pdlim7,PDZ and LIM domain protein 7 isoform a,13760
NP_038767.1,55523421,55528514,-1,13,Mus_musculus,Dok3,docking protein 3,5093
NP_598820.2,55530594,55536507,-1,13,Mus_musculus,Ddx41,probable ATP-dependent RNA helicase DDX41,5913
NP_663357.2,55541624,55556096,-1,13,Mus_musculus,Fam193b,protein FAM193B,14472
NP_080487.2,55593173,55596990,1,13,Mus_musculus,Tmed9,transmembrane emp24 domain-containing protein 9 precursor,3817
NP_666157.1,55600142,55609374,1,13,Mus_musculus,B4galt7,"beta-1,4-galactosyltransferase 7 isoform 1",9232
NP_031622.2,55623090,55632000,1,13,Mus_musculus,Caml,calcium signal-modulating cyclophilin ligand,8910
NP_001268984.1,55635178,55678831,1,13,Mus_musculus,Ddx46,probable ATP-dependent RNA helicase DDX46,43653
NP_851795.1,55699075,55699642,1,13,Mus_musculus,B230219D22Rik,UPF0461 protein C5orf24 homolog,567
NP_780359.2,55714777,55725863,1,13,Mus_musculus,Txndc15,thioredoxin domain-containing protein 15 precursor,11086
NP_082557.1,55727372,55776700,1,13,Mus_musculus,Pcbd2,pterin-4-alpha-carbinolamine dehydratase 2,49328
NP_001239416.1,55784661,55808919,1,13,Mus_musculus,Catsper3,cation channel sperm-associated protein 3 isoform 1,24258
NP_035227.1,55826068,55830940,-1,13,Mus_musculus,Pitx1,pituitary homeobox 1,4872
NP_001152987.1,56074226,56128448,-1,13,Mus_musculus,H2afy,core histone macro-H2A.1 isoform 4,54222
NP_666088.1,56176184,56176628,-1,13,Mus_musculus,Tifab,TRAF-interacting protein with FHA domain-containing protein B,444
NP_035026.1,56251197,56251932,-1,13,Mus_musculus,Neurog1,neurogenin-1,735
NP_062514.2,56289791,56296173,-1,13,Mus_musculus,Cxcl14,C-X-C motif chemokine 14 precursor,6382
NP_808477.2,56438489,56470472,1,13,Mus_musculus,Slc25a48,solute carrier family 25 member 48,31983
NP_032399.1,56479362,56482231,-1,13,Mus_musculus,Il9,interleukin-9 precursor,2869
NP_848789.2,56526915,56537467,1,13,Mus_musculus,Fbxl21,F-box/LRR-repeat protein 21,10552
NP_034832.2,56542704,56548362,-1,13,Mus_musculus,Lect2,leukocyte cell-derived chemotaxin-2 precursor,5658
NP_033395.1,56609646,56638757,1,13,Mus_musculus,Tgfbi,transforming growth factor-beta-induced protein ig-h3 precursor,29111
NP_001157513.1,56723593,56737478,1,13,Mus_musculus,Smad5,mothers against decapentaplegic homolog 5,13885
NP_001289302.1,56773763,56822614,-1,13,Mus_musculus,Trpc7,short transient receptor potential channel 7 isoform 3 precursor,48851
NP_001159937.1,57423089,57907587,-1,13,Mus_musculus,Spock1,testican-1 isoform 5 precursor,484498
NP_001182004.1,58005175,58102428,-1,13,Mus_musculus,Klhl3,kelch-like protein 3,97253
NP_084148.1,58127395,58128313,-1,13,Mus_musculus,Hnrnpa0,heterogeneous nuclear ribonucleoprotein A0,918
NP_001041525.1,58157686,58163519,1,13,Mus_musculus,Idnk,probable gluconokinase isoform b,5833
NP_689420.1,58177875,58215436,-1,13,Mus_musculus,Ubqln1,ubiquilin-1 isoform 2,37561
NP_062806.1,58233610,58264157,-1,13,Mus_musculus,Gkap1,G kinase-anchoring protein 1,30547
NP_780423.2,58287792,58354862,-1,13,Mus_musculus,Kif27,kinesin-like protein KIF27,67070
NP_081611.1,58381779,58385154,-1,13,Mus_musculus,2210016F16Rik,UPF0553 protein C9orf64 homolog,3375
NP_001288274.1,58392385,58400390,-1,13,Mus_musculus,Hnrnpk,heterogeneous nuclear ribonucleoprotein K isoform 4,8005
NP_083180.3,58407938,58409789,1,13,Mus_musculus,Rmi1,recQ-mediated genome instability protein 1,1851
NP_071712.3,58555689,58610807,-1,13,Mus_musculus,Slc28a3,solute carrier family 28 member 3,55118
NP_032771.1,58808728,58932060,1,13,Mus_musculus,Ntrk2,BDNF/NT-3 growth factors receptor isoform b precursor,123332
NP_001271148.1,59450136,59514200,-1,13,Mus_musculus,Agtpbp1,cytosolic carboxypeptidase 1 isoform 3,64064
NP_084429.2,59586157,59634477,1,13,Mus_musculus,Naa35,"N-alpha-acetyltransferase 35, NatC auxiliary subunit",48320
NP_001030294.1,59637291,59665655,-1,13,Mus_musculus,Golm1,Golgi membrane protein 1,28364
NP_899113.1,59689459,59691629,-1,13,Mus_musculus,4921517D22Rik,uncharacterized protein C9orf153 homolog,2170
NP_082433.2,59700301,59706150,-1,13,Mus_musculus,Spata31d1a,spermatogenesis-associated protein 31D1,5849
NP_001161065.1,59712314,59719125,1,13,Mus_musculus,Spata31d1b,uncharacterized protein LOC238662,6811
NP_808379.2,59725975,59731720,-1,13,Mus_musculus,Spata31d1d,putative spermatogenesis-associated protein 31D3,5745
XP_017171161.1,59741052,59744004,-1,13,Mus_musculus,LOC102638268,spermatogenesis-associated protein 31D1,2952
NP_081197.1,59756854,59769704,-1,13,Mus_musculus,Isca1,"iron-sulfur cluster assembly 1 homolog, mitochondrial precursor",12850
NP_705766.3,59778798,59822079,-1,13,Mus_musculus,Zcchc6,terminal uridylyltransferase 7,43281
NP_032112.1,60175786,60176941,-1,13,Mus_musculus,Gas1,growth arrest-specific protein 1,1155
NP_598823.1,60602534,60761867,1,13,Mus_musculus,Dapk1,death-associated protein kinase 1 isoform 1,159333
NP_954599.2,60782154,60785145,-1,13,Mus_musculus,BC051665,uncharacterized protein LOC218275 precursor,2991
NP_081620.2,60798499,60801415,-1,13,Mus_musculus,Ctsll3,cathepsin L-like 3 precursor,2916
NP_835199.1,60842876,60854938,-1,13,Mus_musculus,4930486L24Rik,testin-2 precursor,12062
NP_031823.1,60895710,60896714,-1,13,Mus_musculus,Ctla2b,protein CTLA-2-beta isoform a,1004
NP_080705.1,60901554,60902635,-1,13,Mus_musculus,Tpbpb,trophoblast specific protein beta precursor,1081
NP_001139271.1,60935019,60936044,-1,13,Mus_musculus,Ctla2a,protein CTLA-2-alpha isoform b,1025
NP_033437.2,60939605,60940688,-1,13,Mus_musculus,Tpbpa,trophoblast-specific protein alpha precursor,1083
NP_036137.1,61000476,61004550,-1,13,Mus_musculus,Ctsj,cathepsin J precursor,4074
NP_083912.2,61035294,61039552,-1,13,Mus_musculus,Ctsq,cathepsin Q precursor,4258
NP_064680.1,61159475,61163230,-1,13,Mus_musculus,Ctsr,cathepsin R precursor,3755
NP_067420.1,61195400,61202265,-1,13,Mus_musculus,Cts6,cathepsin 6 precursor,6865
NP_062414.3,61248153,61254081,-1,13,Mus_musculus,Cts8,cathepsin 8 precursor,5928
NP_062412.1,61352735,61357036,-1,13,Mus_musculus,Cts7,cathepsin 7 precursor,4301
NP_071721.2,61536554,61540313,-1,13,Mus_musculus,Ctsm,cathepsin M precursor,3759
NP_081182.2,61564905,61568820,-1,13,Mus_musculus,Cts3,cathepsin 3 precursor,3915
XP_017171149.1,61630022,61636282,1,13,Mus_musculus,LOC108168055,zinc finger protein 120-like,6260
NP_001034328.2,62130025,62173220,1,13,Mus_musculus,Zfp808,zinc finger protein 80,43195
NP_001156382.1,62368862,62383082,-1,13,Mus_musculus,Gm3604,uncharacterized protein LOC100041979,14220
NP_849206.2,62454322,62466709,-1,13,Mus_musculus,Zfp935,KRAB zinc finger protein isoform 1,12387
NP_780461.2,62517499,62520451,-1,13,Mus_musculus,Zfp934,zinc finger protein 934 isoform 2,2952
NP_775557.1,62605189,62624040,-1,13,Mus_musculus,6720489N17Rik,uncharacterized protein LOC211378 isoform 1,18851
NP_001242994.1,62773607,62785683,-1,13,Mus_musculus,Gm5141,zinc-finger protein 80-like,12076
NP_032020.2,62837085,62858297,-1,13,Mus_musculus,Fbp2,"fructose-1,6-bisphosphatase isozyme 2",21212
NP_062268.1,62864975,62888043,-1,13,Mus_musculus,Fbp1,"fructose-1,6-bisphosphatase 1",23068
NP_001276853.1,63015166,63298852,1,13,Mus_musculus,2010111I01Rik,aminopeptidase O,283686
NP_001269871.1,63312665,63398136,-1,13,Mus_musculus,Fancc,Fanconi anemia group C protein homolog isoform 2,85471
NP_032983.1,63511532,63565520,-1,13,Mus_musculus,Ptch1,protein patched homolog 1,53988
NP_075996.2,63815474,63869184,1,13,Mus_musculus,Ercc6l2,DNA excision repair protein ERCC-6-like 2 isoform 2,53710
NP_032317.2,64058568,64089128,-1,13,Mus_musculus,Hsd17b3,testosterone 17-beta-dehydrogenase 3,30560
NP_001001321.2,64097581,64129307,-1,13,Mus_musculus,Slc35d2,UDP-N-acetylglucosamine/UDP-glucose/GDP-mannose transporter,31726
NP_780703.1,64135313,64152989,-1,13,Mus_musculus,Zfp367,zinc finger protein 367,17676
NP_064370.2,64161985,64185329,1,13,Mus_musculus,Habp4,intracellular hyaluronan-binding protein 4,23344
NP_001116461.1,64205302,64248453,-1,13,Mus_musculus,Cdc14b,dual specificity protein phosphatase CDC14B isoform 2,43151
NP_079646.1,64292100,64312684,-1,13,Mus_musculus,Aaed1,thioredoxin-like protein AAED1,20584
NP_034114.1,64364097,64369153,-1,13,Mus_musculus,Ctsl,cathepsin L1 preproprotein,5056
NP_444410.1,64432595,64438978,1,13,Mus_musculus,Cdk20,cyclin-dependent kinase 20,6383
NP_001182364.1,64481763,64486000,-1,13,Mus_musculus,1190003K10Rik,uncharacterized protein LOC68880,4237
NP_001074598.1,64738546,64903840,-1,13,Mus_musculus,Cntnap3,contactin-associated protein-like 3 precursor,165294
NP_084323.2,64917482,64923084,1,13,Mus_musculus,Spata31,spermatogenesis-associated protein 31,5602
NP_001077359.2,65033088,65037207,1,13,Mus_musculus,Spata31d1c,uncharacterized protein LOC238683,4119
NP_598441.3,65066612,65112617,-1,13,Mus_musculus,Mfsd14b,hippocampus abundant transcript-like protein 1,46005
NP_667030.2,65152225,65153152,1,13,Mus_musculus,Olfr466,olfactory receptor 466,927
NP_780499.3,65181563,65199442,-1,13,Mus_musculus,Nlrp4f,"NACHT, LRR and PYD domains-containing protein 4F",17879
NP_848141.3,65278971,65297582,1,13,Mus_musculus,Zfp369,neurotrophin receptor-interacting factor 2,18611
XP_017171167.1,65337304,65348486,-1,13,Mus_musculus,Gm7762,LOW QUALITY PROTEIN: zinc finger protein 431-like,11182
XP_006517561.2,65396979,65415024,-1,13,Mus_musculus,Gm31714,zinc finger protein 431-like,18045
XP_017171170.1,65511861,65512932,1,13,Mus_musculus,LOC102634499,zinc finger protein 431-like,1071
XP_017171151.1,65897274,65907988,1,13,Mus_musculus,Gm17353,zinc finger protein 431-like,10714
XP_017171171.1,65950686,65958927,1,13,Mus_musculus,LOC108168096,zinc finger protein 120-like,8241
NP_001171303.1,66113557,66122836,1,13,Mus_musculus,Gm10324,zinc finger protein family member,9279
XP_017171144.1,66156615,66164048,1,13,Mus_musculus,LOC108167370,zinc finger protein 709-like,7433
XP_017171152.1,66227147,66236670,-1,13,Mus_musculus,LOC105245577,zinc finger protein 431-like,9523
XP_017171172.1,66281715,66284053,-1,13,Mus_musculus,LOC108168097,zinc finger protein 431-like,2338
NP_898942.1,66418244,66441022,-1,13,Mus_musculus,2410141K09Rik,zinc finger protein-like isoform b,22778
XP_017171173.1,66527952,66529383,1,13,Mus_musculus,LOC108168098,zinc finger protein 709-like,1431
XP_017171174.1,66589282,66598489,1,13,Mus_musculus,LOC108167371,zinc finger protein 431-like,9207
XP_017171188.1,66792582,66802467,-1,13,Mus_musculus,LOC105245578,zinc finger protein 120-like,9885
XP_017171189.1,66850721,66862027,-1,13,Mus_musculus,Gm10323,zinc finger protein 431-like,11306
NP_080495.1,66900748,66905311,-1,13,Mus_musculus,Uqcrb,cytochrome b-c1 complex subunit 7,4563
NP_001171221.1,66907944,66908256,1,13,Mus_musculus,Gm10767,uncharacterized protein LOC100038538,312
NP_079823.2,66912183,66930203,-1,13,Mus_musculus,Mterf3,"transcription termination factor 3, mitochondrial precursor",18020
NP_032985.2,66933507,66997077,1,13,Mus_musculus,Ptdss1,phosphatidylserine synthase 1,63570
NP_001159690.1,67040343,67061068,-1,13,Mus_musculus,Zfp712,zinc finger protein 712,20725
NP_001278995.1,67070167,67074866,-1,13,Mus_musculus,Zfp708,zinc finger protein 708 isoform d,4699
NP_001242981.1,67098163,67113981,-1,13,Mus_musculus,Rslcan18,regulator of sex-limitation candidate 18,15818
NP_765980.3,67128308,67140552,1,13,Mus_musculus,Zfp759,zinc finger protein 759,12244
NP_001013791.1,67173217,67182947,1,13,Mus_musculus,Rsl1,regulator of sex limited protein 1,9730
NP_001041669.1,67194588,67208055,1,13,Mus_musculus,Zfp455,zinc finger protein 455,13467
NP_001001152.1,67256114,67269036,-1,13,Mus_musculus,Zfp458,zinc finger protein 728,12922
NP_001003666.2,67292565,67306355,-1,13,Mus_musculus,Zfp457,zinc finger protein 457,13790
NP_808290.1,67316328,67332472,-1,13,Mus_musculus,Zfp595,zin finger protein 595,16144
NP_001033740.1,67342971,67360509,-1,13,Mus_musculus,Zfp953,zinc finger protein 953,17538
NP_001001186.3,67366208,67372874,-1,13,Mus_musculus,Zfp456,zinc finger protein 456,6666
NP_001074410.1,67389865,67399731,-1,13,Mus_musculus,Zfp429,zinc finger protein 429,9866
NP_808479.1,67408158,67413957,-1,13,Mus_musculus,Zfp459,zinc finger protein 459,5799
NP_808380.1,67442219,67451517,-1,13,Mus_musculus,Zfp874a,zinc finger protein 874,9298
NP_001070259.1,67473833,67484146,-1,13,Mus_musculus,Zfp874b,zinc finger protein 874b,10313
NP_001007576.1,67490900,67494726,-1,13,Mus_musculus,Zfp58,zinc finger protein 58,3826
NP_573491.2,67516718,67526082,-1,13,Mus_musculus,Zfp87,zinc finger protein 87,9364
NP_001030308.1,67540472,67553036,-1,13,Mus_musculus,Zfp748,zinc finger protein 748,12564
NP_001156718.1,67591006,67609578,-1,13,Mus_musculus,Zfp729b,zinc finger protein,18572
NP_898969.2,67619186,67637682,-1,13,Mus_musculus,Zfp729a,uncharacterized protein LOC212281,18496
NP_001001187.2,67669488,67683438,-1,13,Mus_musculus,Zfp738,zinc finger protein 738,13950
NP_663597.1,67707985,67729066,-1,13,Mus_musculus,Zfp65,"zinc finger protein 71, related sequence",21081
NP_001001130.1,67748529,67755068,-1,13,Mus_musculus,Zfp85,zinc finger protein 85,6539
NP_082678.2,67779813,67787084,1,13,Mus_musculus,Zfp493,regulator of sex-limitation candidate 12,7271
NP_938081.2,67813890,67826260,1,13,Mus_musculus,Zfp273,zinc finger protein 273,12370
NP_001296303.1,67833234,67843070,1,13,Mus_musculus,Gm10037,predicted gene 10037,9836
NP_001001185.1,67863505,67863775,1,13,Mus_musculus,BC048507,dynein light chain LC8-type 1-like,270
XP_017171175.1,67885468,67889709,-1,13,Mus_musculus,Gm40991,uncharacterized protein Gm40991,4241
XP_987269.2,67951818,67952544,1,13,Mus_musculus,Gm7969,uncharacterized protein Gm7969,726
XP_017171145.1,68444522,68447939,-1,13,Mus_musculus,LOC108168045,endogenous retrovirus group K member 25 Pol protein-like,3417
NP_766068.1,68562287,68580679,-1,13,Mus_musculus,Mtrr,methionine synthase reductase,18392
NP_081399.3,68583561,68592029,1,13,Mus_musculus,Fastkd3,"FAST kinase domain-containing protein 3, mitochondrial",8468
NP_081311.1,68597475,68613009,1,13,Mus_musculus,1700001L19Rik,uncharacterized protein C5orf49 homolog,15534
NP_705762.2,68620719,68999295,-1,13,Mus_musculus,Adcy2,adenylate cyclase type 2,378576
NP_001162602.1,69499915,69515869,-1,13,Mus_musculus,Papd7,non-canonical poly(A) RNA polymerase PAPD7 isoform 2,15954
XP_011242908.2,69534560,69535196,1,13,Mus_musculus,LOC105245580,uncharacterized protein LOC105245580,636
NP_780492.2,69575129,69611247,-1,13,Mus_musculus,Srd5a1,3-oxo-5-alpha-steroid 4-dehydrogenase 1,36118
NP_663329.3,69612092,69633851,1,13,Mus_musculus,Nsun2,tRNA (cytosine(34)-C(5))-methyltransferase,21759
NP_001138634.1,69704041,69739340,-1,13,Mus_musculus,Ube2ql1,ubiquitin-conjugating enzyme E2Q-like protein 1,35299
NP_613062.1,69809930,69815689,1,13,Mus_musculus,Med10,mediator of RNA polymerase II transcription subunit 10,5759
NP_659086.2,70589600,70637597,-1,13,Mus_musculus,Ice1,little elongation complex subunit 1,47997
NP_742050.2,70728851,70841549,-1,13,Mus_musculus,Adamts16,A disintegrin and metalloproteinase with thrombospondin motifs 16 precursor,112698
NP_084149.1,70883475,70884239,1,13,Mus_musculus,8030423J24Rik,uncharacterized protein LOC77166,764
NP_034703.2,71958615,71963488,-1,13,Mus_musculus,Irx1,iroquois-class homeodomain protein IRX-1,4873
NP_034704.1,72629061,72632638,1,13,Mus_musculus,Irx2,iroquois-class homeodomain protein IRX-2,3577
NP_061373.1,73264934,73269034,1,13,Mus_musculus,Irx4,iroquois-class homeodomain protein IRX-4,4100
NP_035018.1,73319994,73328446,-1,13,Mus_musculus,Ndufs6,"NADH dehydrogenase [ubiquinone] iron-sulfur protein 6, mitochondrial precursor",8452
NP_444393.1,73331372,73331681,1,13,Mus_musculus,Mrpl36,"39S ribosomal protein L36, mitochondrial",309
NP_663351.3,73467382,73514538,1,13,Mus_musculus,Lpcat1,lysophosphatidylcholine acyltransferase 1,47156
NP_034150.1,73538515,73577233,1,13,Mus_musculus,Slc6a3,sodium-dependent dopamine transporter,38718
NP_666159.2,73604237,73620117,1,13,Mus_musculus,Clptm1l,cleft lip and palate transmembrane protein 1-like protein,15880
NP_033380.1,73627029,73649013,1,13,Mus_musculus,Tert,telomerase reverse transcriptase,21984
NP_001129559.1,73664121,73677929,-1,13,Mus_musculus,Slc6a18,sodium-dependent neutral amino acid transporter B(0)AT3 isoform 2,13808
NP_083154.1,73681628,73700633,-1,13,Mus_musculus,Slc6a19,sodium-dependent neutral amino acid transporter B(0)AT1,19005
NP_082056.1,73700035,73708960,1,13,Mus_musculus,Slc6a19os,uncharacterized protein LOC71390,8925
NP_035520.1,73763766,73814934,1,13,Mus_musculus,Slc12a7,solute carrier family 12 member 7,51168
NP_082462.3,73820959,73847427,-1,13,Mus_musculus,Nkd2,protein naked cuticle homolog 2,26468
NP_081458.1,73913243,73937581,-1,13,Mus_musculus,Trip13,pachytene checkpoint protein 2 homolog,24338
NP_001019679.2,73937893,73960338,1,13,Mus_musculus,Brd9,bromodomain-containing protein 9 isoform 1,22445
NP_081980.1,73963920,73992642,1,13,Mus_musculus,Zdhhc11,probable palmitoyltransferase ZDHHC11,28722
NP_878259.1,74021142,74031415,1,13,Mus_musculus,Tppp,tubulin polymerization-promoting protein,10273
NP_083235.3,74038162,74062262,-1,13,Mus_musculus,Cep72,centrosomal protein of 72 kDa,24100
NP_001074529.1,74121514,74166064,1,13,Mus_musculus,Slc9a3,sodium/hydrogen exchanger 3 precursor,44550
NP_796307.2,74172072,74207080,-1,13,Mus_musculus,Exoc3,exocyst complex component 3,35008
NP_001304280.1,74213656,74229938,-1,13,Mus_musculus,Ahrr,aryl hydrocarbon receptor repressor isoform 2,16282
NP_035181.1,74303949,74317207,-1,13,Mus_musculus,Pdcd6,programmed cell death protein 6,13258
NP_075770.1,74323086,74350208,-1,13,Mus_musculus,Sdha,"succinate dehydrogenase [ubiquinone] flavoprotein subunit, mitochondrial precursor",27122
NP_077163.1,74352865,74357117,1,13,Mus_musculus,Ccdc127,coiled-coil domain-containing protein 127 isoform 1,4252
NP_001028214.1,74360753,74363959,-1,13,Mus_musculus,Lrrc14b,leucine-rich repeat-containing protein 14B,3206
NP_001075149.1,74371649,74376469,-1,13,Mus_musculus,Zfp72,zinc finger protein 72,4820
NP_666343.1,74480516,74493852,-1,13,Mus_musculus,Zfp825,zinc finger protein 124,13336
NP_109636.1,74646223,74690729,1,13,Mus_musculus,Erap1,endoplasmic reticulum aminopeptidase 1 precursor,44506
NP_001288089.1,74695898,74734177,-1,13,Mus_musculus,Cast,calpastatin isoform 7,38279
NP_038656.1,75090061,75132319,1,13,Mus_musculus,Pcsk1,neuroendocrine convertase 1 precursor,42258
NP_620403.2,75707650,75770796,1,13,Mus_musculus,Ell2,RNA polymerase II elongation factor ELL2,63146
NP_444338.2,75839968,75847286,1,13,Mus_musculus,Glrx,glutaredoxin-1,7318
NP_082769.1,75872345,75943532,-1,13,Mus_musculus,Rhobtb3,rho-related BTB domain-containing protein 3,71187
NP_083619.1,75967833,75998769,1,13,Mus_musculus,Spata9,spermatogenesis-associated protein 9,30936
NP_849247.3,76002824,76008285,-1,13,Mus_musculus,Rfesd,Rieske domain-containing protein,5461
NP_780704.1,76055540,76056824,-1,13,Mus_musculus,Gpr150,probable G-protein coupled receptor 150,1284
NP_084123.2,76062255,76098508,-1,13,Mus_musculus,Arsk,arylsulfatase K precursor,36253
NP_001074821.1,76108193,76187674,1,13,Mus_musculus,Ttc37,tetratricopeptide repeat protein 37,79481
NP_084450.2,76641765,77029951,1,13,Mus_musculus,Mctp1,multiple C2 and transmembrane domain-containing protein 1,388186
NP_598832.3,77043548,77126714,-1,13,Mus_musculus,Slf1,SMC5-SMC6 complex localization factor protein 1,83166
NP_001074822.1,77174853,77193228,1,13,Mus_musculus,2210408I21Rik,uncharacterized protein KIAA0825 homolog isoform 2,18375
NP_612185.1,77742780,78163655,1,13,Mus_musculus,Fam172a,protein FAM172A isoform 1 precursor,420875
NP_034281.2,78189732,78198573,-1,13,Mus_musculus,Nr2f1,COUP transcription factor 1,8841
NP_001036056.1,80883649,80893426,1,13,Mus_musculus,Arrdc3,arrestin domain-containing protein 3,9777
NP_473394.3,81095382,81633028,-1,13,Mus_musculus,Adgrv1,G-protein coupled receptor 98 precursor,537646
NP_084533.1,81665014,81669823,1,13,Mus_musculus,Lysmd3,lysM and putative peptidoglycan-binding domain-containing protein 3,4809
NP_001074645.1,81676035,81699860,-1,13,Mus_musculus,Polr3g,DNA-directed RNA polymerase III subunit RPC7,23825
NP_082648.1,81711528,81750346,1,13,Mus_musculus,Mblac2,metallo-beta-lactamase domain-containing protein 2,38818
NP_031710.1,81783340,81796697,1,13,Mus_musculus,Cetn3,centrin-3,13357
NP_001164008.1,83575676,83662631,1,13,Mus_musculus,Mef2c,myocyte-specific enhancer factor 2C isoform 1,86955
NP_780396.2,84222431,84294880,1,13,Mus_musculus,Tmem161b,transmembrane protein 161B,72449
NP_075732.1,85189535,85212778,1,13,Mus_musculus,Ccnh,cyclin-H,23243
NP_663427.2,85216103,85288907,-1,13,Mus_musculus,Rasa1,ras GTPase-activating protein 1,72804
NP_031775.1,86045752,86046675,-1,13,Mus_musculus,Cox7c,"cytochrome c oxidase subunit 7C, mitochondrial precursor",923
NP_001033076.1,88821981,89319820,1,13,Mus_musculus,Edil3,EGF-like repeat and discoidin I-like domain-containing protein 3 isoform a precursor,497839
NP_038528.3,89584721,89608149,1,13,Mus_musculus,Hapln1,hyaluronan and proteoglycan link protein 1 precursor,23428
NP_001127947.1,89657230,89731528,-1,13,Mus_musculus,Vcan,versican core protein isoform 4 precursor,74298
NP_082288.1,89849357,90071679,-1,13,Mus_musculus,Xrcc4,DNA repair protein XRCC4,222322
NP_079611.2,90089780,90104445,1,13,Mus_musculus,Tmem167,protein kish-A precursor,14665
NP_001139351.1,90883550,90905292,-1,13,Mus_musculus,Atp6ap1l,V-type proton ATPase subunit S1-like protein precursor,21742
NP_077137.1,90923195,90924683,1,13,Mus_musculus,Rps23,40S ribosomal protein S23,1488
NP_080046.3,90936602,91208422,-1,13,Mus_musculus,Atg10,ubiquitin-like-conjugating enzyme ATG10,271820
NP_077234.2,91461186,91700695,1,13,Mus_musculus,Ssbp2,single-stranded DNA-binding protein 2 isoform 2,239509
NP_083066.1,91741530,91784780,1,13,Mus_musculus,Acot12,acyl-coenzyme A thioesterase 12,43250
NP_663428.2,91797135,91806134,-1,13,Mus_musculus,Zcchc9,zinc finger CCHC domain-containing protein 9,8999
NP_940807.1,91853528,91865333,-1,13,Mus_musculus,Ckmt2,"creatine kinase S-type, mitochondrial precursor",11805
NP_033053.2,91884431,92131494,-1,13,Mus_musculus,Rasgrf2,ras-specific guanine nucleotide-releasing factor 2,247063
NP_001298049.1,92212434,92354900,-1,13,Mus_musculus,Msh3,DNA mismatch repair protein Msh3 isoform 2,142466
NP_034179.1,92355258,92384803,1,13,Mus_musculus,Dhfr,dihydrofolate reductase,29545
NP_780664.2,92438261,92439788,1,13,Mus_musculus,Ankrd34b,ankyrin repeat domain-containing protein 34B,1527
NP_001157099.1,92450083,92483952,-1,13,Mus_musculus,Fam151b,protein FAM151B,33869
NP_775568.1,92488461,92524299,-1,13,Mus_musculus,Zfyve16,zinc finger FYVE domain-containing protein 16,35838
NP_084513.3,92574829,92575966,-1,13,Mus_musculus,Spz1,spermatogenic leucine zipper protein 1,1137
NP_766176.1,92611260,92708137,1,13,Mus_musculus,Serinc5,serine incorporator 5,96877
NP_035712.1,92751750,92794673,-1,13,Mus_musculus,Thbs4,thrombospondin-4 precursor,42923
NP_001156417.1,92844786,92852894,1,13,Mus_musculus,Mtx3,metaxin-3,8108
NP_076310.2,93041313,93144506,-1,13,Mus_musculus,Cmya5,cardiomyopathy-associated protein 5,103193
NP_598666.1,93147590,93186439,-1,13,Mus_musculus,Papd4,poly(A) RNA polymerase GLD2,38849
NP_036112.1,93305297,93356113,1,13,Mus_musculus,Homer1,homer protein homolog 1 isoform S,50816
NP_067285.2,93439441,93499306,-1,13,Mus_musculus,Jmy,junction-mediating and -regulatory protein,59865
XP_889797.1,93448487,93448835,1,13,Mus_musculus,Gm6109,60S ribosomal protein L30-like,348
NP_057877.1,93617475,93637496,-1,13,Mus_musculus,Bhmt,betaine--homocysteine S-methyltransferase 1,20021
NP_075022.2,93657062,93674270,-1,13,Mus_musculus,Bhmt2,S-methylmethionine--homocysteine S-methyltransferase BHMT2,17208
NP_083048.1,93674446,93752465,1,13,Mus_musculus,Dmgdh,"dimethylglycine dehydrogenase, mitochondrial precursor",78019
NP_033842.3,93771777,93940731,1,13,Mus_musculus,Arsb,arylsulfatase B precursor,168954
NP_766177.1,94174223,94192101,1,13,Mus_musculus,Lhfpl2,lipoma HMGIC fusion partner-like 2 protein,17878
NP_083429.1,94203998,94285276,-1,13,Mus_musculus,Scamp1,secretory carrier-associated membrane protein 1,81278
NP_033810.2,94359103,94565758,1,13,Mus_musculus,Ap3b1,AP-3 complex subunit beta-1,206655
NP_033347.1,94788949,94842730,1,13,Mus_musculus,Tbca,tubulin-specific chaperone A,53781
NP_035151.1,94875769,94883620,1,13,Mus_musculus,Otp,homeobox protein orthopedia,7851
NP_766178.2,94976538,95021825,1,13,Mus_musculus,Wdr41,WD repeat-containing protein 41,45287
NP_001164140.1,95026119,95222813,-1,13,Mus_musculus,Pde8b,"high affinity cAMP-specific and IBMX-insensitive 3',5'-cyclic phosphodiesterase 8B isoform 1",196694
NP_082382.1,95336069,95336756,1,13,Mus_musculus,Zbed3,zinc finger BED domain-containing protein 3,687
NP_079906.2,95351501,95375058,-1,13,Mus_musculus,Aggf1,angiogenic factor with G patch and FHA domains 1,23557
NP_940800.1,95431936,95444680,-1,13,Mus_musculus,Crhbp,corticotropin-releasing factor-binding protein precursor,12744
NP_001074628.1,95477300,95478655,-1,13,Mus_musculus,S100z,protein S100-Z,1355
NP_032000.3,95513172,95525127,-1,13,Mus_musculus,F2rl1,proteinase-activated receptor 2 precursor,11955
NP_034299.2,95603732,95618374,-1,13,Mus_musculus,F2r,proteinase-activated receptor 1 precursor,14642
NP_081987.1,95628006,95891709,-1,13,Mus_musculus,Iqgap2,ras GTPase-activating-like protein IQGAP2,263703
NP_034300.3,95697063,95701558,1,13,Mus_musculus,F2rl2,proteinase-activated receptor 3 precursor,4495
NP_083486.1,95961279,96088799,-1,13,Mus_musculus,Sv2c,synaptic vesicle glycoprotein 2C,127520
NP_080449.1,96391597,96414619,1,13,Mus_musculus,Poc5,centrosomal protein POC5,23022
NP_001036179.1,96417838,96470948,-1,13,Mus_musculus,Ankdd1b,ankyrin repeat and death domain-containing protein 1B,53110
NP_036178.1,96482169,96519160,-1,13,Mus_musculus,Polk,DNA polymerase kappa,36991
NP_075909.1,96543163,96635877,1,13,Mus_musculus,Col4a3bp,collagen type IV alpha-3-binding protein isoform 1,92714
NP_032281.2,96650578,96666685,-1,13,Mus_musculus,Hmgcr,3-hydroxy-3-methylglutaryl-coenzyme A reductase,16107
XP_006517860.1,96748531,96909641,1,13,Mus_musculus,Ankrd31,putative ankyrin repeat domain-containing protein 31,161110
NP_001159537.1,96946197,96947565,1,13,Mus_musculus,Gcnt4,"beta-1,3-galactosyl-O-glycosyl-glycoprotein beta-1,6-N-acetylglucosaminyltransferase 4",1368
NP_001271134.1,97022450,97034265,-1,13,Mus_musculus,1700029F12Rik,uncharacterized protein LOC66479 isoform 3,11815
NP_001093928.1,97091820,97127038,1,13,Mus_musculus,Fam169a,soluble lamin-associated protein of 75 kDa,35218
NP_067527.3,97131160,97137757,-1,13,Mus_musculus,Nsa2,ribosome biogenesis protein NSA2 homolog,6597
NP_796240.3,97141947,97175737,1,13,Mus_musculus,Gfm2,"ribosome-releasing factor 2, mitochondrial isoform 1",33790
NP_034552.1,97176528,97198261,-1,13,Mus_musculus,Hexb,beta-hexosaminidase subunit beta precursor,21733
NP_031956.3,97244983,97246753,1,13,Mus_musculus,Enc1,ectoderm-neural cortex protein 1,1770
NP_036156.2,97899646,98145584,-1,13,Mus_musculus,Arhgef28,rho guanine nucleotide exchange factor 28,245938
NP_849249.1,98249128,98260888,-1,13,Mus_musculus,Utp15,U3 small nucleolar RNA-associated protein 15 homolog,11760
NP_001258317.1,98266246,98272884,1,13,Mus_musculus,Ankra2,ankyrin repeat family A protein 2 isoform a,6638
XP_006517862.1,98279905,98307092,1,13,Mus_musculus,LOC102637808,low-density lipoprotein receptor class A domain-containing protein 1-like,27187
NP_001164011.1,98310154,98316298,-1,13,Mus_musculus,Btf3,transcription factor BTF3 isoform 2,6144
NP_032268.2,98354619,98355990,1,13,Mus_musculus,Foxd1,forkhead box protein D1,1371
NP_080961.1,98636407,98637320,-1,13,Mus_musculus,Tmem174,transmembrane protein 174,913
NP_001020777.1,98686320,98692640,-1,13,Mus_musculus,Tmem171,transmembrane protein 171,6320
NP_766179.2,98725753,98815108,-1,13,Mus_musculus,Fcho2,F-BAR domain only protein 2,89355
NP_001041732.1,98846455,98890781,-1,13,Mus_musculus,Tnpo1,transportin-1 isoform 2,44326
NP_081340.1,98984144,98984516,-1,13,Mus_musculus,1700024P04Rik,histone H2B subacrosomal variant,372
XP_017171186.1,98988927,98990880,-1,13,Mus_musculus,Gm41035,uncharacterized protein Gm41035,1953
NP_001004149.1,99228332,99246571,1,13,Mus_musculus,Zfp366,zinc finger protein 366,18239
NP_081149.1,99320168,99344669,-1,13,Mus_musculus,Ptcd2,"pentatricopeptide repeat-containing protein 2, mitochondrial",24501
NP_776118.2,99344802,99414978,1,13,Mus_musculus,Mrps27,"28S ribosomal protein S27, mitochondrial",70176
NP_032660.2,99425805,99516487,-1,13,Mus_musculus,Map1b,microtubule-associated protein 1B,90682
NP_001074962.1,99898918,99900634,-1,13,Mus_musculus,Cartpt,cocaine- and amphetamine-regulated transcript protein isoform 2 preproprotein,1716
NP_084302.1,99948838,100015514,-1,13,Mus_musculus,Mccc2,"methylcrotonoyl-CoA carboxylase beta chain, mitochondrial",66676
NP_001074530.1,100020278,100103838,-1,13,Mus_musculus,Bdp1,transcription factor TFIIIB component B'' homolog,83560
NP_035483.1,100108222,100114037,1,13,Mus_musculus,Serf1,small EDRK-rich factor 1,5815
NP_035550.1,100124893,100135736,1,13,Mus_musculus,Smn1,survival motor neuron protein isoform 1,10843
NP_035002.2,100144358,100189398,-1,13,Mus_musculus,Naip2,baculoviral IAP repeat-containing protein 1b,45040
NP_035000.2,100212606,100246199,-1,13,Mus_musculus,Naip5,baculoviral IAP repeat-containing protein 1e,33593
NP_035001.2,100283548,100316551,-1,13,Mus_musculus,Naip6,baculoviral IAP repeat-containing protein 1f,33003
NP_032696.2,100408806,100444737,-1,13,Mus_musculus,Naip1,baculoviral IAP repeat-containing protein 1a,35931
NP_071294.3,100468906,100490131,-1,13,Mus_musculus,Gtf2h2,general transcription factor IIH subunit 2,21225
NP_032782.1,100498813,100541117,-1,13,Mus_musculus,Ocln,occludin,42304
NP_001033691.1,100597288,100612569,-1,13,Mus_musculus,Marveld2,MARVEL domain-containing protein 2 isoform 1,15281
NP_001269940.1,100617643,100633910,-1,13,Mus_musculus,Rad17,cell cycle checkpoint protein RAD17 isoform 2,16267
NP_081868.1,100651417,100666019,1,13,Mus_musculus,Ak6,adenylate kinase isoenzyme 6,14602
NP_001161858.1,100677913,100696118,1,13,Mus_musculus,Ccdc125,coiled-coil domain-containing protein 125 isoform B,18205
NP_034004.2,100703477,100730839,-1,13,Mus_musculus,Cdk7,cyclin-dependent kinase 7,27362
NP_001177193.1,100736255,100744568,-1,13,Mus_musculus,Mrps36,"28S ribosomal protein S36, mitochondrial isoform 2",8313
NP_068686.1,100760101,100775802,-1,13,Mus_musculus,Cenph,centromere protein H,15701
NP_758505.2,100779677,100786402,-1,13,Mus_musculus,Ccnb1,G2/mitotic-specific cyclin-B1,6725
NP_075023.2,100803290,100833177,-1,13,Mus_musculus,Slc30a5,zinc transporter 5,29887
NP_001020126.1,101684879,101692288,-1,13,Mus_musculus,Pik3r1,phosphatidylinositol 3-kinase regulatory subunit alpha isoform 1,7409
NP_032559.2,102693699,102706433,1,13,Mus_musculus,Cd180,CD180 antigen precursor,12734
NP_780380.2,102735001,103334192,-1,13,Mus_musculus,Mast4,microtubule-associated serine/threonine-protein kinase 4,599191
NP_766180.1,103743563,103763953,-1,13,Mus_musculus,Srek1,splicing regulatory glutamine/lysine-rich protein 1,20390
NP_001276403.1,103820698,103886329,-1,13,Mus_musculus,Erbb2ip,protein LAP2 isoform 4,65631
XP_006517866.1,103920289,103921822,1,13,Mus_musculus,D130037M23Rik,translation initiation factor IF-2,1533
NP_083723.1,104024945,104109456,-1,13,Mus_musculus,Nln,"neurolysin, mitochondrial precursor",84511
NP_659087.1,104111089,104139851,1,13,Mus_musculus,Sgtb,small glutamine-rich tetratricopeptide repeat-containing protein beta,28762
NP_001087229.1,104144137,104178159,-1,13,Mus_musculus,Trappc13,trafficking protein particle complex subunit 13 isoform 3,34022
NP_109656.1,104181052,104201410,1,13,Mus_musculus,Trim23,E3 ubiquitin-protein ligase TRIM23,20358
NP_766395.2,104205503,104228801,-1,13,Mus_musculus,Ppwd1,peptidylprolyl isomerase domain and WD repeat-containing protein 1,23298
NP_068562.1,104229585,104249519,1,13,Mus_musculus,Cenpk,centromere protein K isoform 1,19934
NP_001074489.1,104294727,104493704,1,13,Mus_musculus,Adamts6,A disintegrin and metalloproteinase with thrombospondin motifs 6 precursor,198977
NP_080348.1,104631575,104816728,-1,13,Mus_musculus,Cwc27,peptidyl-prolyl cis-trans isomerase CWC27 homolog,185153
NP_080351.2,104817353,104837548,1,13,Mus_musculus,Srek1ip1,protein SREK1IP1,20195
NP_084260.1,104845935,104863713,-1,13,Mus_musculus,Fam159b,membrane protein FAM159B,17778
NP_084155.2,104951490,105054214,-1,13,Mus_musculus,Rgs7bp,regulator of G-protein signaling 7-binding protein,102724
NP_080027.1,105082159,105121421,1,13,Mus_musculus,4933425L06Rik,uncharacterized protein LOC66763,39262
NP_082210.1,105149351,105271039,-1,13,Mus_musculus,Rnf180,E3 ubiquitin-protein ligase RNF180,121688
NP_032334.2,105444253,105445519,1,13,Mus_musculus,Htr1a,5-hydroxytryptamine receptor 1A,1266
XP_017171187.1,106737946,106760764,-1,13,Mus_musculus,Gm30411,uncharacterized protein Gm30411,22818
NP_083941.2,106795630,106925150,-1,13,Mus_musculus,Ipo11,importin-11,129520
NP_079723.1,106947204,106958697,1,13,Mus_musculus,Dimt1,probable dimethyladenosine transferase,11493
NP_032468.2,106962138,106993925,-1,13,Mus_musculus,Kif2a,kinesin-like protein KIF2A isoform 1,31787
NP_663431.2,107726434,107890049,-1,13,Mus_musculus,Zswim6,zinc finger SWIM domain-containing protein 6,163615
NP_001041715.1,108047461,108047686,1,13,Mus_musculus,Smim15,small integral membrane protein 15,225
NP_001120818.1,108052705,108158569,-1,13,Mus_musculus,Ndufaf2,"mimitin, mitochondrial",105864
NP_082318.2,108158793,108194124,1,13,Mus_musculus,Ercc8,DNA excision repair protein ERCC-8,35331
NP_083277.3,108256734,108282681,1,13,Mus_musculus,Elovl7,elongation of very long chain fatty acids protein 7,25947
NP_848798.1,108316421,108388702,1,13,Mus_musculus,Depdc1b,DEP domain-containing protein 1B,72281
NP_035186.1,108860165,109951344,1,13,Mus_musculus,Pde4d,"cAMP-specific 3',5'-cyclic phosphodiesterase 4D",1091179
NP_076341.1,110061814,110280018,-1,13,Mus_musculus,Rab3c,ras-related protein Rab-3C,218204
NP_808381.1,110353653,110354127,-1,13,Mus_musculus,Gapt,protein GAPT,474
NP_690017.2,110395176,110400224,1,13,Mus_musculus,Plk2,serine/threonine-protein kinase PLK2,5048
NP_780706.1,111255132,111256263,1,13,Mus_musculus,Actbl2,beta-actin-like protein 2,1131
NP_001116435.1,111426492,111466913,-1,13,Mus_musculus,Gpbp1,vasculin isoform 1,40421
NP_766181.2,111686345,111715141,1,13,Mus_musculus,Mier3,mesoderm induction early response protein 3,28796
NP_036075.2,111748899,111808969,-1,13,Mus_musculus,Map3k1,mitogen-activated protein kinase kinase kinase 1,60070
NP_001161877.1,112288927,112344228,1,13,Mus_musculus,Ankrd55,ankyrin repeat domain-containing protein 55 isoform 4,55301
NP_034690.3,112475045,112504445,1,13,Mus_musculus,Il6st,interleukin-6 receptor subunit beta precursor,29400
NP_647460.2,112523902,112559202,-1,13,Mus_musculus,Il31ra,interleukin-31 receptor subunit alpha precursor,35300
NP_034159.1,112598944,112651403,-1,13,Mus_musculus,Ddx4,probable ATP-dependent RNA helicase DDX4 isoform 2,52459
NP_848861.1,112669621,112731664,1,13,Mus_musculus,Slc38a9,sodium-coupled neutral amino acid transporter 9,62043
NP_032273.1,112801208,112867568,1,13,Mus_musculus,Plpp1,phospholipid phosphatase 1 isoform 1,66360
NP_082427.1,112867942,112927357,-1,13,Mus_musculus,Skiv2l2,superkiller viralicidic activity 2-like 2,59415
NP_766182.2,112927792,112969187,1,13,Mus_musculus,Dhx29,ATP-dependent RNA helicase Dhx29,41395
NP_001074531.1,112987897,112990057,1,13,Mus_musculus,Ccno,cyclin-O,2160
NP_001033003.1,112993871,112999184,1,13,Mus_musculus,Mcidas,multicilin,5313
NP_001268416.1,113035378,113091135,1,13,Mus_musculus,Cdc20b,cell division cycle protein 20 homolog B,55757
NP_081403.1,113043135,113046375,-1,13,Mus_musculus,Gpx8,probable glutathione peroxidase 8,3240
NP_034500.1,113093891,113100951,-1,13,Mus_musculus,Gzma,granzyme A precursor,7060
NP_032222.1,113171873,113180897,-1,13,Mus_musculus,Gzmk,granzyme K precursor,9024
NP_076101.1,113209842,113216740,1,13,Mus_musculus,Esm1,endothelial cell-specific molecule 1 precursor,6898
NP_570614.2,113594608,113618395,-1,13,Mus_musculus,Snx18,sorting nexin-18,23787
NP_064344.1,113663027,113663492,-1,13,Mus_musculus,Hspb3,heat shock protein beta-3,465
NP_766183.1,113794648,114154856,1,13,Mus_musculus,Arl15,ADP-ribosylation factor-like protein 15,360208
NP_035017.2,114288762,114388056,-1,13,Mus_musculus,Ndufs4,"NADH dehydrogenase [ubiquinone] iron-sulfur protein 4, mitochondrial",99294
NP_032072.1,114453422,114458586,-1,13,Mus_musculus,Fst,follistatin isoform 2 precursor,5164
NP_038854.2,114818305,114820928,1,13,Mus_musculus,Mocs2,molybdopterin synthase sulfur carrier subunit isoform Mocs2A,2623
NP_032422.2,114836484,114931933,-1,13,Mus_musculus,Itga2,integrin alpha-2 precursor,95449
NP_001028400.2,114960089,115101531,-1,13,Mus_musculus,Itga1,integrin alpha-1 precursor,141442
NP_067434.3,116299479,116309422,-1,13,Mus_musculus,Isl1,insulin gene enhancer protein ISL-1,9943
NP_001074478.1,116855189,117025470,-1,13,Mus_musculus,Parp8,poly [ADP-ribose] polymerase 8,170281
NP_034460.3,117220848,117273062,1,13,Mus_musculus,Emb,embigin precursor,52214
NP_034538.2,117602703,117976234,1,13,Mus_musculus,Hcn1,potassium/sodium hyperpolarization-activated cyclic nucleotide-gated channel 1,373531
NP_067531.1,118380352,118387234,-1,13,Mus_musculus,Mrps30,"28S ribosomal protein S30, mitochondrial",6882
NP_032028.1,118715383,118789316,1,13,Mus_musculus,Fgf10,fibroblast growth factor 10 precursor,73933
NP_001295435.1,119336256,119404702,-1,13,Mus_musculus,Nnt,"NAD(P) transhydrogenase, mitochondrial isoform 2",68446
NP_663432.1,119429132,119457081,1,13,Mus_musculus,Paip1,polyadenylate-binding protein-interacting protein 1 isoform 1,27949
NP_080403.4,119466103,119485917,1,13,Mus_musculus,4833420G17Rik,uncharacterized protein C5orf34 homolog,19814
NP_001171137.1,119492634,119495470,1,13,Mus_musculus,Gm7120,transmembrane protein C5orf28 homolog precursor,2836
NP_064675.1,119623872,119651066,1,13,Mus_musculus,Ccl28,C-C motif chemokine 28 precursor,27194
NP_666054.2,119699673,119706478,1,13,Mus_musculus,Hmgcs1,"hydroxymethylglutaryl-CoA synthase, cytoplasmic",6805
NP_780747.1,119712045,119727871,-1,13,Mus_musculus,Nim1k,serine/threonine-protein kinase NIM1,15826
NP_082521.1,119766351,119790272,-1,13,Mus_musculus,Zfp131,zinc finger protein 131 isoform 2,23921
XP_017171146.1,119790270,119791542,1,13,Mus_musculus,LOC108168049,translation initiation factor IF-2-like,1272
NP_001001449.1,119828166,119828658,-1,13,Mus_musculus,AF067063,uncharacterized protein LOC380878,492
NP_061226.1,119893578,119894094,-1,13,Mus_musculus,Tcstv1,"2-cell-stage, variable group, member 1",516
NP_001297561.1,119912236,119912752,-1,13,Mus_musculus,LOC106029237,"2-cell-stage, variable group-like",516
NP_001028941.1,119949546,119950068,-1,13,Mus_musculus,B020031M17Rik,uncharacterized protein LOC333467,522
XP_011243021.1,119968136,119968666,1,13,Mus_musculus,Gm41080,LOW QUALITY PROTEIN: annexin-2 receptor,530
XP_006517870.1,120026438,120027011,-1,13,Mus_musculus,Gm36079,annexin-2 receptor-like,573
NP_001289895.1,120034758,120035331,-1,13,Mus_musculus,Gm21188,"predicted gene, 21188",573
NP_001034737.2,120154626,120155136,1,13,Mus_musculus,Gm20767,"2-cell-stage, variable group, member 1-like",510
XP_011243019.1,120173183,120173696,1,13,Mus_musculus,Gm21818,uncharacterized protein Gm21818,513
NP_951015.1,120263801,120264317,1,13,Mus_musculus,AF067061,uncharacterized protein LOC236546,516
NP_001033014.1,120308145,120308649,1,13,Mus_musculus,BC147527,"2-cell-stage, variable group, member 3-like",504
NP_705743.1,120317566,120318076,1,13,Mus_musculus,Tcstv3,"2-cell-stage, variable group, member 3",510
NP_443141.3,140307,182323,1,5,Homo_sapiens,PLEKHG4B,pleckstrin homology domain-containing family G member 4B,42016
NP_001073947.1,191538,195353,1,5,Homo_sapiens,LRRC14B,leucine-rich repeat-containing protein 14B,3815
NP_660308.1,205296,216849,-1,5,Homo_sapiens,CCDC127,coiled-coil domain-containing protein 127,11553
NP_004159.2,218355,256420,1,5,Homo_sapiens,SDHA,"succinate dehydrogenase [ubiquinone] flavoprotein subunit, mitochondrial isoform 1",38065
NP_001254488.1,271720,314418,1,5,Homo_sapiens,PDCD6,programmed cell death protein 6 isoform 5,42698
NP_009208.2,446205,466898,1,5,Homo_sapiens,EXOC3,exocyst complex component 3,20693
NP_001271280.1,473378,524322,-1,5,Homo_sapiens,SLC9A3,sodium/hydrogen exchanger 3 isoform 2,50944
NP_060610.2,612361,653153,1,5,Homo_sapiens,CEP72,centrosomal protein of 72 kDa,40792
NP_008961.1,665101,678060,-1,5,Homo_sapiens,TPPP,tubulin polymerization-promoting protein,12959
NP_079062.1,801106,850602,-1,5,Homo_sapiens,ZDHHC11,probable palmitoyltransferase ZDHHC11,49496
NP_001304880.1,864467,889699,-1,5,Homo_sapiens,BRD9,bromodomain-containing protein 9 isoform 3,25232
NP_001159732.1,892998,908465,1,5,Homo_sapiens,TRIP13,pachytene checkpoint protein 2 homolog isoform 2,15467
NP_001258011.1,1009057,1037668,1,5,Homo_sapiens,NKD2,protein naked cuticle homolog 2 isoform 2,28611
NP_006589.2,1052359,1111991,-1,5,Homo_sapiens,SLC12A7,solute carrier family 12 member 7,59632
NP_001003841.1,1201650,1221904,1,5,Homo_sapiens,SLC6A19,sodium-dependent neutral amino acid transporter B(0)AT1,20254
NP_872438.2,1225477,1246078,1,5,Homo_sapiens,SLC6A18,sodium-dependent neutral amino acid transporter B(0)AT3,20601
NP_001180305.1,1253727,1294989,-1,5,Homo_sapiens,TERT,telomerase reverse transcriptase isoform 2,41262
NP_110409.2,1318368,1344841,-1,5,Homo_sapiens,CLPTM1L,cleft lip and palate transmembrane protein 1-like protein,26473
NP_001035.1,1394734,1443197,-1,5,Homo_sapiens,SLC6A3,sodium-dependent dopamine transporter,48463
NP_079106.3,1463650,1523844,-1,5,Homo_sapiens,LPCAT1,lysophosphatidylcholine acyltransferase 1,60194
NP_115868.1,1798623,1798935,-1,5,Homo_sapiens,MRPL36,"39S ribosomal protein L36, mitochondrial",312
NP_004544.1,1801417,1815916,1,5,Homo_sapiens,NDUFS6,"NADH dehydrogenase [ubiquinone] iron-sulfur protein 6, mitochondrial precursor",14499
NP_001265561.1,1877968,1882647,-1,5,Homo_sapiens,IRX4,iroquois-class homeodomain protein IRX-4 isoform b,4679
NP_001127694.1,2747563,2751413,-1,5,Homo_sapiens,IRX2,iroquois-class homeodomain protein IRX-2,3850
NP_001293078.1,2752264,2753359,1,5,Homo_sapiens,C5orf38,protein CEI isoform 3 precursor,1095
NP_077313.3,3596105,3601040,1,5,Homo_sapiens,IRX1,iroquois-class homeodomain protein IRX-1,4935
NP_620687.2,5140467,5319138,1,5,Homo_sapiens,ADAMTS16,A disintegrin and metalloproteinase with thrombospondin motifs 16 preproprotein,178671
NP_056140.1,5422915,5489330,1,5,Homo_sapiens,ICE1,little elongation complex subunit 1,66415
NP_115662.2,6372502,6378483,-1,5,Homo_sapiens,MED10,mediator of RNA polymerase II transcription subunit 10,5981
NP_001138633.1,6448893,6491349,1,5,Homo_sapiens,UBE2QL1,ubiquitin-conjugating enzyme E2Q-like protein 1,42456
NP_001180384.1,6599925,6632979,-1,5,Homo_sapiens,NSUN2,tRNA (cytosine(34)-C(5))-methyltransferase isoform 2,33054
NP_001311251.1,6633550,6668268,1,5,Homo_sapiens,SRD5A1,3-oxo-5-alpha-steroid 4-dehydrogenase 1 isoform 2,34718
NP_008930.1,6737543,6754945,1,5,Homo_sapiens,PAPD7,non-canonical poly(A) RNA polymerase PAPD7 isoform 1,17402
NP_065433.2,7396296,7826871,1,5,Homo_sapiens,ADCY2,adenylate cyclase type 2,430575
NP_001083053.1,7831849,7851021,-1,5,Homo_sapiens,C5orf49,uncharacterized protein C5orf49,19172
NP_076996.2,7859434,7868083,-1,5,Homo_sapiens,FASTKD3,FAST kinase domain-containing protein 3,8649
NP_076915.2,7869133,7900058,1,5,Homo_sapiens,MTRR,methionine synthase reductase isoform 2,30925
NP_003957.2,9042896,9379946,-1,5,Homo_sapiens,SEMA5A,semaphorin-5A precursor,337050
NP_062545.1,9629132,9630032,-1,5,Homo_sapiens,TAS2R1,taste receptor type 2 member 1,900
NP_001245317.1,10227440,10249873,-1,5,Homo_sapiens,FAM173B,protein FAM173B isoform 2,22433
NP_001293082.1,10250003,10264783,1,5,Homo_sapiens,CCT5,T-complex protein 1 subunit epsilon isoform b,14780
NP_620164.1,10280452,10290762,-1,5,Homo_sapiens,CMBL,carboxymethylenebutenolidase homolog,10310
NP_005876.2,10353898,10433684,1,5,Homo_sapiens,MARCH6,E3 ubiquitin-protein ligase MARCH6 isoform 1,79786
NP_114122.2,10442167,10464947,1,5,Homo_sapiens,ROPN1L,ropporin-1-like protein,22780
NP_001157912.1,10564467,10650113,1,5,Homo_sapiens,ANKRD33B,ankyrin repeat domain-containing protein 33B,85646
NP_001278892.1,10680706,10761068,-1,5,Homo_sapiens,DAP,death-associated protein 1 isoform 1,80362
NP_001275646.1,10973452,11364768,-1,5,Homo_sapiens,CTNND2,catenin delta-2 isoform 4,391316
NP_001360.1,13691983,13944438,-1,5,Homo_sapiens,DNAH5,"dynein heavy chain 5, axonemal",252455
NP_009049.2,14143725,14508422,1,5,Homo_sapiens,TRIO,triple functional domain protein,364697
NP_061891.1,14581894,14610314,1,5,Homo_sapiens,FAM105A,inactive ubiquitin thioesterase FAM105A,28420
NP_612357.4,14664825,14693048,1,5,Homo_sapiens,OTULIN,ubiquitin thioesterase otulin,28223
NP_473368.1,14711196,14871447,-1,5,Homo_sapiens,ANKH,progressive ankylosis protein homolog,160251
NP_036436.1,15500676,15937186,1,5,Homo_sapiens,FBXL7,F-box/LRR-repeat protein 7 isoform 1,436510
NP_001096032.1,16067470,16179575,-1,5,Homo_sapiens,MARCH11,E3 ubiquitin-protein ligase MARCH11,112105
NP_219482.1,16451656,16465665,-1,5,Homo_sapiens,ZNF622,zinc finger protein 622,14009
NP_061873.2,16474740,16508612,-1,5,Homo_sapiens,FAM134B,reticulophagy receptor FAM134B isoform 2,33872
NP_036466.2,16666691,16935808,-1,5,Homo_sapiens,MYO10,unconventional myosin-X,269117
NP_006308.3,17275216,17275900,1,5,Homo_sapiens,BASP1,brain acid soluble protein 1,684
NP_004925.1,19473225,19838986,-1,5,Homo_sapiens,CDH18,cadherin-18 isoform 1 preproprotein,365761
NP_001304157.1,21751736,22078676,-1,5,Homo_sapiens,CDH12,cadherin-12 isoform 2 precursor,326940
NP_064612.2,23509033,23527773,1,5,Homo_sapiens,PRDM9,histone-lysine N-methyltransferase PRDM9 isoform PRDM9 B,18740
NP_001304151.1,24487662,24491669,-1,5,Homo_sapiens,CDH10,cadherin-10 isoform 2,4007
NP_057363.3,26881135,26988333,-1,5,Homo_sapiens,CDH9,cadherin-9 preproprotein,107198
NP_004923.1,31267473,31323308,1,5,Homo_sapiens,CDH6,cadherin-6 preproprotein,55835
NP_001093882.1,31401431,31529059,-1,5,Homo_sapiens,DROSHA,ribonuclease 3 isoform 2,127628
NP_060826.2,31532392,31552902,1,5,Homo_sapiens,C5orf22,UPF0489 protein C5orf22,20510
NP_835260.2,31799248,32108135,1,5,Homo_sapiens,PDZD2,PDZ domain-containing protein 2,308887
NP_071413.1,32126211,32174034,-1,5,Homo_sapiens,GOLPH3,Golgi phosphoprotein 3,47823
NP_001281273.1,32229777,32312838,-1,5,Homo_sapiens,MTMR12,myotubularin-related protein 12 isoform 3,83061
NP_057191.2,32355759,32444658,-1,5,Homo_sapiens,ZFR,zinc finger RNA-binding protein,88899
NP_006704.3,32588512,32601084,1,5,Homo_sapiens,SUB1,activated RNA polymerase II transcriptional coactivator p15,12572
NP_001191305.1,32710662,32786345,1,5,Homo_sapiens,NPR3,atrial natriuretic peptide receptor 3 isoform 3,75683
NP_001245367.1,33441086,33467708,1,5,Homo_sapiens,TARS,"threonine--tRNA ligase, cytoplasmic isoform 2",26622
NP_112217.2,33527187,33891856,-1,5,Homo_sapiens,ADAMTS12,A disintegrin and metalloproteinase with thrombospondin motifs 12 preproprotein,364669
NP_057652.1,33936740,33938150,1,5,Homo_sapiens,RXFP3,relaxin-3 receptor 1,1410
NP_057264.3,33944647,33984583,-1,5,Homo_sapiens,SLC45A2,membrane-associated transporter protein isoform a,39936
NP_001161067.1,33988307,34008019,-1,5,Homo_sapiens,AMACR,alpha-methylacyl-CoA racemase isoform 3,19712
NP_112207.1,34020582,34043125,-1,5,Homo_sapiens,C1QTNF3,complement C1q tumor necrosis factor-related protein 3 isoform a precursor,22543
NP_056392.2,34686919,34830765,1,5,Homo_sapiens,RAI14,ankycorbin isoform a,143846
NP_001304878.1,34839634,34896778,1,5,Homo_sapiens,TTC23L,tetratricopeptide repeat protein 23-like isoform 1,57144
NP_002844.1,34908764,34914892,-1,5,Homo_sapiens,RAD1,cell cycle checkpoint protein RAD1,6128
NP_060791.3,34915738,34925495,1,5,Homo_sapiens,BRIX1,ribosome biogenesis protein BRX1 homolog,9757
NP_919259.3,34929819,34954714,1,5,Homo_sapiens,DNAJC21,dnaJ homolog subfamily C member 21 isoform 1,24895
NP_001293102.1,34998718,35047892,-1,5,Homo_sapiens,AGXT2,"alanine--glyoxylate aminotransferase 2, mitochondrial isoform b precursor",49174
NP_001191247.1,35049286,35089620,-1,5,Homo_sapiens,PRLR,prolactin receptor isoform 5 precursor,40334
NP_653323.1,35617997,35670248,1,5,Homo_sapiens,SPEF2,sperm flagellar protein 2 isoform 2,52251
NP_002176.2,35856977,35876486,1,5,Homo_sapiens,IL7R,interleukin-7 receptor subunit alpha precursor,19509
NP_001036090.1,35904544,35921120,-1,5,Homo_sapiens,CAPSL,calcyphosin-like protein,16576
NP_689617.3,35954201,35991240,-1,5,Homo_sapiens,UGT3A1,UDP-glucuronosyltransferase 3A1 isoform 1 precursor,37039
NP_001161788.1,36035697,36066789,-1,5,Homo_sapiens,UGT3A2,UDP-glucuronosyltransferase 3A2 isoform 2 precursor,31092
NP_001007528.1,36104045,36143349,-1,5,Homo_sapiens,LMBRD2,LMBR1 domain-containing protein 2,39304
NP_005974.2,36152262,36182031,1,5,Homo_sapiens,SKP2,S-phase kinase-associated protein 2 isoform 1,29769
NP_694558.1,36195143,36225612,-1,5,Homo_sapiens,NADK2,"NAD kinase 2, mitochondrial isoform 2",30469
NP_001310202.1,36248640,36301416,-1,5,Homo_sapiens,RANBP3L,ran-binding protein 3-like isoform 3,52776
NP_001160168.1,36608423,36608621,1,5,Homo_sapiens,SLC1A3,excitatory amino acid transporter 1 isoform 3,198
NP_056199.2,36953696,37064023,1,5,Homo_sapiens,NIPBL,nipped-B-like protein isoform B,110327
NP_075561.3,37107601,37247698,-1,5,Homo_sapiens,C5orf42,uncharacterized protein C5orf42,140097
NP_004289.1,37291899,37364364,-1,5,Homo_sapiens,NUP155,nuclear pore complex protein Nup155 isoform 2,72465
NP_060504.1,37379367,37752573,1,5,Homo_sapiens,WDR70,WD repeat-containing protein 70,373206
NP_001265027.1,37815650,37816130,-1,5,Homo_sapiens,GDNF,glial cell line-derived neurotrophic factor isoform 5,480
NP_001265023.1,37875356,37875674,1,5,Homo_sapiens,GDNF-AS1,GDNF antisense RNA 1 (head to head) precursor,318
NP_001192230.1,38258754,38463986,1,5,Homo_sapiens,EGFLAM,pikachurin isoform 5 precursor,205232
NP_001121143.1,38481594,38530647,-1,5,Homo_sapiens,LIFR,leukemia inhibitory factor receptor precursor,49053
NP_001310433.1,38869044,38886228,1,5,Homo_sapiens,OSMR,oncostatin-M-specific receptor subunit beta isoform 2 precursor,17184
NP_001272369.1,38942303,38975570,-1,5,Homo_sapiens,RICTOR,rapamycin-insensitive companion of mTOR isoform 3,33267
NP_955367.1,39107442,39202960,-1,5,Homo_sapiens,FYB,FYN-binding protein isoform 2,95518
NP_001728.1,39285198,39364464,-1,5,Homo_sapiens,C9,complement component C9 precursor,79266
NP_001231800.1,39375018,39394320,-1,5,Homo_sapiens,DAB2,disabled homolog 2 isoform 2,19302
NP_000949.1,40680993,40692378,1,5,Homo_sapiens,PTGER4,prostaglandin E2 receptor EP4 subtype,11385
NP_036514.1,40716144,40747018,-1,5,Homo_sapiens,TTC33,tetratricopeptide repeat protein 33,30874
NP_006242.5,40762777,40798189,-1,5,Homo_sapiens,PRKAA1,5'-AMP-activated protein kinase catalytic subunit alpha-1 isoform 1,35412
NP_000988.1,40832503,40835185,-1,5,Homo_sapiens,RPL37,60S ribosomal protein L37,2682
NP_115976.2,40841382,40854446,1,5,Homo_sapiens,CARD6,caspase recruitment domain-containing protein 6,13064
NP_000578.2,40909610,40981573,1,5,Homo_sapiens,C7,complement component C7 precursor,71963
NP_775760.3,40998051,41070852,-1,5,Homo_sapiens,MROH2B,maestro heat-like repeat-containing protein family member 2B,72801
NP_000056.2,41142824,41203230,-1,5,Homo_sapiens,C6,complement component C6 precursor,60406
NP_001005473.1,41313616,41510526,-1,5,Homo_sapiens,PLCXD3,PI-PLC X domain-containing protein 3,196910
NP_000427.1,41731728,41870358,-1,5,Homo_sapiens,OXCT1,"succinyl-CoA:3-ketoacid coenzyme A transferase 1, mitochondrial precursor",138630
NP_787117.3,41904367,41917299,1,5,Homo_sapiens,C5orf51,UPF0600 protein C5orf51,12932
NP_277019.1,41925309,41934334,1,5,Homo_sapiens,FBXO4,F-box only protein 4 isoform 2,9025
NP_001229328.1,42424588,42719424,1,5,Homo_sapiens,GHR,growth hormone receptor isoform 2 precursor,294836
NP_001128320.1,42759121,42799781,1,5,Homo_sapiens,CCDC152,coiled-coil domain-containing protein 152,40660
NP_001078955.1,42800719,42808353,-1,5,Homo_sapiens,SEPP1,selenoprotein P isoform 1 precursor,7634
NP_001014301.1,43039464,43040046,-1,5,Homo_sapiens,ANXA2R,annexin-2 receptor,582
NP_001284477.1,43122053,43175133,1,5,Homo_sapiens,ZNF131,zinc finger protein 131 isoform 1,53080
NP_699192.1,43245775,43280729,1,5,Homo_sapiens,NIM1K,serine/threonine-protein kinase NIM1,34954
NP_001311151.1,43291130,43298965,-1,5,Homo_sapiens,HMGCS1,"hydroxymethylglutaryl-CoA synthase, cytoplasmic isoform 2",7835
NP_001288804.1,43381859,43388399,-1,5,Homo_sapiens,CCL28,C-C motif chemokine 28 isoform b,6540
NP_071928.2,43446221,43453969,-1,5,Homo_sapiens,TMEM267,transmembrane protein C5orf28,7748
NP_940968.1,43486914,43509339,-1,5,Homo_sapiens,C5orf34,uncharacterized protein C5orf34,22425
NP_899152.1,43527375,43555928,-1,5,Homo_sapiens,PAIP1,polyadenylate-binding protein-interacting protein 1 isoform 3,28553
NP_892022.2,43609195,43704404,1,5,Homo_sapiens,NNT,"NAD(P) transhydrogenase, mitochondrial",95209
NP_004456.1,44304994,44388682,-1,5,Homo_sapiens,FGF10,fibroblast growth factor 10 precursor,83688
NP_057724.2,44808962,44815202,1,5,Homo_sapiens,MRPS30,"28S ribosomal protein S30, mitochondrial",6240
NP_066550.2,45261920,45696093,-1,5,Homo_sapiens,HCN1,potassium/sodium hyperpolarization-activated cyclic nucleotide-gated channel 1,434173
NP_940851.1,50399272,50441151,-1,5,Homo_sapiens,EMB,embigin precursor,41879
NP_078891.2,50667095,50842068,1,5,Homo_sapiens,PARP8,poly [ADP-ribose] polymerase 8 isoform 1,174973
NP_002193.2,51383671,51393610,1,5,Homo_sapiens,ISL1,insulin gene enhancer protein ISL-1,9939
NP_852478.1,52788353,52952451,1,5,Homo_sapiens,ITGA1,integrin alpha-1 precursor,164098
NP_002194.2,52989468,53090599,1,5,Homo_sapiens,ITGA2,integrin alpha-2 precursor,101131
NP_004522.1,53098601,53107174,-1,5,Homo_sapiens,MOCS2,molybdopterin synthase catalytic subunit large subunit MOCS2B,8573
NP_006341.1,53480791,53485688,1,5,Homo_sapiens,FST,follistatin isoform FST317 precursor,4897
NP_001304980.1,53560662,53683130,1,5,Homo_sapiens,NDUFS4,"NADH dehydrogenase [ubiquinone] iron-sulfur protein 4, mitochondrial isoform 2 precursor",122468
NP_061960.1,53886560,54310479,-1,5,Homo_sapiens,ARL15,ADP-ribosylation factor-like protein 15,423919
NP_006299.1,54455789,54456242,1,5,Homo_sapiens,HSPB3,heat shock protein beta-3,453
NP_443102.2,54517952,54519839,1,5,Homo_sapiens,SNX18,sorting nexin-18 isoform b,1887
NP_001129076.1,54979331,54985517,-1,5,Homo_sapiens,ESM1,endothelial cell-specific molecule 1 isoform b precursor,6186
NP_002095.1,55024322,55033926,1,5,Homo_sapiens,GZMK,granzyme K precursor,9604
NP_006135.1,55102682,55110182,1,5,Homo_sapiens,GZMA,granzyme A precursor,7500
NP_001139206.2,55114217,55173000,-1,5,Homo_sapiens,CDC20B,cell division cycle protein 20 homolog B isoform 2,58783
NP_001293127.1,55160192,55164123,1,5,Homo_sapiens,GPX8,probable glutathione peroxidase 8 isoform c,3931
NP_001177716.1,55220365,55227138,-1,5,Homo_sapiens,MCIDAS,multicilin,6773
NP_066970.3,55231374,55233523,-1,5,Homo_sapiens,CCNO,cyclin-O,2149
NP_061903.2,55256487,55307573,-1,5,Homo_sapiens,DHX29,ATP-dependent RNA helicase DHX29,51086
NP_056175.3,55308013,55424772,1,5,Homo_sapiens,SKIV2L2,superkiller viralicidic activity 2-like 2,116759
NP_003702.2,55425205,55534629,-1,5,Homo_sapiens,PLPP1,phospholipid phosphatase 1 isoform 1,109424
NP_001269358.1,55626493,55669616,-1,5,Homo_sapiens,SLC38A9,sodium-coupled neutral amino acid transporter 9 isoform 4,43123
NP_077726.1,55738963,55816540,1,5,Homo_sapiens,DDX4,probable ATP-dependent RNA helicase DDX4 isoform 1,77577
NP_001284499.1,55851570,55908659,1,5,Homo_sapiens,IL31RA,interleukin-31 receptor subunit alpha isoform 6,57089
NP_001177910.1,55941081,55976278,-1,5,Homo_sapiens,IL6ST,interleukin-6 receptor subunit beta isoform 3 precursor,35197
NP_078945.2,56100182,56232913,-1,5,Homo_sapiens,ANKRD55,ankyrin repeat domain-containing protein 55,132731
NP_001273982.1,56511721,56556172,-1,5,Homo_sapiens,C5orf67,uncharacterized protein C5orf67,44451
XP_016865616.1,56771005,56771924,-1,5,Homo_sapiens,LOC105378979,growth/differentiation factor 3,919
NP_005912.1,56815573,56893680,1,5,Homo_sapiens,MAP3K1,mitogen-activated protein kinase kinase kinase 1,78107
NP_001309948.1,56909645,56914036,1,5,Homo_sapiens,SETD9,SET domain-containing protein 9 isoform 4,4391
NP_689835.3,56923127,56952102,-1,5,Homo_sapiens,MIER3,mesoderm induction early response protein 3 isoform 3,28975
NP_001120708.1,57214130,57262752,1,5,Homo_sapiens,GPBP1,vasculin isoform 2,48622
NP_001017992.1,57481576,57482707,-1,5,Homo_sapiens,ACTBL2,beta-actin-like protein 2,1131
NP_001239155.1,58454582,58459959,-1,5,Homo_sapiens,PLK2,serine/threonine-protein kinase PLK2 isoform 2,5377
NP_689900.1,58494536,58495010,1,5,Homo_sapiens,GAPT,protein GAPT,474
NP_001304844.1,58582396,58851351,1,5,Homo_sapiens,RAB3C,ras-related protein Rab-3C isoform 2,268955
NP_001184152.1,58974663,58999536,-1,5,Homo_sapiens,PDE4D,"cAMP-specific 3',5'-cyclic phosphodiesterase 4D isoform PDE4D6",24873
NP_001138680.1,60597752,60700093,-1,5,Homo_sapiens,DEPDC1B,DEP domain-containing protein 1B isoform 2,102341
NP_001284547.1,60754623,60767897,-1,5,Homo_sapiens,ELOVL7,elongation of very long chain fatty acids protein 7 isoform 3,13274
NP_001277214.1,60874614,60918286,-1,5,Homo_sapiens,ERCC8,DNA excision repair protein ERCC-8 isoform 4,43672
NP_777549.1,60945255,61152955,1,5,Homo_sapiens,NDUFAF2,"mimitin, mitochondrial",207700
NP_001041714.1,61159946,61160171,-1,5,Homo_sapiens,SMIM15,small integral membrane protein 15,225
NP_065979.1,61332272,61544317,1,5,Homo_sapiens,ZSWIM6,zinc finger SWIM domain-containing protein 6,212045
NP_775938.1,61643363,61704033,1,5,Homo_sapiens,C5orf64,uncharacterized protein C5orf64,60670
NP_001091981.1,62306472,62385569,1,5,Homo_sapiens,KIF2A,kinesin-like protein KIF2A isoform 2,79097
NP_055288.1,62389009,62403772,-1,5,Homo_sapiens,DIMT1,probable dimethyladenosine transferase,14763
NP_001128251.1,62419013,62627318,1,5,Homo_sapiens,IPO11,importin-11 isoform 1,208305
NP_000515.2,63960450,63961719,-1,5,Homo_sapiens,HTR1A,5-hydroxytryptamine receptor 1A,1269
NP_848627.1,64200807,64217420,1,5,Homo_sapiens,RNF180,E3 ubiquitin-protein ligase RNF180 isoform 2,16613
NP_001025046.1,64506624,64609252,1,5,Homo_sapiens,RGS7BP,regulator of G-protein signaling 7-binding protein isoform 1,102628
NP_001157914.1,64690623,64718022,1,5,Homo_sapiens,FAM159B,membrane protein FAM159B,27399
NP_776190.1,64724383,64768517,-1,5,Homo_sapiens,SREK1IP1,protein SREK1IP1,44134
NP_001284574.1,64769146,64807806,1,5,Homo_sapiens,CWC27,peptidyl-prolyl cis-trans isomerase CWC27 homolog isoform 3,38660
NP_922932.2,65151835,65473673,-1,5,Homo_sapiens,ADAMTS6,A disintegrin and metalloproteinase with thrombospondin motifs 6 preproprotein,321838
NP_071428.2,65518474,65554907,-1,5,Homo_sapiens,CENPK,centromere protein K,36433
NP_056157.1,65563310,65587396,1,5,Homo_sapiens,PPWD1,peptidylprolyl isomerase domain and WD repeat-containing protein 1 isoform 1,24086
NP_150230.1,65590298,65624274,-1,5,Homo_sapiens,TRIM23,E3 ubiquitin-protein ligase TRIM23 isoform beta,33976
NP_001087224.1,65625060,65664611,1,5,Homo_sapiens,TRAPPC13,trafficking protein particle complex subunit 13 isoform 1,39551
NP_061945.1,65670245,65720807,-1,5,Homo_sapiens,SGTB,small glutamine-rich tetratricopeptide repeat-containing protein beta,50562
NP_065777.1,65722373,65822915,1,5,Homo_sapiens,NLN,"neurolysin, mitochondrial",100542
NP_001240628.1,65992718,66078530,1,5,Homo_sapiens,ERBIN,protein LAP2 isoform 8,85812
NP_001310462.1,66144376,66178755,1,5,Homo_sapiens,SREK1,splicing regulatory glutamine/lysine-rich protein 1 isoform f,34379
NP_942123.1,66596655,66986486,1,5,Homo_sapiens,MAST4,microtubule-associated serine/threonine-protein kinase 4 isoform b,389831
NP_005573.2,67182856,67196641,-1,5,Homo_sapiens,CD180,CD180 antigen precursor,13785
NP_852664.1,68226675,68297601,1,5,Homo_sapiens,PIK3R1,phosphatidylinositol 3-kinase regulatory subunit alpha isoform 1,70926
NP_076960.1,69094255,69104045,1,5,Homo_sapiens,SLC30A5,zinc transporter 5 isoform 2,9790
NP_114172.1,69167262,69177631,1,5,Homo_sapiens,CCNB1,G2/mitotic-specific cyclin-B1,10369
NP_075060.1,69189634,69209799,1,5,Homo_sapiens,CENPH,centromere protein H,20165
NP_150597.1,69217829,69229225,1,5,Homo_sapiens,MRPS36,"28S ribosomal protein S36, mitochondrial",11396
NP_001790.1,69234975,69277135,1,5,Homo_sapiens,CDK7,cyclin-dependent kinase 7 isoform 1,42160
NP_001284626.1,69282728,69311195,-1,5,Homo_sapiens,CCDC125,coiled-coil domain-containing protein 125 isoform 3,28467
NP_057367.1,69352060,69369490,-1,5,Homo_sapiens,AK6,adenylate kinase isoenzyme 6 isoform b,17430
NP_579917.1,69371515,69414292,1,5,Homo_sapiens,RAD17,cell cycle checkpoint protein RAD17 isoform 2,42777
NP_001033692.2,69419385,69441654,1,5,Homo_sapiens,MARVELD2,MARVEL domain-containing protein 2 isoform 1,22269
NP_001192183.1,69504244,69553671,1,5,Homo_sapiens,OCLN,occludin isoform a,49427
NP_001092198.1,69565132,69592198,1,5,Homo_sapiens,GTF2H2C,general transcription factor IIH subunit 2-like protein,27066
NP_001171558.1,70025451,70032387,1,5,Homo_sapiens,SERF1B,small EDRK-rich factor 1 isoform 1,6936
NP_059107.1,70049685,70076571,1,5,Homo_sapiens,SMN2,survival motor neuron protein isoform d,26886
XP_016865593.1,70510538,70512509,1,5,Homo_sapiens,LOC107986351,putative POM121-like protein 1-like,1971
XP_016865597.1,70529861,70530446,-1,5,Homo_sapiens,LOC107986354,uncharacterized protein LOC107986354,585
NP_075257.1,70900869,70907806,1,5,Homo_sapiens,SERF1A,small EDRK-rich factor 1 isoform 2,6937
NP_000335.1,70925103,70951991,1,5,Homo_sapiens,SMN1,survival motor neuron protein isoform d,26888
NP_004527.2,70970103,71012915,-1,5,Homo_sapiens,NAIP,baculoviral IAP repeat-containing protein 1 isoform 1,42812
NP_001506.1,71035676,71062763,-1,5,Homo_sapiens,GTF2H2,general transcription factor IIH subunit 2,27087
XP_016865595.1,71215799,71216384,-1,5,Homo_sapiens,LOC107986352,uncharacterized protein LOC107986352,585
XP_016865596.1,71233820,71234405,-1,5,Homo_sapiens,LOC107986353,uncharacterized protein LOC107986353,585
NP_060899.2,71455877,71564885,1,5,Homo_sapiens,BDP1,transcription factor TFIIIB component B'' homolog,109008
NP_071415.1,71587425,71656860,1,5,Homo_sapiens,MCCC2,"methylcrotonoyl-CoA carboxylase beta chain, mitochondrial",69435
NP_004282.1,71719293,71720615,1,5,Homo_sapiens,CARTPT,cocaine- and amphetamine-regulated transcript protein preproprotein,1322
NP_005900.2,72107531,72205239,1,5,Homo_sapiens,MAP1B,microtubule-associated protein 1B isoform 1,97708
NP_001273680.1,72220908,72297685,-1,5,Homo_sapiens,MRPS27,"28S ribosomal protein S27, mitochondrial isoform 3",76777
NP_079030.3,72320382,72358427,1,5,Homo_sapiens,PTCD2,"pentatricopeptide repeat-containing protein 2, mitochondrial isoform 1",38045
NP_689838.1,72443755,72461496,-1,5,Homo_sapiens,ZNF366,zinc finger protein 366,17741
NP_002261.3,72816737,72905410,1,5,Homo_sapiens,TNPO1,transportin-1 isoform 1,88673
NP_620137.2,72956096,73088090,1,5,Homo_sapiens,FCHO2,F-BAR domain only protein 2 isoform a,131994
NP_775761.4,73123373,73131730,1,5,Homo_sapiens,TMEM171,transmembrane protein 171 isoform 1,8357
NP_694949.1,73173243,73174165,1,5,Homo_sapiens,TMEM174,transmembrane protein 174,922
NP_004463.1,73446964,73448362,-1,5,Homo_sapiens,FOXD1,forkhead box protein D1,1398
NP_001032726.1,73498667,73505238,1,5,Homo_sapiens,BTF3,transcription factor BTF3 isoform A,6571
NP_075526.1,73552796,73562881,-1,5,Homo_sapiens,ANKRA2,ankyrin repeat family A protein 2,10085
NP_115551.2,73567344,73580094,1,5,Homo_sapiens,UTP15,U3 small nucleolar RNA-associated protein 15 homolog isoform 1,12750
NP_001073948.2,73684851,73941013,1,5,Homo_sapiens,ARHGEF28,rho guanine nucleotide exchange factor 28 isoform 1,256162
NP_001243505.1,74634715,74636266,-1,5,Homo_sapiens,ENC1,ectoderm-neural cortex protein 1 isoform 2,1551
NP_000512.1,74685260,74721175,1,5,Homo_sapiens,HEXB,beta-hexosaminidase subunit beta isoform 1 preproprotein,35915
NP_733792.1,74721654,74763742,-1,5,Homo_sapiens,GFM2,"ribosome-releasing factor 2, mitochondrial isoform 2",42088
NP_001258594.1,74767360,74776651,1,5,Homo_sapiens,NSA2,ribosome biogenesis protein NSA2 homolog isoform 2,9291
NP_056381.1,74781459,74841676,-1,5,Homo_sapiens,FAM169A,soluble lamin-associated protein of 75 kDa,60217
NP_057675.1,75028675,75030037,-1,5,Homo_sapiens,GCNT4,"beta-1,3-galactosyl-O-glycosyl-glycoprotein beta-1,6-N-acetylglucosaminyltransferase 4",1362
NP_001157915.1,75068518,75236686,-1,5,Homo_sapiens,ANKRD31,putative ankyrin repeat domain-containing protein 31,168168
NP_000850.1,75342605,75360342,1,5,Homo_sapiens,HMGCR,3-hydroxy-3-methylglutaryl-Coenzyme A reductase isoform 1,17737
NP_112729.1,75379345,75511207,-1,5,Homo_sapiens,COL4A3BP,collagen type IV alpha-3-binding protein isoform 2,131862
NP_057302.1,75547022,75598018,1,5,Homo_sapiens,POLK,DNA polymerase kappa,50996
NP_001263642.1,75611634,75671040,1,5,Homo_sapiens,ANKDD1B,ankyrin repeat and death domain-containing protein 1B,59406
NP_689621.2,75674434,75712384,-1,5,Homo_sapiens,POC5,centrosomal protein POC5 isoform 2,37950
NP_055794.3,76131750,76325547,1,5,Homo_sapiens,SV2C,synaptic vesicle glycoprotein 2C isoform 1,193797
NP_006624.2,76403545,76707313,1,5,Homo_sapiens,IQGAP2,ras GTPase-activating-like protein IQGAP2 isoform 1,303768
NP_001243495.1,76617581,76618640,-1,5,Homo_sapiens,F2RL2,proteinase-activated receptor 3 isoform 2,1059
NP_001983.2,76716307,76733503,1,5,Homo_sapiens,F2R,proteinase-activated receptor 1 isoform 1 precursor,17196
NP_005233.3,76819182,76833801,1,5,Homo_sapiens,F2RL1,proteinase-activated receptor 2 precursor,14619
NP_570128.2,76875359,76877832,1,5,Homo_sapiens,S100Z,protein S100-Z,2473
NP_001873.2,76953134,76968885,1,5,Homo_sapiens,CRHBP,corticotropin-releasing factor-binding protein precursor,15751
NP_060516.2,77030766,77063252,1,5,Homo_sapiens,AGGF1,angiogenic factor with G patch and FHA domains 1,32486
NP_115743.1,77077173,77077878,-1,5,Homo_sapiens,ZBED3,zinc finger BED domain-containing protein 3,705
NP_003710.1,77210925,77426554,1,5,Homo_sapiens,PDE8B,"high affinity cAMP-specific and IBMX-insensitive 3',5'-cyclic phosphodiesterase 8B isoform 1",215629
NP_060738.2,77433134,77492220,-1,5,Homo_sapiens,WDR41,WD repeat-containing protein 41,59086
NP_115485.1,77630263,77638549,-1,5,Homo_sapiens,OTP,homeobox protein orthopedia,8286
NP_001284669.1,77691417,77776257,-1,5,Homo_sapiens,TBCA,tubulin-specific chaperone A isoform 3,84840
NP_001258698.1,78002901,78267576,-1,5,Homo_sapiens,AP3B1,AP-3 complex subunit beta-1 isoform 2,264675
NP_004857.4,78360671,78475668,1,5,Homo_sapiens,SCAMP1,secretory carrier-associated membrane protein 1 isoform 1,114997
NP_005770.1,78488896,78510213,-1,5,Homo_sapiens,LHFPL2,lipoma HMGIC fusion partner-like 2 protein,21317
NP_000037.2,78780396,78985248,-1,5,Homo_sapiens,ARSB,arylsulfatase B isoform 1 precursor,204852
NP_037523.2,78998081,79069620,-1,5,Homo_sapiens,DMGDH,"dimethylglycine dehydrogenase, mitochondrial precursor",71539
NP_060084.2,79069782,79088574,1,5,Homo_sapiens,BHMT2,S-methylmethionine--homocysteine S-methyltransferase BHMT2 isoform 1,18792
NP_001704.2,79111885,79131116,1,5,Homo_sapiens,BHMT,betaine--homocysteine S-methyltransferase 1,19231
NP_689618.4,79236650,79316307,1,5,Homo_sapiens,JMY,junction-mediating and -regulatory protein,79657
NP_001264006.1,79376008,79512774,-1,5,Homo_sapiens,HOMER1,homer protein homolog 1 isoform 2,136766
NP_776158.2,79619648,79685273,1,5,Homo_sapiens,PAPD4,poly(A) RNA polymerase GLD2 isoform 1,65625
NP_705838.3,79689907,79799616,1,5,Homo_sapiens,CMYA5,cardiomyopathy-associated protein 5,109709
NP_001161213.1,79983683,79990204,-1,5,Homo_sapiens,MTX3,metaxin-3 isoform 1,6521
NP_003239.2,80035537,80083141,1,5,Homo_sapiens,THBS4,thrombospondin-4 isoform a precursor,47604
NP_001167542.1,80113600,80255922,-1,5,Homo_sapiens,SERINC5,serine incorporator 5 isoform 3,142322
NP_115956.3,80320215,80321508,1,5,Homo_sapiens,SPZ1,spermatogenic leucine zipper protein 1,1293
NP_001271166.1,80434147,80440043,1,5,Homo_sapiens,ZFYVE16,zinc finger FYVE domain-containing protein 16 isoform b,5896
NP_991111.2,80488123,80541832,1,5,Homo_sapiens,FAM151B,protein FAM151B,53709
NP_001004441.2,80558474,80560019,-1,5,Homo_sapiens,ANKRD34B,ankyrin repeat domain-containing protein 34B,1545
NP_001277283.1,80629086,80649474,-1,5,Homo_sapiens,DHFR,dihydrofolate reductase isoform 2,20388
NP_002430.3,80654727,80875862,1,5,Homo_sapiens,MSH3,DNA mismatch repair protein Msh3,221135
NP_008840.1,80960738,81225770,1,5,Homo_sapiens,RASGRF2,ras-specific guanine nucleotide-releasing factor 2,265032
NP_001816.2,81251132,81266258,1,5,Homo_sapiens,CKMT2,"creatine kinase S-type, mitochondrial precursor",15126
NP_115656.1,81304757,81312662,1,5,Homo_sapiens,ZCCHC9,zinc finger CCHC domain-containing protein 9,7905
NP_570123.1,81330393,81394114,-1,5,Homo_sapiens,ACOT12,acyl-coenzyme A thioesterase 12,63721
NP_001243665.1,81420503,81751042,-1,5,Homo_sapiens,SSBP2,single-stranded DNA-binding protein 2 isoform 6,330539
NP_113670.1,81987570,82253425,1,5,Homo_sapiens,ATG10,ubiquitin-like-conjugating enzyme ATG10,265855
NP_001016.1,82276108,82278323,-1,5,Homo_sapiens,RPS23,40S ribosomal protein S23,2215
NP_001017971.1,82305401,82318300,1,5,Homo_sapiens,ATP6AP1L,V-type proton ATPase subunit S1-like protein,12899
NP_777569.1,83057083,83077323,-1,5,Homo_sapiens,TMEM167A,protein kish-A precursor,20240
NP_001304942.1,83104919,83310828,1,5,Homo_sapiens,XRCC4,DNA repair protein XRCC4 isoform 3,205909
NP_004376.2,83483518,83580434,1,5,Homo_sapiens,VCAN,versican core protein isoform 1 precursor,96916
NP_001875.1,83641495,83673523,-1,5,Homo_sapiens,HAPLN1,hyaluronan and proteoglycan link protein 1 precursor,32028
NP_001265571.1,83943418,84384374,-1,5,Homo_sapiens,EDIL3,EGF-like repeat and discoidin I-like domain-containing protein 3 isoform 2 precursor,440956
NP_001858.1,86618055,86619469,1,5,Homo_sapiens,COX7C,"cytochrome c oxidase subunit 7C, mitochondrial precursor",1414
NP_002881.1,87268451,87390883,1,5,Homo_sapiens,RASA1,ras GTPase-activating protein 1 isoform 1,122432
NP_001186118.1,87394445,87411304,-1,5,Homo_sapiens,CCNH,cyclin-H isoform 2,16859
NP_001275936.1,88190051,88268723,-1,5,Homo_sapiens,TMEM161B,transmembrane protein 161B isoform 1,78672
NP_001180277.1,88722603,88823788,-1,5,Homo_sapiens,MEF2C,myocyte-specific enhancer factor 2C isoform 4,101185
NP_001284697.1,90394063,90409661,-1,5,Homo_sapiens,CETN3,centrin-3 isoform 3,15598
NP_981951.1,90461166,90474292,-1,5,Homo_sapiens,MBLAC2,metallo-beta-lactamase domain-containing protein 2,13126
NP_006458.2,90485567,90512139,1,5,Homo_sapiens,POLR3G,DNA-directed RNA polymerase III subunit RPC7,26572
NP_938014.1,90518818,90525289,-1,5,Homo_sapiens,LYSMD3,lysM and putative peptidoglycan-binding domain-containing protein 3 isoform 1,6471
NP_115495.3,90558895,91163900,1,5,Homo_sapiens,ADGRV1,G-protein coupled receptor 98 precursor,605005
NP_065852.1,91371399,91383092,-1,5,Homo_sapiens,ARRDC3,arrestin domain-containing protein 3,11693
NP_005645.1,93585023,93593842,1,5,Homo_sapiens,NR2F1,COUP transcription factor 1,8819
NP_001156890.1,93620986,94053195,-1,5,Homo_sapiens,FAM172A,protein FAM172A isoform 3,432209
NP_001139150.1,94154006,94537126,-1,5,Homo_sapiens,KIAA0825,uncharacterized protein KIAA0825 isoform 1,383120
NP_115666.2,94628810,94695312,1,5,Homo_sapiens,SLF1,SMC5-SMC6 complex localization factor protein 1,66502
NP_001284706.1,94707495,95081482,-1,5,Homo_sapiens,MCTP1,multiple C2 and transmembrane domain-containing protein 1 isoform 3,373987
NP_689761.2,95391389,95450282,1,5,Homo_sapiens,FAM81B,protein FAM81B,58893
NP_055454.1,95464606,95547150,-1,5,Homo_sapiens,TTC37,tetratricopeptide repeat protein 37,82544
NP_937793.1,95555278,95603526,1,5,Homo_sapiens,ARSK,arylsulfatase K precursor,48248
NP_954713.1,95620275,95621580,1,5,Homo_sapiens,GPR150,probable G-protein coupled receptor 150,1305
NP_001124537.1,95652271,95656309,1,5,Homo_sapiens,RFESD,Rieske domain-containing protein isoform 1,4038
NP_114158.2,95658622,95682854,-1,5,Homo_sapiens,SPATA9,spermatogenesis-associated protein 9,24232
NP_055714.3,95731682,95793174,1,5,Homo_sapiens,RHOBTB3,rho-related BTB domain-containing protein 3,61492
NP_001112362.1,95816512,95822662,-1,5,Homo_sapiens,GLRX,glutaredoxin-1,6150
NP_036213.2,95888870,95961721,-1,5,Homo_sapiens,ELL2,RNA polymerase II elongation factor ELL2,72851
NP_001171346.1,96393000,96432121,-1,5,Homo_sapiens,PCSK1,neuroendocrine convertase 1 isoform 2,39121
NP_001035905.1,96662422,96771679,1,5,Homo_sapiens,CAST,calpastatin isoform f,109257
NP_057526.3,96763199,96803926,-1,5,Homo_sapiens,ERAP1,endoplasmic reticulum aminopeptidase 1 isoform a precursor,40727
NP_071745.1,96879685,96917605,1,5,Homo_sapiens,ERAP2,endoplasmic reticulum aminopeptidase 2,37920
XP_005272207.1,96935370,96936075,-1,5,Homo_sapiens,LOC101929747,uncharacterized protein LOC101929747,705
NP_005566.2,96936155,97028533,1,5,Homo_sapiens,LNPEP,leucyl-cystinyl aminopeptidase isoform 1,92378
NP_694966.3,97094747,97142576,-1,5,Homo_sapiens,LIX1,protein limb expression 1 homolog,47829
NP_060813.2,97163060,97183191,-1,5,Homo_sapiens,RIOK2,serine/threonine-protein kinase RIO2 isoform 1,20131
NP_001012779.2,98770668,98793753,1,5,Homo_sapiens,RGMB,RGM domain family member B,23085
NP_001261.2,98856379,98926386,-1,5,Homo_sapiens,CHD1,chromodomain-helicase-DNA-binding protein 1,70007
NP_940909.1,100535530,100586184,1,5,Homo_sapiens,FAM174A,membrane protein FAM174A precursor,50654
NP_005659.1,100811846,100902955,-1,5,Homo_sapiens,ST8SIA4,"CMP-N-acetylneuraminate-poly-alpha-2, 8-sialyltransferase isoform a precursor",91109
NP_851322.3,102236857,102296262,-1,5,Homo_sapiens,SLCO4C1,solute carrier organic anion transporter family member 4C1,59405
NP_001294943.1,102373351,102498844,-1,5,Homo_sapiens,SLCO6A1,solute carrier organic anion transporter family member 6A1 isoform 3,125493
NP_001306872.1,102866195,103029065,1,5,Homo_sapiens,PAM,peptidyl-glycine alpha-amidating monooxygenase isoform f precursor,162870
NP_001304883.1,103087897,103104738,-1,5,Homo_sapiens,GIN1,gypsy retrotransposon integrase-like protein 1 isoform 2,16841
NP_001268400.1,103129589,103201634,1,5,Homo_sapiens,PPIP5K2,inositol hexakisphosphate and diphosphoinositol-pentakisphosphate kinase 2 isoform 3,72045
NP_149988.1,103275919,103276540,1,5,Homo_sapiens,C5orf30,UNC119-binding protein C5orf30,621
NP_001287670.1,103550860,103560248,-1,5,Homo_sapiens,NUDT12,peroxisomal NADH pyrophosphatase NUDT12 isoform 2,9388
NP_001953.1,107381254,107670613,-1,5,Homo_sapiens,EFNA5,ephrin-A5 precursor,289359
NP_001156787.2,107861719,108381691,-1,5,Homo_sapiens,FBXL17,F-box/LRR-repeat protein 17,519972
NP_001294967.1,108798182,108841841,1,5,Homo_sapiens,FER,tyrosine-protein kinase Fer isoform d,43659
NP_001294957.1,108867810,109187575,1,5,Homo_sapiens,FER,tyrosine-protein kinase Fer isoform b,319765
NP_055634.3,109337230,109383433,-1,5,Homo_sapiens,PJA2,E3 ubiquitin-protein ligase Praja-2,46203
NP_002363.2,109690417,109866998,1,5,Homo_sapiens,MAN2A1,alpha-mannosidase 2,176581
NP_001034852.3,110420579,110667352,-1,5,Homo_sapiens,TMEM232,transmembrane protein 232,246773
NP_001290179.1,110738237,110761782,1,5,Homo_sapiens,SLC25A46,solute carrier family 25 member 46 isoform 3,23545
NP_149024.1,111071890,111076074,1,5,Homo_sapiens,TSLP,thymic stromal lymphopoietin isoform 1 precursor,4184
NP_644810.1,111092288,111126883,1,5,Homo_sapiens,WDR36,WD repeat-containing protein 36,34595
NP_001310303.1,111224483,111484466,1,5,Homo_sapiens,CAMK4,calcium/calmodulin-dependent protein kinase type IV isoform 1,259983
NP_001294989.1,111499885,111501104,-1,5,Homo_sapiens,STARD4,stAR-related lipid transfer protein 4 isoform d,1219
NP_001135948.1,111730920,111755772,-1,5,Homo_sapiens,NREP,neuronal regeneration-related protein isoform a,24852
NP_071423.3,112164989,112419039,-1,5,Homo_sapiens,EPB41L4A,band 4.1-like protein 4A,254050
NP_001120983.2,112707717,112844126,1,5,Homo_sapiens,APC,adenomatous polyposis coli protein isoform a,136409
NP_001191122.1,112861376,112867403,1,5,Homo_sapiens,SRP19,signal recognition particle 19 kDa protein isoform 2,6027
NP_005660.4,112878785,112922190,-1,5,Homo_sapiens,REEP5,receptor expression-enhancing protein 5,43405
NP_689837.2,112976933,113013484,1,5,Homo_sapiens,DCP2,m7GpppN-mRNA hydrolase isoform 1,36551
NP_002378.1,113027301,113294385,-1,5,Homo_sapiens,MCC,colorectal mutant cancer protein isoform 2,267084
NP_114417.1,113433735,113434839,-1,5,Homo_sapiens,TSSK1B,testis-specific serine/threonine-protein kinase 1,1104
NP_073739.3,113513895,113593383,1,5,Homo_sapiens,YTHDC2,probable ATP-dependent RNA helicase YTHDC2,79488
NP_067627.2,114362775,114496182,1,5,Homo_sapiens,KCNN2,small conductance calcium-activated potassium channel protein 2 isoform a,133407
NP_001287681.1,115126502,115147227,-1,5,Homo_sapiens,TRIM36,E3 ubiquitin-protein ligase TRIM36 isoform 4,20725
NP_001017397.1,115171102,115180037,-1,5,Homo_sapiens,TRIM36,E3 ubiquitin-protein ligase TRIM36 isoform 2,8935
NP_005014.2,115212401,115262851,-1,5,Homo_sapiens,PGGT1B,geranylgeranyl transferase type-1 subunit beta,50450
NP_689762.2,115267875,115279758,-1,5,Homo_sapiens,CCDC112,coiled-coil domain-containing protein 112 isoform 2,11883
NP_064562.1,115524307,115543493,-1,5,Homo_sapiens,FEM1C,protein fem-1 homolog C,19186
NP_067681.1,115580548,115581256,-1,5,Homo_sapiens,TICAM2,TIR domain-containing adapter molecule 2,708
NP_001157941.1,115581314,115625792,-1,5,Homo_sapiens,TMED7-TICAM2,TRAM adaptor with GOLD domain isoform 2 precursor,44478
NP_001310496.1,115805432,115813212,-1,5,Homo_sapiens,CDO1,cysteine dioxygenase type 1 isoform 4,7780
NP_004698.3,115831803,115841552,-1,5,Homo_sapiens,ATG12,ubiquitin-like protein ATG12 isoform 1,9749
NP_001305022.1,115842037,115906856,1,5,Homo_sapiens,AP3S1,AP-3 complex subunit sigma-1 isoform 5,64819
NP_776161.3,115962617,116026118,1,5,Homo_sapiens,LVRN,aminopeptidase Q,63501
NP_001182510.1,116051465,116058947,1,5,Homo_sapiens,ARL14EPL,ARL14 effector protein-like,7482
NP_057228.1,116085052,116292489,1,5,Homo_sapiens,COMMD10,COMM domain-containing protein 10 isoform a,207437
NP_065847.1,116446612,116504944,-1,5,Homo_sapiens,SEMA6A,semaphorin-6A isoform 2 precursor,58332
NP_001295010.1,118840916,118988149,-1,5,Homo_sapiens,DTWD2,DTW domain-containing protein 2 isoform b,147233
NP_001277250.1,119071569,119247219,1,5,Homo_sapiens,DMXL1,dmX-like protein 1 isoform 1,175650
NP_001071122.1,119268906,119393381,1,5,Homo_sapiens,TNFAIP8,tumor necrosis factor alpha-induced protein 8 isoform b,124475
NP_000405.1,119452575,119541994,1,5,Homo_sapiens,HSD17B4,peroxisomal multifunctional enzyme type 2 isoform 2,89419
NP_877438.2,119629768,119635034,1,5,Homo_sapiens,FAM170A,protein FAM170A isoform 1,5266
NP_001287712.1,120464486,120686709,1,5,Homo_sapiens,PRR16,protein Largen isoform 1,222223
NP_803431.1,121851963,121852692,1,5,Homo_sapiens,FTMT,"ferritin, mitochondrial precursor",729
NP_689759.2,121962032,122027126,1,5,Homo_sapiens,SRFBP1,serum response factor-binding protein 1,65094
NP_001304002.1,122066742,122074156,-1,5,Homo_sapiens,LOX,protein-lysine 6-oxidase isoform 3,7414
NP_997200.1,122151990,122153085,1,5,Homo_sapiens,ZNF474,zinc finger protein 474,1095
NP_001182464.1,122160229,122182642,1,5,Homo_sapiens,LOC100505841,uncharacterized protein LOC100505841,22413
NP_005451.2,122391134,122463496,1,5,Homo_sapiens,SNCAIP,synphilin-1 isoform 1,72362
NP_003091.2,122775103,122829648,1,5,Homo_sapiens,SNX2,sorting nexin-2 isoform 1,54545
NP_054754.1,122845633,123007749,1,5,Homo_sapiens,SNX24,sorting nexin-24,162116
NP_000934.1,123023874,123036625,-1,5,Homo_sapiens,PPIC,peptidyl-prolyl cis-trans isomerase C precursor,12751
NP_001129711.1,123090014,123187201,1,5,Homo_sapiens,PRDM6,putative histone-lysine N-methyltransferase PRDM6,97187
NP_001159698.1,123346518,123418486,-1,5,Homo_sapiens,CEP120,centrosomal protein of 120 kDa isoform 2,71968
NP_001257501.1,123545663,123614396,1,5,Homo_sapiens,CSNK1G3,casein kinase I isoform gamma-3 isoform 5,68733
NP_065798.2,124637899,124744989,-1,5,Homo_sapiens,ZNF608,zinc finger protein 608,107090
NP_001139791.1,126360331,126492956,1,5,Homo_sapiens,GRAMD3,GRAM domain-containing protein 3 isoform 1,132625
NP_001188306.1,126544964,126595114,-1,5,Homo_sapiens,ALDH7A1,alpha-aminoadipic semialdehyde dehydrogenase isoform 2,50150
NP_115553.2,126600962,126624844,1,5,Homo_sapiens,PHAX,phosphorylated adapter RNA export protein,23882
NP_997291.1,126631734,126636241,1,5,Homo_sapiens,TEX43,testis-expressed sequence 43 protein,4507
NP_005564.1,126777508,126836264,1,5,Homo_sapiens,LMNB1,lamin-B1 isoform 1,58756
NP_848545.1,126870632,126918171,-1,5,Homo_sapiens,MARCH3,E3 ubiquitin-protein ligase MARCH3,47539
NP_001157951.1,127047669,127058995,-1,5,Homo_sapiens,C5orf63,glutaredoxin-like protein C5orf63 isoform 1,11326
XP_011542092.1,127218954,127229743,-1,5,Homo_sapiens,LOC105379198,uncharacterized protein LOC105379198,10789
NP_001295048.1,127331308,127424349,1,5,Homo_sapiens,MEGF10,multiple epidermal growth factor-like domains protein 10 isoform b precursor,93041
NP_570721.1,127523479,127551916,1,5,Homo_sapiens,PRRC1,protein PRRC1 isoform 2,28437
NP_001041717.1,127657521,127657767,1,5,Homo_sapiens,CTXN3,cortexin-3,246
NP_001304867.1,127703388,127941468,1,5,Homo_sapiens,CCDC192,coiled-coil domain containing 192,238080
NP_001037.1,128083954,128186631,1,5,Homo_sapiens,SLC12A2,solute carrier family 12 member 2 isoform 1,102677
NP_001990.2,128259454,128537603,-1,5,Homo_sapiens,FBN2,fibrillin-2 precursor,278149
NP_054750.1,128966137,129033282,1,5,Homo_sapiens,SLC27A6,long-chain fatty acid transport protein 6,67145
NP_057132.2,129094766,129113001,1,5,Homo_sapiens,ISOC1,isochorismatase domain-containing protein 1,18235
NP_598377.3,129460409,129737218,1,5,Homo_sapiens,ADAMTS19,A disintegrin and metalloproteinase with thrombospondin motifs 19 preproprotein,276809
NP_001244237.1,129748190,129765063,1,5,Homo_sapiens,KIAA1024L,UPF0258 protein KIAA1024-like,16873
NP_787052.3,129904829,130185791,1,5,Homo_sapiens,CHSY3,chondroitin sulfate synthase 3,280962
NP_005331.1,131159446,131165205,-1,5,Homo_sapiens,HINT1,histidine triad nucleotide-binding protein 1,5759
NP_001280664.1,131171020,131199560,1,5,Homo_sapiens,LYRM7,complex III assembly factor LYRM7 isoform 2,28540
NP_001033791.1,131359493,131391091,1,5,Homo_sapiens,CDC42SE2,CDC42 small effector protein 2,31598
NP_057424.3,131427265,131635030,-1,5,Homo_sapiens,RAPGEF6,rap guanine nucleotide exchange factor 6 isoform 2,207765
NP_001008738.2,131644684,131796921,-1,5,Homo_sapiens,FNIP1,folliculin-interacting protein 1 isoform 2,152237
NP_001290551.1,131807235,131945505,-1,5,Homo_sapiens,MEIKIN,meiosis-specific kinetochore protein,138270
NP_001192180.1,131954233,131994225,-1,5,Homo_sapiens,ACSL6,long-chain-fatty-acid--CoA ligase 6 isoform f,39992
NP_000579.2,132060706,132062791,1,5,Homo_sapiens,IL3,interleukin-3 precursor,2085
NP_000749.2,132073823,132075852,1,5,Homo_sapiens,CSF2,granulocyte-macrophage colony-stimulating factor precursor,2029
NP_001136071.1,132193009,132218626,-1,5,Homo_sapiens,P4HA2,prolyl 4-hydroxylase subunit alpha-2 isoform 1 precursor,25617
NP_001124499.1,132257734,132272095,1,5,Homo_sapiens,PDLIM4,PDZ and LIM domain protein 4 isoform 2,14361
NP_003050.2,132294616,132343835,1,5,Homo_sapiens,SLC22A4,solute carrier family 22 member 4,49219
NP_001295051.1,132369972,132394272,1,5,Homo_sapiens,SLC22A5,solute carrier family 22 member 5 isoform a,24300
NP_002189.1,132483950,132489478,-1,5,Homo_sapiens,IRF1,interferon regulatory factor 1,5528
NP_000870.1,132541810,132543478,-1,5,Homo_sapiens,IL5,interleukin-5 precursor,1668
NP_005723.2,132557324,132642364,1,5,Homo_sapiens,RAD50,DNA repair protein RAD50,85040
NP_002179.2,132658186,132660282,1,5,Homo_sapiens,IL13,interleukin-13 precursor,2096
NP_000580.1,132674050,132682587,1,5,Homo_sapiens,IL4,interleukin-4 isoform 1 precursor,8537
NP_008985.3,132696633,132737419,-1,5,Homo_sapiens,KIF3A,kinesin-like protein KIF3A isoform 3,40786
NP_001274182.1,132747495,132752970,1,5,Homo_sapiens,CCNI2,cyclin-I2 isoform 3,5475
NP_001092281.1,132752015,132777137,-1,5,Homo_sapiens,SEPT8,septin-8 isoform a,25122
NP_787069.4,132813621,132815271,1,5,Homo_sapiens,SOWAHA,ankyrin repeat domain-containing protein SOWAHA precursor,1650
NP_597713.2,132822795,132826140,-1,5,Homo_sapiens,SHROOM1,protein Shroom1 isoform 2,3345
XP_016865598.1,132829606,132831365,-1,5,Homo_sapiens,LOC107984115,laforin-like,1759
NP_001275757.1,132861588,132864269,-1,5,Homo_sapiens,GDF9,growth/differentiation factor 9 isoform 2,2681
NP_055217.2,132866881,132867582,1,5,Homo_sapiens,UQCRQ,cytochrome b-c1 complex subunit 8,701
NP_443203.1,132873694,132874446,1,5,Homo_sapiens,LEAP2,liver-expressed antimicrobial peptide 2 precursor,752
NP_055238.1,132881058,132937189,-1,5,Homo_sapiens,AFF4,AF4/FMR2 family member 4,56131
XP_011542087.1,132960723,132961296,-1,5,Homo_sapiens,LOC105379177,uncharacterized protein LOC105379177,573
NP_001295058.1,132998582,133026537,-1,5,Homo_sapiens,ZCCHC10,zinc finger CCHC domain-containing protein 10 isoform 11,27955
NP_002145.3,133052250,133104436,1,5,Homo_sapiens,HSPA4,heat shock 70 kDa protein 4,52186
NP_055897.1,133199094,133603983,-1,5,Homo_sapiens,FSTL4,follistatin-related protein 4 precursor,404889
NP_064584.1,133956858,133968584,-1,5,Homo_sapiens,C5orf15,keratinocyte-associated transmembrane protein 2 precursor,11726
NP_003365.1,133972770,133993012,-1,5,Homo_sapiens,VDAC1,voltage-dependent anion-selective channel protein 1,20242
XP_011542088.1,134081908,134082070,-1,5,Homo_sapiens,LOC101060024,uncharacterized protein C7orf73-like,162
NP_003193.2,134114906,134146303,1,5,Homo_sapiens,TCF7,transcription factor 7 isoform 1,31397
NP_733779.1,134157732,134174022,-1,5,Homo_sapiens,SKP1,S-phase kinase-associated protein 1 isoform b,16290
NP_002706.1,134197771,134225861,-1,5,Homo_sapiens,PPP2CA,serine/threonine-protein phosphatase 2A catalytic subunit alpha isoform,28090
NP_001107047.1,134298650,134366523,-1,5,Homo_sapiens,CDKL3,cyclin-dependent kinase-like 3 isoform 1,67873
NP_003328.1,134371595,134390353,1,5,Homo_sapiens,UBE2B,ubiquitin-conjugating enzyme E2 B,18758
NP_542387.1,134402914,134411854,-1,5,Homo_sapiens,CDKN2AIPNL,CDKN2AIP N-terminal-like protein,8940
NP_001276914.1,134525694,134579317,1,5,Homo_sapiens,JADE2,protein Jade-2 isoform 2,53623
NP_001028675.1,134606949,134624019,-1,5,Homo_sapiens,SAR1B,GTP-binding protein SAR1b,17070
NP_001239160.1,134649076,134693093,1,5,Homo_sapiens,SEC24A,protein transport protein Sec24A isoform 2,44017
NP_001736.1,134738620,134750950,1,5,Homo_sapiens,CAMLG,calcium signal-modulating cyclophilin ligand,12330
NP_001287789.1,134758938,134828706,1,5,Homo_sapiens,DDX46,probable ATP-dependent RNA helicase DDX46 isoform 1,69768
NP_001129058.1,134854900,134855467,1,5,Homo_sapiens,C5orf24,UPF0461 protein C5orf24 isoform 1,567
NP_078991.3,134874427,134899685,1,5,Homo_sapiens,TXNDC15,thioredoxin domain-containing protein 15 precursor,25258
NP_115527.3,134905139,134960681,1,5,Homo_sapiens,PCBD2,pterin-4-alpha-carbinolamine dehydratase 2,55542
NP_821138.1,134967991,135011623,1,5,Homo_sapiens,CATSPER3,cation channel sperm-associated protein 3,43632
NP_002644.4,135028778,135033881,-1,5,Homo_sapiens,PITX1,pituitary homeobox 1,5103
NP_001264277.1,135334118,135343466,1,5,Homo_sapiens,C5orf66,putative uncharacterized protein C5orf66,9348
NP_004884.1,135334975,135389093,-1,5,Homo_sapiens,H2AFY,core histone macro-H2A.1 isoform 2,54118
NP_570900.1,135446373,135447108,-1,5,Homo_sapiens,DCANP1,dendritic cell nuclear protein 1,735
NP_001092691.1,135449453,135449939,-1,5,Homo_sapiens,TIFAB,TRAF-interacting protein with FHA domain-containing protein B,486
NP_006152.2,135534976,135535690,-1,5,Homo_sapiens,NEUROG1,neurogenin-1,714
NP_004878.2,135571852,135578814,-1,5,Homo_sapiens,CXCL14,C-X-C motif chemokine 14 precursor,6962
NP_660325.4,135834847,135888084,1,5,Homo_sapiens,SLC25A48,solute carrier family 25 member 48,53237
NP_000581.1,135892390,135895816,-1,5,Homo_sapiens,IL9,interleukin-9 precursor,3426
NP_036291.2,135936594,135941671,1,5,Homo_sapiens,FBXL21,F-box/LRR-repeat protein 21,5077
NP_002293.2,135947330,135954833,-1,5,Homo_sapiens,LECT2,leukocyte cell-derived chemotaxin-2 precursor,7503
NP_000349.1,136029055,136063226,1,5,Homo_sapiens,TGFBI,transforming growth factor-beta-induced protein ig-h3 precursor,34171
NP_005894.3,136153760,136177480,1,5,Homo_sapiens,SMAD5,mothers against decapentaplegic homolog 5,23720
NP_001161048.1,136213434,136365254,-1,5,Homo_sapiens,TRPC7,short transient receptor potential channel 7 isoform 3,151820
NP_004589.1,136978653,137498558,-1,5,Homo_sapiens,SPOCK1,testican-1 precursor,519905
NP_001244124.1,137622097,137698403,-1,5,Homo_sapiens,KLHL3,kelch-like protein 3 isoform 3,76306
NP_006796.1,137753148,137754066,-1,5,Homo_sapiens,HNRNPA0,heterogeneous nuclear ribonucleoprotein A0,918
NP_006781.1,137870651,137887385,1,5,Homo_sapiens,MYOT,myotilin isoform a,16734
NP_001287850.1,137889491,137936410,1,5,Homo_sapiens,PKD2L2,polycystic kidney disease 2-like 2 protein isoform 4,46919
NP_001095271.1,137940224,138018317,-1,5,Homo_sapiens,FAM13B,protein FAM13B isoform 3,78093
NP_490645.1,138084089,138091073,1,5,Homo_sapiens,WNT8A,protein Wnt-8a isoform 3 precursor,6984
NP_003542.1,138115680,138138780,-1,5,Homo_sapiens,NME5,nucleoside diphosphate kinase homolog 5,23100
NP_631938.1,138140073,138178614,-1,5,Homo_sapiens,BRD8,bromodomain-containing protein 8 isoform 2,38541
NP_005724.1,138179680,138187413,1,5,Homo_sapiens,KIF20A,kinesin-like protein KIF20A,7733
NP_004652.2,138188977,138213312,-1,5,Homo_sapiens,CDC23,cell division cycle protein 23 homolog,24335
NP_001487.2,138252967,138274424,-1,5,Homo_sapiens,GFRA3,GDNF family receptor alpha-3 preproprotein,21457
NP_073720.1,138285691,138331180,-1,5,Homo_sapiens,CDC25C,M-phase inducer phosphatase 3 isoform b,45489
NP_001129119.1,138341335,138346959,1,5,Homo_sapiens,FAM53C,protein FAM53C,5624
NP_057688.2,138352795,138435700,1,5,Homo_sapiens,KDM3B,lysine-specific demethylase 3B,82905
NP_001258732.1,138439208,138445751,1,5,Homo_sapiens,REEP2,receptor expression-enhancing protein 2 isoform 1,6543
NP_001955.1,138465761,138468081,1,5,Homo_sapiens,EGR1,early growth response protein 1,2320
NP_001243231.1,138508304,138518854,-1,5,Homo_sapiens,ETF1,eukaryotic peptide chain release factor subunit 1 isoform 2,10550
NP_004125.3,138556036,138575318,-1,5,Homo_sapiens,HSPA9,"stress-70 protein, mitochondrial precursor",19282
NP_001277236.1,138781924,138933823,1,5,Homo_sapiens,CTNNA1,catenin alpha-1 isoform 2,151899
NP_056379.1,138873009,138874911,-1,5,Homo_sapiens,LRRTM2,leucine-rich repeat transmembrane neuronal protein 2 precursor,1902
NP_001310932.1,138886259,138933823,1,5,Homo_sapiens,CTNNA1,catenin alpha-1 isoform 9,47564
NP_071909.1,138947116,139127843,-1,5,Homo_sapiens,SIL1,nucleotide exchange factor SIL1 precursor,180727
NP_001181885.1,139293980,139329395,1,5,Homo_sapiens,MATR3,matrin-3 isoform b,35415
NP_057564.3,139363784,139368798,1,5,Homo_sapiens,PAIP2,polyadenylate-binding protein-interacting protein 2,5014
NP_005838.3,139372005,139383253,-1,5,Homo_sapiens,SLC23A1,solute carrier family 23 member 1 isoform a,11248
NP_057543.2,139387764,139389856,-1,5,Homo_sapiens,MZB1,marginal zone B- and B1-cell-specific protein precursor,2092
NP_001155018.1,139392033,139395081,-1,5,Homo_sapiens,PROB1,proline-rich basic protein 1,3048
NP_919272.1,139396799,139404060,-1,5,Homo_sapiens,SPATA24,spermatogenesis-associated protein 24,7261
NP_689899.1,139414147,139439445,-1,5,Homo_sapiens,DNAJC18,dnaJ homolog subfamily C member 18,25298
NP_001280668.1,139448764,139462670,-1,5,Homo_sapiens,ECSCR,endothelial cell-specific chemotaxis regulator isoform 2 precursor,13906
NP_938023.1,139476260,139481704,-1,5,Homo_sapiens,TMEM173,stimulator of interferon genes protein isoform 1,5444
NP_003330.1,139561791,139626801,1,5,Homo_sapiens,UBE2D2,ubiquitin-conjugating enzyme E2 D2 isoform 1,65010
NP_057547.5,139680523,139682907,1,5,Homo_sapiens,CXXC5,CXXC-type zinc finger protein 5,2384
NP_115665.1,139809440,139842474,1,5,Homo_sapiens,PSD2,PH and SEC7 domain-containing protein 2,33034
NP_001171864.1,139847916,140043069,-1,5,Homo_sapiens,NRG2,"pro-neuregulin-2, membrane-bound isoform isoform 7",195153
NP_005850.1,140114181,140115150,1,5,Homo_sapiens,PURA,transcriptional activator protein Pur-alpha,969
NP_001007190.1,140128476,140128638,1,5,Homo_sapiens,IGIP,IgA-inducing protein homolog precursor,162
NP_115788.1,140194465,140243411,1,5,Homo_sapiens,CYSTM1,cysteine-rich and transmembrane domain-containing protein 1,48946
NP_002613.2,140245973,140303073,-1,5,Homo_sapiens,PFDN1,prefoldin subunit 1,57100
NP_001936.1,140334675,140346328,-1,5,Homo_sapiens,HBEGF,proheparin-binding EGF-like growth factor precursor,11653
NP_001245357.1,140360236,140372798,1,5,Homo_sapiens,SLC4A9,anion exchange protein 4 isoform 1,12562
NP_001183959.1,140401967,140472312,1,5,Homo_sapiens,ANKHD1,ankyrin repeat and KH domain-containing protein 1 isoform 4,70345
NP_003723.1,140547737,140549262,1,5,Homo_sapiens,EIF4EBP3,eukaryotic translation initiation factor 4E-binding protein 3,1525
NP_001240693.1,140550699,140557452,-1,5,Homo_sapiens,SRA1,steroid receptor RNA activator 1 isoform 2,6753
NP_573420.2,140558584,140564245,-1,5,Homo_sapiens,APBB3,amyloid beta A4 precursor protein-binding family B member 3 isoform a,5661
NP_542401.1,140567169,140568144,1,5,Homo_sapiens,SLC35A4,probable UDP-sugar transporter protein SLC35A4,975
NP_001167575.1,140631855,140633071,-1,5,Homo_sapiens,CD14,monocyte differentiation antigen CD14 precursor,1216
NP_001287909.1,140639527,140645098,1,5,Homo_sapiens,TMCO6,transmembrane and coiled-coil domain-containing protein 6 isoform 1,5571
NP_002479.1,140645586,140647583,-1,5,Homo_sapiens,NDUFA2,NADH dehydrogenase [ubiquinone] 1 alpha subcomplex subunit 2 isoform 1,1997
NP_006074.2,140647908,140662329,1,5,Homo_sapiens,IK,protein Red,14421
NP_060176.2,140664912,140669654,1,5,Homo_sapiens,WDR55,WD repeat-containing protein 55,4742
NP_919225.1,140671292,140673542,-1,5,Homo_sapiens,DND1,dead end protein homolog 1,2250
NP_001276023.1,140674256,140691304,-1,5,Homo_sapiens,HARS,"histidine--tRNA ligase, cytoplasmic isoform 7",17048
NP_036340.1,140691648,140698552,1,5,Homo_sapiens,HARS2,"probable histidine--tRNA ligase, mitochondrial isoform 1 precursor",6904
NP_653324.1,140700460,140705756,1,5,Homo_sapiens,ZMAT2,zinc finger matrin-type protein 2,5296
NP_113598.1,140786290,140788714,1,5,Homo_sapiens,PCDHA1,protocadherin alpha-1 isoform 2 precursor,2424
NP_113683.1,140794964,140797439,1,5,Homo_sapiens,PCDHA2,protocadherin alpha-2 isoform 2 precursor,2475
NP_113685.1,140801197,140803672,1,5,Homo_sapiens,PCDHA3,protocadherin alpha-3 isoform 2 precursor,2475
NP_113688.1,140807187,140809584,1,5,Homo_sapiens,PCDHA4,protocadherin alpha-4 isoform 2 precursor,2397
NP_113689.1,140821775,140824226,1,5,Homo_sapiens,PCDHA5,protocadherin alpha-5 isoform 2 precursor,2451
NP_114036.1,140828091,140830503,1,5,Homo_sapiens,PCDHA6,protocadherin alpha-6 isoform 2 precursor,2412
NP_114040.1,140834383,140836753,1,5,Homo_sapiens,PCDHA7,protocadherin alpha-7 isoform 2 precursor,2370
NP_114062.1,140841321,140843766,1,5,Homo_sapiens,PCDHA8,protocadherin alpha-8 isoform 2 precursor,2445
NP_054724.1,140848495,140851024,1,5,Homo_sapiens,PCDHA9,protocadherin alpha-9 isoform 2 precursor,2529
NP_114065.1,140856048,140858583,1,5,Homo_sapiens,PCDHA10,protocadherin alpha-10 isoform 2 precursor,2535
NP_114067.1,140869103,140871536,1,5,Homo_sapiens,PCDHA11,protocadherin alpha-11 isoform 2 precursor,2433
NP_114070.1,140875472,140877851,1,5,Homo_sapiens,PCDHA12,protocadherin alpha-12 isoform 2 precursor,2379
NP_114071.1,140882268,140884692,1,5,Homo_sapiens,PCDHA13,protocadherin alpha-13 isoform 2 precursor,2424
NP_114088.2,140926892,140929349,1,5,Homo_sapiens,PCDHAC1,protocadherin alpha-C1 isoform 2 precursor,2457
NP_114089.1,140966766,140969421,1,5,Homo_sapiens,PCDHAC2,protocadherin alpha-C2 isoform 2 precursor,2655
NP_037472.2,141051470,141053927,1,5,Homo_sapiens,PCDHB1,protocadherin beta-1 precursor,2457
NP_061759.1,141094790,141097187,1,5,Homo_sapiens,PCDHB2,protocadherin beta-2 precursor,2397
NP_061760.1,141100649,141103040,1,5,Homo_sapiens,PCDHB3,protocadherin beta-3 precursor,2391
NP_061761.1,141121998,141124386,1,5,Homo_sapiens,PCDHB4,protocadherin beta-4 precursor,2388
NP_056484.2,141135434,141137822,1,5,Homo_sapiens,PCDHB5,protocadherin beta-5 precursor,2388
NP_061762.2,141150257,141152642,1,5,Homo_sapiens,PCDHB6,protocadherin beta-6 isoform 1 precursor,2385
NP_061763.1,141172835,141175217,1,5,Homo_sapiens,PCDHB7,protocadherin beta-7 precursor,2382
NP_061993.3,141178034,141180440,1,5,Homo_sapiens,PCDHB8,protocadherin beta-8 precursor,2406
NP_066008.2,141182559,141184890,1,5,Homo_sapiens,PCDHB16,protocadherin beta-16 precursor,2331
NP_061992.3,141187318,141189712,1,5,Homo_sapiens,PCDHB9,protocadherin beta-9 precursor,2394
NP_061753.1,141192552,141194955,1,5,Homo_sapiens,PCDHB10,protocadherin beta-10 precursor,2403
NP_061754.1,141199774,141202168,1,5,Homo_sapiens,PCDHB11,protocadherin beta-11 precursor,2394
NP_061755.1,141208907,141211295,1,5,Homo_sapiens,PCDHB12,protocadherin beta-12 precursor,2388
NP_061756.1,141214123,141216520,1,5,Homo_sapiens,PCDHB13,protocadherin beta-13 precursor,2397
NP_061757.1,141223505,141225902,1,5,Homo_sapiens,PCDHB14,protocadherin beta-14 precursor,2397
NP_061758.1,141245578,141247942,1,5,Homo_sapiens,PCDHB15,protocadherin beta-15 precursor,2364
NP_114153.1,141302959,141303865,-1,5,Homo_sapiens,SLC25A2,mitochondrial ornithine transporter 2,906
NP_005633.2,141318994,141320044,-1,5,Homo_sapiens,TAF7,transcription initiation factor TFIID subunit 7,1050
NP_114382.1,141330684,141333156,1,5,Homo_sapiens,PCDHGA1,protocadherin gamma-A1 isoform 2 precursor,2472
NP_114398.1,141338971,141341443,1,5,Homo_sapiens,PCDHGA2,protocadherin gamma-A2 isoform 2 precursor,2472
NP_114400.1,141344033,141346523,1,5,Homo_sapiens,PCDHGA3,protocadherin gamma-A3 isoform 2 precursor,2490
NP_115266.1,141350260,141352693,1,5,Homo_sapiens,PCDHGB1,protocadherin gamma-B1 isoform 2 precursor,2433
NP_114442.2,141355107,141357663,1,5,Homo_sapiens,PCDHGA4,protocadherin gamma-A4 isoform 2 precursor,2556
NP_115267.1,141360135,141362571,1,5,Homo_sapiens,PCDHGB2,protocadherin gamma-B2 isoform 2 precursor,2436
NP_114443.1,141364330,141366772,1,5,Homo_sapiens,PCDHGA5,protocadherin gamma-A5 isoform 2 precursor,2442
NP_115268.2,141370394,141372839,1,5,Homo_sapiens,PCDHGB3,protocadherin gamma-B3 isoform 2 precursor,2445
NP_114475.1,141374083,141376540,1,5,Homo_sapiens,PCDHGA6,protocadherin gamma-A6 isoform 2 precursor,2457
NP_114476.1,141382899,141385353,1,5,Homo_sapiens,PCDHGA7,protocadherin gamma-A7 isoform 2 precursor,2454
NP_115269.1,141387884,141390296,1,5,Homo_sapiens,PCDHGB4,protocadherin gamma-B4 isoform 2 precursor,2412
NP_054723.1,141392813,141395276,1,5,Homo_sapiens,PCDHGA8,protocadherin gamma-A8 isoform 2 precursor,2463
NP_115270.1,141398127,141400584,1,5,Homo_sapiens,PCDHGB5,protocadherin gamma-B5 isoform 2 precursor,2457
NP_114478.1,141402952,141405439,1,5,Homo_sapiens,PCDHGA9,protocadherin gamma-A9 isoform 2 precursor,2487
NP_115271.1,141408202,141410665,1,5,Homo_sapiens,PCDHGB6,protocadherin gamma-B6 isoform 2 precursor,2463
NP_114479.1,141413175,141415728,1,5,Homo_sapiens,PCDHGA10,protocadherin gamma-A10 isoform 2 precursor,2553
NP_115272.1,141417859,141420286,1,5,Homo_sapiens,PCDHGB7,protocadherin gamma-B7 isoform 2 precursor,2427
NP_114480.1,141421227,141423741,1,5,Homo_sapiens,PCDHGA11,protocadherin gamma-A11 isoform 2 precursor,2514
NP_115265.1,141430759,141433222,1,5,Homo_sapiens,PCDHGA12,protocadherin gamma-A12 isoform 2 precursor,2463
NP_115778.1,141476116,141478708,1,5,Homo_sapiens,PCDHGC3,protocadherin gamma-C3 isoform 2 precursor,2592
NP_115782.1,141485173,141487789,1,5,Homo_sapiens,PCDHGC4,protocadherin gamma-C4 isoform 2 precursor,2616
NP_115783.1,141489240,141491877,1,5,Homo_sapiens,PCDHGC5,protocadherin gamma-C5 isoform 2 precursor,2637
NP_001073280.1,141516850,141618914,-1,5,Homo_sapiens,DIAPH1,protein diaphanous homolog 1 isoform 2,102064
NP_003874.2,141621467,141636790,-1,5,Homo_sapiens,HDAC3,histone deacetylase 3,15323
NP_776189.3,141638225,141640444,1,5,Homo_sapiens,RELL2,RELT-like protein 2,2219
NP_258260.1,141641497,141651368,-1,5,Homo_sapiens,FCHSD1,F-BAR and double SH3 domains protein 1,9871
NP_071926.4,141653949,141680486,-1,5,Homo_sapiens,ARAP3,"arf-GAP with Rho-GAP domain, ANK repeat and PH domain-containing protein 3",26537
NP_115796.2,141854041,141878262,-1,5,Homo_sapiens,PCDH1,protocadherin-1 isoform 2 precursor,24221
NP_055588.3,141923941,141938759,1,5,Homo_sapiens,KIAA0141,death ligand signal enhancer precursor,14818
NP_057664.1,141945380,141957851,-1,5,Homo_sapiens,PCDH12,protocadherin-12 precursor,12471
NP_001188294.1,141973588,141987790,1,5,Homo_sapiens,RNF14,E3 ubiquitin-protein ligase RNF14 isoform 1,14202
NP_005462.1,142002028,142012035,-1,5,Homo_sapiens,GNPDA1,glucosamine-6-phosphate isomerase 1,10007
NP_085048.1,142108974,142144674,1,5,Homo_sapiens,NDFIP1,NEDD4 family-interacting protein 1,35700
NP_001120968.1,142314208,142315108,-1,5,Homo_sapiens,SPRY4,protein sprouty homolog 4 isoform 2,900
NP_001244135.1,142595289,142614127,-1,5,Homo_sapiens,FGF1,fibroblast growth factor 1 isoform 4 precursor,18838
NP_055886.1,142770761,143222446,1,5,Homo_sapiens,ARHGAP26,rho GTPase-activating protein 26 isoform a,451685
NP_001018661.1,143279363,143400839,-1,5,Homo_sapiens,NR3C1,glucocorticoid receptor isoform beta,121476
NP_067005.1,143812267,143820568,1,5,Homo_sapiens,HMHB1,minor histocompatibility protein HB-1,8301
NP_001258661.1,144160396,144165552,-1,5,Homo_sapiens,YIPF5,protein YIPF5 isoform b,5156
NP_065819.1,144206714,144474114,1,5,Homo_sapiens,KCTD16,BTB/POZ domain-containing protein KCTD16,267400
NP_612501.3,145764940,145823122,-1,5,Homo_sapiens,PRELID2,PRELI domain-containing protein 2 isoform c,58182
NP_001073985.1,145859732,145872968,-1,5,Homo_sapiens,GRXCR2,glutaredoxin domain-containing cysteine-rich protein 2,13236
NP_689763.3,145937928,146062701,1,5,Homo_sapiens,SH3RF2,putative E3 ubiquitin-protein ligase SH3RF2,124773
NP_001025040.1,146084431,146104311,-1,5,Homo_sapiens,PLAC8L1,PLAC8-like protein 1,19880
NP_001304894.1,146114105,146172737,-1,5,Homo_sapiens,LARS,"leucine--tRNA ligase, cytoplasmic isoform 4",58632
NP_061862.1,146203765,146286030,1,5,Homo_sapiens,RBM27,RNA-binding protein 27,82265
NP_002691.1,146339112,146340444,1,5,Homo_sapiens,POU4F3,"POU domain, class 4, transcription factor 3",1332
NP_006697.2,146447349,146510642,1,5,Homo_sapiens,TCERG1,transcription elongation regulator 1 isoform 1,63293
NP_919227.2,146514853,146516113,-1,5,Homo_sapiens,GPR151,probable G-protein coupled receptor 151,1260
NP_858064.1,146589946,146856535,-1,5,Homo_sapiens,PPP2R2B,serine/threonine-protein phosphatase 2A 55 kDa regulatory subunit B beta isoform isoform d,266589
NP_659438.1,147239634,147348723,1,5,Homo_sapiens,STK32A,serine/threonine-protein kinase 32A isoform 2,109089
NP_001378.1,147394034,147453587,-1,5,Homo_sapiens,DPYSL3,dihydropyrimidinase-related protein 3 isoform 2,59553
NP_055605.2,147591665,147671806,-1,5,Homo_sapiens,JAKMIP2,janus kinase and microtubule-interacting protein 2 isoform 3,80141
NP_003113.2,147824660,147831577,-1,5,Homo_sapiens,SPINK1,serine protease inhibitor Kazal-type 1 precursor,6917
NP_473364.1,147878803,147882050,1,5,Homo_sapiens,SCGB3A2,secretoglobin family 3A member 2 precursor,3247
NP_996849.2,147896992,147906501,-1,5,Homo_sapiens,C5orf46,uncharacterized protein C5orf46 precursor,9509
NP_001121171.1,148064044,148124849,1,5,Homo_sapiens,SPINK5,serine protease inhibitor Kazal-type 5 isoform c preproprotein,60805
NP_001001325.1,148169732,148175398,1,5,Homo_sapiens,SPINK14,serine protease inhibitor Kazal-type 14 precursor,5666
NP_001182219.1,148203096,148214950,1,5,Homo_sapiens,SPINK6,serine protease inhibitor Kazal-type 6 precursor,11854
XP_011536019.1,148238597,148243254,1,5,Homo_sapiens,LOC105378220,macrophage receptor MARCO,4657
NP_001035218.1,148270072,148286048,1,5,Homo_sapiens,SPINK13,serine protease inhibitor Kazal-type 13 precursor,15976
NP_115955.1,148312483,148315684,1,5,Homo_sapiens,SPINK7,serine protease inhibitor Kazal-type 7 precursor,3201
NP_001035523.1,148335613,148339712,1,5,Homo_sapiens,SPINK9,serine protease inhibitor Kazal-type 9 precursor,4099
NP_110420.3,148394776,148442147,1,5,Homo_sapiens,FBXO38,F-box only protein 38 isoform a,47371
NP_001035259.1,148451184,148637014,-1,5,Homo_sapiens,HTR4,5-hydroxytryptamine receptor 4 isoform a,185830
NP_000015.1,148826831,148828073,1,5,Homo_sapiens,ADRB2,beta-2 adrenergic receptor,1242
NP_078853.2,149004710,149063022,-1,5,Homo_sapiens,SH3TC2,SH3 domain and tetratricopeptide repeat-containing protein 2,58312
NP_001287944.1,149142095,149258404,1,5,Homo_sapiens,ABLIM3,actin-binding LIM protein 3 isoform 1,116309
NP_001309992.1,149271968,149312318,1,5,Homo_sapiens,AFAP1L1,actin filament-associated protein 1-like 1 isoform 4,40350
NP_689620.2,149345539,149351282,1,5,Homo_sapiens,GRPEL2,"grpE protein homolog 2, mitochondrial precursor",5743
NP_076933.3,149358068,149368654,1,5,Homo_sapiens,PCYOX1L,prenylcysteine oxidase-like isoform 1 precursor,10586
NP_001304916.1,149374368,149376890,-1,5,Homo_sapiens,IL17B,interleukin-17B isoform 2,2522
NP_001258671.1,149496852,149525134,-1,5,Homo_sapiens,CSNK1A1,casein kinase I isoform alpha isoform 4,28282
NP_001001669.2,149597769,149632191,1,5,Homo_sapiens,ARHGEF37,rho guanine nucleotide exchange factor 37,34422
NP_573570.3,149730342,149847558,1,5,Homo_sapiens,PPARGC1B,peroxisome proliferator-activated receptor gamma coactivator 1-beta isoform 1,117216
NP_000431.2,149860894,149944673,-1,5,Homo_sapiens,PDE6A,"rod cGMP-specific 3',5'-cyclic phosphodiesterase subunit alpha",83779
NP_000103.2,149977652,149981813,1,5,Homo_sapiens,SLC26A2,sulfate transporter,4161
NP_112215.1,149994782,149996348,-1,5,Homo_sapiens,TIGD6,tigger transposable element-derived protein 6,1566
NP_055798.2,150004852,150052192,1,5,Homo_sapiens,HMGXB3,HMG domain-containing protein 3,47340
NP_005202.2,150054068,150086427,-1,5,Homo_sapiens,CSF1R,macrophage colony-stimulating factor 1 receptor precursor,32359
NP_002600.1,150115762,150137047,-1,5,Homo_sapiens,PDGFRB,platelet-derived growth factor receptor beta precursor,21285
NP_001795.2,150166876,150183680,1,5,Homo_sapiens,CDX1,homeobox protein CDX-1,16804
NP_055043.2,150190327,150209615,1,5,Homo_sapiens,SLC6A7,sodium-dependent proline transporter,19288
NP_741960.1,150222709,150289625,-1,5,Homo_sapiens,CAMK2A,calcium/calmodulin-dependent protein kinase type II subunit alpha isoform 2,66916
NP_001012301.1,150297213,150302373,-1,5,Homo_sapiens,ARSI,arylsulfatase I precursor,5160
NP_001008657.1,150357746,150383755,1,5,Homo_sapiens,TCOF1,treacle protein isoform c,26009
NP_004346.1,150402239,150412749,-1,5,Homo_sapiens,CD74,HLA class II histocompatibility antigen gamma chain isoform b,10510
NP_005608.1,150444285,150447733,-1,5,Homo_sapiens,RPS14,40S ribosomal protein S14,3448
NP_001534.1,150521254,150553332,1,5,Homo_sapiens,NDST1,bifunctional heparan sulfate N-deacetylase/N-sulfotransferase 1 isoform 1,32078
NP_001159680.1,150618367,150650333,1,5,Homo_sapiens,SYNPO,synaptopodin isoform C,31966
NP_588612.2,150662941,150676875,1,5,Homo_sapiens,MYOZ3,myozenin-3,13934
NP_060517.1,150691750,150700985,-1,5,Homo_sapiens,RBM22,pre-mRNA-splicing factor RBM22,9235
NP_001129116.1,150711148,150756451,-1,5,Homo_sapiens,DCTN4,dynactin subunit 4 isoform c,45303
NP_116565.3,150795440,150795623,1,5,Homo_sapiens,SMIM3,small integral membrane protein 3,183
NP_001139277.1,150848123,150848669,1,5,Homo_sapiens,IRGM,immunity-related GTPase family M protein,546
NP_001166303.1,150895423,150898461,-1,5,Homo_sapiens,ZNF300,zinc finger protein 300 isoform 3,3038
NP_002075.2,151020654,151028130,1,5,Homo_sapiens,GPX3,glutathione peroxidase 3 precursor,7476
NP_001239321.1,151030641,151065095,-1,5,Homo_sapiens,TNIP1,TNFAIP3-interacting protein 1 isoform 4,34454
NP_001180473.1,151101447,151140165,-1,5,Homo_sapiens,ANXA6,annexin A6 isoform 2,38718
NP_056436.2,151183436,151223970,-1,5,Homo_sapiens,CCDC69,coiled-coil domain-containing protein 69,40534
XP_016865624.1,151212763,151224114,1,5,Homo_sapiens,LOC105378230,synapsin-1-like,11351
NP_000396.2,151253216,151267451,1,5,Homo_sapiens,GM2A,ganglioside GM2 activator isoform 1 precursor,14235
NP_861439.3,151277392,151303354,-1,5,Homo_sapiens,SLC36A3,proton-coupled amino acid transporter 3 isoform 2,25962
NP_861441.2,151316816,151347460,-1,5,Homo_sapiens,SLC36A2,proton-coupled amino acid transporter 2,30644
NP_001295080.1,151458792,151469254,1,5,Homo_sapiens,SLC36A1,proton-coupled amino acid transporter 1 isoform c,10462
NP_001438.1,151505564,151568931,-1,5,Homo_sapiens,FAT2,protocadherin Fat 2 precursor,63367
NP_001296373.1,151663454,151676188,-1,5,Homo_sapiens,SPARC,SPARC isoform 3 precursor,12734
NP_004036.1,151746324,151758551,-1,5,Homo_sapiens,ATOX1,copper transport protein ATOX1,12227
NP_938405.1,151786620,151804091,1,5,Homo_sapiens,G3BP1,ras GTPase-activating protein-binding protein 1,17471
NP_001278929.1,151822672,151886723,-1,5,Homo_sapiens,GLRA1,glycine receptor subunit alpha-1 isoform 3,64051
NP_064552.3,152392190,152405113,-1,5,Homo_sapiens,NMUR2,neuromedin-U receptor 2,12923
NP_000818.2,153490888,153811225,1,5,Homo_sapiens,GRIA1,glutamate receptor 1 isoform 1 precursor,320337
NP_001304924.1,153992975,154034953,-1,5,Homo_sapiens,FAM114A2,protein FAM114A2 isoform 2,41978
NP_001229265.1,154049722,154053713,1,5,Homo_sapiens,MFAP3,microfibril-associated glycoprotein 3 isoform 1 precursor,3991
NP_938080.1,154190866,154416972,1,5,Homo_sapiens,GALNT10,polypeptide N-acetylgalactosaminyltransferase 10,226106
NP_078908.1,154446604,154456028,1,5,Homo_sapiens,SAP30L,histone deacetylase complex subunit SAP30L isoform 1,9424
NP_004812.1,154475805,154478008,-1,5,Homo_sapiens,HAND1,heart- and neural crest derivatives-expressed protein 1,2203
NP_056130.2,154712925,154814096,1,5,Homo_sapiens,LARP1,la-related protein 1,101171
NP_115761.2,154820315,154838178,-1,5,Homo_sapiens,FAXDC2,fatty acid hydroxylase domain-containing protein 2,17863
NP_004770.4,154863278,154875439,1,5,Homo_sapiens,CNOT8,CCR4-NOT transcription complex subunit 8 isoform 1,12161
NP_001239085.1,154888209,154938133,-1,5,Homo_sapiens,GEMIN5,gem-associated protein 5 isoform 2,49924
NP_054899.2,154941110,154966897,1,5,Homo_sapiens,MRPL22,"39S ribosomal protein L22, mitochondrial isoform a",25787
NP_001092763.1,155013859,155017564,1,5,Homo_sapiens,KIF4B,chromosome-associated kinesin KIF4B,3705
NP_758447.1,156329576,156757776,1,5,Homo_sapiens,SGCD,delta-sarcoglycan isoform 2,428200
NP_001140198.1,156919456,156963198,-1,5,Homo_sapiens,TIMD4,T-cell immunoglobulin and mucin domain-containing protein 4 isoform 2 precursor,43742
NP_001295085.1,157029587,157057943,-1,5,Homo_sapiens,HAVCR1,hepatitis A virus cellular receptor 1 isoform b precursor,28356
NP_116171.3,157087101,157108983,-1,5,Homo_sapiens,HAVCR2,hepatitis A virus cellular receptor 2 precursor,21882
NP_001094286.1,157138729,157139431,-1,5,Homo_sapiens,MED7,mediator of RNA polymerase II transcription subunit 7,702
NP_570969.2,157162446,157166168,-1,5,Homo_sapiens,FAM71B,protein FAM71B,3722
NP_005537.3,157180977,157252678,1,5,Homo_sapiens,ITK,tyrosine-protein kinase ITK/TSK,71701
NP_001278651.1,157285361,157393000,1,5,Homo_sapiens,CYFIP2,cytoplasmic FMR1-interacting protein 2 isoform c,107639
NP_001001343.2,157342861,157343536,-1,5,Homo_sapiens,FNDC9,fibronectin type III domain-containing protein 9,675
NP_001092757.1,157460134,157472960,1,5,Homo_sapiens,NIPAL4,magnesium transporter NIPA4 isoform 1,12826
NP_150377.1,157480948,157575696,-1,5,Homo_sapiens,ADAM19,disintegrin and metalloproteinase domain-containing protein 19 preproprotein,94748
NP_848511.1,157626339,157652078,-1,5,Homo_sapiens,SOX30,transcription factor SOX-30 isoform a,25739
NP_001138604.1,157671614,157679999,1,5,Homo_sapiens,C5orf52,uncharacterized protein C5orf52,8385
NP_060342.2,157731440,157739482,1,5,Homo_sapiens,THG1L,probable tRNA(His) guanylyltransferase isoform 1,8042
NP_775762.1,157743750,157755264,1,5,Homo_sapiens,LSM11,U7 snRNA-associated Sm-like protein LSm11,11514
NP_001182485.1,157787645,157817534,-1,5,Homo_sapiens,CLINT1,clathrin interactor 1 isoform 3,29889
NP_001311040.1,158699110,159095631,-1,5,Homo_sapiens,EBF1,transcription factor COE1 isoform 10,396521
NP_001186312.1,159158669,159203617,-1,5,Homo_sapiens,RNF145,RING finger protein 145 isoform 5,44948
NP_659486.2,159268915,159284931,1,5,Homo_sapiens,UBLCP1,ubiquitin-like domain-containing CTD phosphatase 1,16016
NP_002178.2,159316684,159326782,-1,5,Homo_sapiens,IL12B,interleukin-12 subunit beta precursor,10098
NP_000670.1,159916905,159972492,1,5,Homo_sapiens,ADRA1B,alpha-1B adrenergic receptor,55587
NP_003305.1,160010528,160065065,1,5,Homo_sapiens,TTC1,tetratricopeptide repeat protein 1,54537
NP_001253964.1,160078154,160119388,-1,5,Homo_sapiens,PWWP2A,PWWP domain-containing protein 2A isoform c,41234
NP_001124430.1,160199106,160238659,1,5,Homo_sapiens,FABP6,gastrotropin isoform 1,39553
NP_001295102.1,160253377,160311923,-1,5,Homo_sapiens,CCNJL,cyclin-J-like protein isoform b,58546
NP_114114.2,160349167,160370637,-1,5,Homo_sapiens,C1QTNF2,complement C1q tumor necrosis factor-related protein 2,21470
NP_071373.2,160393705,160395490,-1,5,Homo_sapiens,ZBED8,protein ZBED8,1785
NP_006416.3,160403284,160415294,-1,5,Homo_sapiens,SLU7,pre-mRNA-splicing factor SLU7,12010
NP_004210.1,160422312,160428681,1,5,Homo_sapiens,PTTG1,securin,6369
NP_079429.2,160565452,160688074,-1,5,Homo_sapiens,ATP10B,probable phospholipid-transporting ATPase VB,122622
NP_000804.1,161294080,161546643,-1,5,Homo_sapiens,GABRB2,gamma-aminobutyric acid receptor subunit beta-2 isoform 2 precursor,252563
NP_000802.2,161685989,161701773,1,5,Homo_sapiens,GABRA6,gamma-aminobutyric acid receptor subunit alpha-6 precursor,15784
NP_001121115.1,161850810,161897422,1,5,Homo_sapiens,GABRA1,gamma-aminobutyric acid receptor subunit alpha-1 precursor,46612
NP_944493.2,162067999,162153368,1,5,Homo_sapiens,GABRG2,gamma-aminobutyric acid receptor subunit gamma-2 isoform 3 precursor,85369
NP_954854.1,163439256,163442565,1,5,Homo_sapiens,CCNG1,cyclin-G1,3309
NP_660309.1,163453966,163460050,-1,5,Homo_sapiens,NUDCD2,nudC domain-containing protein 2,6084
NP_001136028.1,163460692,163491164,1,5,Homo_sapiens,HMMR,hyaluronan mediated motility receptor isoform a,30472
NP_877725.1,163503394,163518363,1,5,Homo_sapiens,MAT2B,methionine adenosyltransferase 2 subunit beta isoform 2,14969
NP_001116151.1,167284837,168262810,1,5,Homo_sapiens,TENM2,teneurin-2 isoform 1,977973
NP_001155133.1,168292152,168469017,1,5,Homo_sapiens,WWC1,protein KIBRA isoform 1,176865
NP_002878.2,168486498,168519190,1,5,Homo_sapiens,RARS,"arginine--tRNA ligase, cytoplasmic",32692
NP_078870.1,168557570,168579283,-1,5,Homo_sapiens,PANK3,pantothenate kinase 3,21713
NP_003053.1,168666453,169300709,-1,5,Homo_sapiens,SLIT3,slit homolog 3 protein isoform 2 precursor,634256
NP_060255.3,169588416,169604207,1,5,Homo_sapiens,SPDL1,protein Spindly,15791
NP_004937.1,169637326,170082858,1,5,Homo_sapiens,DOCK2,dedicator of cytokinesis protein 2,445532
NP_001123363.1,169864272,169883898,-1,5,Homo_sapiens,FAM196B,protein FAM196B,19626
NP_036320.2,170105957,170108611,1,5,Homo_sapiens,FOXI1,forkhead box protein I1 isoform a,2654
NP_001292324.1,170234135,170236210,1,5,Homo_sapiens,C5orf58,putative uncharacterized protein C5orf58 isoform b,2075
NP_005556.1,170248696,170297611,-1,5,Homo_sapiens,LCP2,lymphocyte cytosolic protein 2,48915
NP_001030010.1,170353876,170735806,1,5,Homo_sapiens,KCNIP1,Kv channel-interacting protein 1 isoform 3,381930
NP_004128.1,170378703,170385447,-1,5,Homo_sapiens,KCNMB1,calcium-activated potassium channel subunit beta-1,6744
NP_001030009.1,170504572,170735806,1,5,Homo_sapiens,KCNIP1,Kv channel-interacting protein 1 isoform 1,231234
NP_001278914.1,170788615,170811993,1,5,Homo_sapiens,GABRP,gamma-aminobutyric acid receptor subunit pi isoform 2 precursor,23378
NP_075048.1,170862033,171298858,1,5,Homo_sapiens,RANBP17,ran-binding protein 17,436825
NP_066305.2,171309365,171311599,1,5,Homo_sapiens,TLX3,T-cell leukemia homeobox protein 3,2234
NP_001032827.1,171387948,171406405,1,5,Homo_sapiens,NPM1,nucleophosmin isoform 3,18457
NP_003853.1,171420199,171456805,1,5,Homo_sapiens,FGF18,fibroblast growth factor 18 precursor,36606
NP_001276899.1,171785871,171791088,1,5,Homo_sapiens,SMIM23,small integral membrane protein 23,5217
NP_387449.2,171868634,172006502,-1,5,Homo_sapiens,FBXW11,F-box/WD repeat-containing protein 11 isoform A,137868
NP_005981.3,172044881,172188042,-1,5,Homo_sapiens,STK10,serine/threonine-protein kinase 10,143161
NP_001164654.1,172194172,172203345,1,5,Homo_sapiens,EFCAB9,EF-hand calcium-binding domain-containing protein 9,9173
NP_689490.2,172211829,172283665,-1,5,Homo_sapiens,UBTD2,ubiquitin domain-containing protein 2,71836
NP_001295104.1,172325275,172454352,-1,5,Homo_sapiens,SH3PXD2B,SH3 and PX domain-containing protein 2B isoform b,129077
NP_001136123.1,172641406,172686925,1,5,Homo_sapiens,NEURL1B,E3 ubiquitin-protein ligase NEURL1B isoform hNEUR2,45519
NP_001274741.1,172758262,172762517,1,5,Homo_sapiens,LOC101928093,uncharacterized protein LOC101928093,4255
NP_004408.1,172768761,172770952,-1,5,Homo_sapiens,DUSP1,dual specificity protein phosphatase 1,2191
NP_001026881.1,172834413,172950816,1,5,Homo_sapiens,ERGIC1,endoplasmic reticulum-Golgi intermediate compartment protein 1,116403
NP_057177.1,172959873,172969541,1,5,Homo_sapiens,RPL26L1,60S ribosomal protein L26-like 1,9668
NP_003936.1,172983860,173020331,1,5,Homo_sapiens,ATP6V0E1,V-type proton ATPase subunit e 1,36471
NP_001161865.1,173080775,173091433,1,5,Homo_sapiens,CREBRF,CREB3 regulatory factor isoform 2,10658
NP_053582.2,173144545,173163921,1,5,Homo_sapiens,BNIP1,vesicle transport protein SEC20 isoform BNIP1-b,19376
NP_004378.1,173232568,173235083,-1,5,Homo_sapiens,NKX2-5,homeobox protein Nkx-2.5 isoform 1,2515
NP_003705.1,173317846,173328193,-1,5,Homo_sapiens,STC2,stanniocalcin-2 precursor,10347
NP_001153123.1,173608264,173616436,-1,5,Homo_sapiens,BOD1,biorientation of chromosomes in cell division protein 1 isoform b,8172
NP_085130.2,173889733,173956137,1,5,Homo_sapiens,CPEB4,cytoplasmic polyadenylation element-binding protein 4 isoform a,66404
NP_001138426.1,173989263,174001215,1,5,Homo_sapiens,C5orf47,uncharacterized protein C5orf47,11952
NP_057064.1,174046755,174107505,1,5,Homo_sapiens,HMP19,neuron-specific protein family member 2,60750
NP_002440.2,174724659,174729583,1,5,Homo_sapiens,MSX2,homeobox protein MSX-2,4924
NP_000785.1,175441758,175443099,-1,5,Homo_sapiens,DRD1,D(1A) dopamine receptor,1341
NP_001309912.1,175492103,175513595,1,5,Homo_sapiens,SFXN1,sideroflexin-1 isoform 3,21492
NP_071640.1,175683233,175684313,1,5,Homo_sapiens,HRH2,histamine H2 receptor isoform 2,1080
NP_001008221.1,175878739,175880045,1,5,Homo_sapiens,CPLX2,complexin-2,1306
NP_115737.1,175959968,175968208,-1,5,Homo_sapiens,THOC3,THO complex subunit 3,8240
XP_011533011.1,176034233,176035127,1,5,Homo_sapiens,LOC105377746,uncharacterized protein LOC105377746,894
NP_001252544.1,176089518,176114049,1,5,Homo_sapiens,FAM153B,protein FAM153B,24531
NP_001295124.1,176238508,176345445,1,5,Homo_sapiens,SIMC1,SUMO-interacting motif-containing protein 1 isoform a,106937
NP_001274264.1,176347599,176352712,-1,5,Homo_sapiens,KIAA1191,putative monooxygenase p33MONOX isoform c,5113
NP_001304877.1,176365563,176369252,1,5,Homo_sapiens,ARL10,ADP-ribosylation factor-like protein 10 isoform 1,3689
NP_001278234.1,176383980,176388466,-1,5,Homo_sapiens,NOP16,nucleolar protein 16 isoform 4,4486
NP_620175.1,176388819,176389497,1,5,Homo_sapiens,HIGD2A,"HIG1 domain family member 2A, mitochondrial",678
NP_001825.1,176392773,176416363,-1,5,Homo_sapiens,CLTB,clathrin light chain B isoform a,23590
NP_055428.1,176448407,176506950,1,5,Homo_sapiens,FAF2,FAS-associated factor 2,58543
NP_055716.1,176529027,176532472,-1,5,Homo_sapiens,RNF44,RING finger protein 44,3445
NP_001165447.1,176565352,176595672,1,5,Homo_sapiens,CDHR2,cadherin-related family member 2 precursor,30320
NP_443131.2,176596807,176599834,-1,5,Homo_sapiens,GPRIN1,G protein-regulated inducer of neurite outgrowth 1,3027
NP_001304963.1,176620810,176629654,-1,5,Homo_sapiens,SNCB,beta-synuclein isoform 2,8844
NP_001092878.1,176642787,176645980,1,5,Homo_sapiens,EIF4E1B,eukaryotic translation initiation factor 4E type 1B,3193
NP_001006617.2,176647615,176657532,1,5,Homo_sapiens,TSPAN17,tetraspanin-17 isoform c,9917
NP_588610.2,176810750,176879886,1,5,Homo_sapiens,UNC5A,netrin receptor UNC5A precursor,69136
NP_002106.2,176881072,176896159,-1,5,Homo_sapiens,HK3,hexokinase-3,15087
NP_001304890.1,176905281,176982615,-1,5,Homo_sapiens,UIMC1,BRCA1-A complex subunit RAP80 isoform 2,77334
NP_001295142.1,177022738,177064599,1,5,Homo_sapiens,ZNF346,zinc finger protein 346 isoform b,41861
NP_002002.3,177089602,177097676,1,5,Homo_sapiens,FGFR4,fibroblast growth factor receptor 4 isoform 1 precursor,8074
NP_071900.2,177135103,177295459,1,5,Homo_sapiens,NSD1,"histone-lysine N-methyltransferase, H3 lysine-36 and H4 lysine-20 specific isoform b",160356
NP_001026847.1,177301742,177303288,-1,5,Homo_sapiens,RAB24,ras-related protein Rab-24,1546
NP_037369.1,177303985,177306570,1,5,Homo_sapiens,PRELID1,"PRELI domain-containing protein 1, mitochondrial isoform 1 precursor",2585
NP_001136407.1,177307118,177311830,-1,5,Homo_sapiens,MXD3,max dimerization protein 3 isoform b,4712
NP_006807.1,177332085,177351647,-1,5,Homo_sapiens,LMAN2,vesicular integral-membrane protein VIP36 precursor,19562
NP_006471.2,177358024,177372075,1,5,Homo_sapiens,RGS14,regulator of G-protein signaling 14,14051
NP_001161051.1,177385741,177389725,1,5,Homo_sapiens,SLC34A1,sodium-dependent phosphate transport protein 2A isoform 2,3984
NP_001025057.1,177400162,177400576,-1,5,Homo_sapiens,PFN3,profilin-3,414
NP_000496.2,177402291,177409527,-1,5,Homo_sapiens,F12,coagulation factor XII preproprotein,7236
NP_001004105.1,177426845,177441250,1,5,Homo_sapiens,GRK6,G protein-coupled receptor kinase 6 isoform C,14405
NP_085044.2,177455067,177456121,1,5,Homo_sapiens,PRR7,proline-rich protein 7,1054
NP_543157.1,177457432,177472210,-1,5,Homo_sapiens,DBN1,drebrin isoform b,14778
NP_976227.1,177483643,177496512,-1,5,Homo_sapiens,PDLIM7,PDZ and LIM domain protein 7 isoform 2,12869
NP_001138348.1,177503044,177509540,-1,5,Homo_sapiens,DOK3,docking protein 3 isoform 3,6496
NP_001308661.1,177511790,177515984,-1,5,Homo_sapiens,DDX41,probable ATP-dependent RNA helicase DDX41 isoform 2,4194
NP_001177875.1,177521974,177554458,-1,5,Homo_sapiens,FAM193B,protein FAM193B,32484
NP_059980.2,177592214,177595416,1,5,Homo_sapiens,TMED9,transmembrane emp24 domain-containing protein 9 precursor,3202
NP_009186.1,177600210,177609695,1,5,Homo_sapiens,B4GALT7,"beta-1,4-galactosyltransferase 7",9485
NP_775934.3,177724112,177748643,-1,5,Homo_sapiens,FAM153A,protein FAM153A,24531
XP_016865626.1,177801234,177803643,-1,5,Homo_sapiens,LOC105377752,protein FAM83G-like,2409
NP_006252.3,177992708,177995933,-1,5,Homo_sapiens,PROP1,homeobox protein prophet of Pit-1,3225
NP_055926.1,178119583,178122001,1,5,Homo_sapiens,N4BP3,NEDD4-binding protein 3,2418
NP_001275724.1,178135212,178148032,1,5,Homo_sapiens,RMND5B,protein RMD5 homolog B isoform b,12820
NP_060308.1,178149712,178153817,-1,5,Homo_sapiens,NHP2,H/ACA ribonucleoprotein complex subunit 2 isoform a,4105
NP_112556.2,178204837,178210623,1,5,Homo_sapiens,HNRNPAB,heterogeneous nuclear ribonucleoprotein A/B isoform a,5786
NP_001265275.1,178211920,178231459,-1,5,Homo_sapiens,PHYKPL,5-phosphohydroxy-L-lysine phospho-lyase isoform 3,19539
NP_775736.2,178238697,178590197,-1,5,Homo_sapiens,COL23A1,collagen alpha-1(XXIII) chain,351500
NP_065717.1,178603616,178623416,-1,5,Homo_sapiens,CLK4,dual specificity protein kinase CLK4,19800
NP_001311268.1,178712059,178727032,-1,5,Homo_sapiens,ZNF354A,zinc finger protein 354A isoform 2,14973
NP_478137.1,178861047,178884291,1,5,Homo_sapiens,ZNF354B,zinc finger protein 354B,23244
XP_016865629.1,178895770,178916650,1,5,Homo_sapiens,LOC107984119,zinc finger protein 181-like,20880
NP_085116.2,178931313,178932699,1,5,Homo_sapiens,ZFP2,zinc finger protein 2 homolog,1386
NP_001310237.1,178942791,178957165,1,5,Homo_sapiens,ZNF454,zinc finger protein 454 isoform 2,14374
NP_000834.2,178981656,178994944,-1,5,Homo_sapiens,GRM6,metabotropic glutamate receptor 6 precursor,13288
NP_001129588.1,179025004,179033640,1,5,Homo_sapiens,ZNF879,zinc finger protein 879,8636
NP_055409.1,179062068,179080097,1,5,Homo_sapiens,ZNF354C,zinc finger protein 354C,18029
NP_055059.2,179113866,179345328,-1,5,Homo_sapiens,ADAMTS2,A disintegrin and metalloproteinase with thrombospondin motifs 2 isoform 1 preproprotein,231462
NP_079434.3,179550569,179609519,1,5,Homo_sapiens,RUFY1,RUN and FYVE domain-containing protein 1 isoform a,58950
NP_001244222.1,179615545,179623133,-1,5,Homo_sapiens,HNRNPH1,heterogeneous nuclear ribonucleoprotein H,7588
NP_001135778.1,179642338,179645020,-1,5,Homo_sapiens,C5orf60,putative uncharacterized protein FLJ35723 isoform b,2682
NP_001157916.1,179678582,179680918,-1,5,Homo_sapiens,CBY3,protein chibby homolog 3,2336
NP_001737.1,179705681,179728644,1,5,Homo_sapiens,CANX,calnexin precursor,22963
NP_055572.1,179733112,179774877,1,5,Homo_sapiens,MAML1,mastermind-like protein 1,41765
NP_665874.1,179794080,179796394,1,5,Homo_sapiens,LTC4S,leukotriene C4 synthase,2314
NP_463459.1,179798044,179802111,-1,5,Homo_sapiens,MGAT4B,"alpha-1,3-mannosyl-glycoprotein 4-beta-N-acetylglucosaminyltransferase B isoform 2",4067
NP_003891.1,179820936,179836593,1,5,Homo_sapiens,SQSTM1,sequestosome-1 isoform 1,15657
NP_001017987.1,179837390,179858796,-1,5,Homo_sapiens,C5orf45,UPF0544 protein C5orf45 isoform 2,21406
NP_055858.2,179863447,179907821,-1,5,Homo_sapiens,TBC1D9B,TBC1 domain family member 9B isoform b,44374
NP_060904.2,179955653,180071702,-1,5,Homo_sapiens,RNF130,E3 ubiquitin-protein ligase RNF130 isoform 1 precursor,116049
NP_778232.2,180101500,180138052,-1,5,Homo_sapiens,RASGEF1C,ras-GEF domain-containing family member 1C,36552
NP_002743.3,180236383,180280561,-1,5,Homo_sapiens,MAPK9,mitogen-activated protein kinase 9 isoform alpha2,44178
NP_005101.1,180301563,180353217,-1,5,Homo_sapiens,GFPT2,glutamine--fructose-6-phosphate aminotransferase [isomerizing] 2,51654
NP_001290170.1,180529276,180574200,1,5,Homo_sapiens,CNOT6,CCR4-NOT transcription complex subunit 6,44924
NP_443095.2,180590230,180591462,-1,5,Homo_sapiens,SCGB3A1,secretoglobin family 3A member 1 precursor,1232
NP_891555.2,180603191,180649545,-1,5,Homo_sapiens,FLT4,vascular endothelial growth factor receptor 3 isoform 1 precursor,46354
NP_001001657.1,180739122,180740058,-1,5,Homo_sapiens,OR2Y1,olfactory receptor 2Y1,936
NP_002397.2,180791633,180792971,-1,5,Homo_sapiens,MGAT1,"alpha-1,3-mannosyl-glycoprotein 2-beta-N-acetylglucosaminyltransferase",1338
NP_689496.4,180848791,180851395,-1,5,Homo_sapiens,ZFP62,zinc finger protein 62 homolog isoform 1,2604
NP_079126.1,180899310,180949955,1,5,Homo_sapiens,BTNL8,butyrophilin-like protein 8 isoform 1 precursor,50645
NP_932079.1,180989028,181005872,1,5,Homo_sapiens,BTNL3,butyrophilin-like protein 3 precursor,16844
NP_001295174.1,181045489,181056617,1,5,Homo_sapiens,BTNL9,butyrophilin-like protein 9 isoform b precursor,11128
NP_001245212.1,181124356,181125304,-1,5,Homo_sapiens,OR2V1,olfactory receptor 2V1,948
NP_996763.1,181154942,181155890,1,5,Homo_sapiens,OR2V2,olfactory receptor 2V2,948
NP_976039.1,181195165,181200075,-1,5,Homo_sapiens,TRIM7,tripartite motif-containing protein 7 isoform 3,4910
NP_203128.1,181203496,181205110,-1,5,Homo_sapiens,TRIM7,tripartite motif-containing protein 7 isoform 4,1614
NP_291027.3,181223999,181234775,1,5,Homo_sapiens,TRIM41,E3 ubiquitin-protein ligase TRIM41 isoform 1,10776
NP_006089.1,181236976,181243800,-1,5,Homo_sapiens,RACK1,receptor of activated protein C kinase 1,6824
NP_116154.1,181257413,181260813,-1,5,Homo_sapiens,TRIM52,tripartite motif-containing protein 52,3400
NP_001005224.1,181367286,181368225,1,5,Homo_sapiens,OR4F3,olfactory receptor 4F3/4F16/4F29,939
NP_001073062.1,2476202,2809093,-1,23,Bos_taurus,PRIM2,DNA primase large subunit,332891
NP_001193835.1,2936080,2953601,1,23,Bos_taurus,RAB23,ras-related protein Rab-23,17521
NP_001029436.1,2957953,2966813,-1,23,Bos_taurus,BAG2,BAG family molecular chaperone regulator 2,8860
NP_001179613.1,2971788,3058877,-1,23,Bos_taurus,ZNF451,zinc finger protein 451,87089
XP_010816413.1,3089798,3101566,-1,23,Bos_taurus,LOC104975635,uncharacterized protein LOC104975635,11768
NP_001192483.1,3125703,3149209,-1,23,Bos_taurus,BEND6,BEN domain-containing protein 6,23506
XP_015315228.1,3171446,3687407,1,23,Bos_taurus,LOC535297,dystonin,515961
NP_001291945.1,4390361,4533848,1,23,Bos_taurus,BMP5,bone morphogenetic protein 5 precursor,143487
NP_001178122.1,4709422,4906605,1,23,Bos_taurus,HMGCLL1,"3-hydroxymethyl-3-methylglutaryl-CoA lyase, cytoplasmic",197183
XP_002697218.1,4937119,5011035,-1,23,Bos_taurus,GFRAL,GDNF family receptor alpha-like,73916
NP_001179606.1,5043871,5175679,-1,23,Bos_taurus,HCRTR2,orexin receptor type 2,131808
NP_001192724.1,5382147,5456386,-1,23,Bos_taurus,FAM83B,protein FAM83B,74239
NP_001030279.1,5954017,6059880,-1,23,Bos_taurus,TINAG,tubulointerstitial nephritis antigen,105863
NP_001192398.1,6530426,6666336,-1,23,Bos_taurus,LRRC1,leucine-rich repeat-containing protein 1,135910
NP_001095425.1,6783411,6784602,1,23,Bos_taurus,KLHL31,kelch-like protein 31,1191
NP_001077143.1,6922379,6965163,1,23,Bos_taurus,GCLC,glutamate--cysteine ligase catalytic subunit,42784
NP_001077254.1,6975319,6990901,1,23,Bos_taurus,DSB,MHC class II antigen DS beta,15582
NP_001012696.1,7011969,7016704,1,23,Bos_taurus,BOLA-DYA,"major histocompatibility complex, class II, DY alpha precursor",4735
NP_001012697.1,7037656,7045301,-1,23,Bos_taurus,BOLA-DYB,"major histocompatibility complex, class II, DY beta precursor",7645
NP_001013618.1,7054418,7063641,-1,23,Bos_taurus,BOLA-DOB,"HLA class II histocompatibility antigen, DO beta chain precursor",9223
NP_776647.1,7079942,7086289,-1,23,Bos_taurus,TAP2,antigen peptide transporter 2,6347
NP_001040087.1,7102159,7108985,-1,23,Bos_taurus,LOC618733,"transporter 2, ATP-binding cassette, sub-family B",6826
NP_001035570.1,7113530,7116653,-1,23,Bos_taurus,PSMB8,proteasome subunit beta type-8,3123
NP_001091527.1,7118280,7126521,-1,23,Bos_taurus,TAP1,antigen peptide transporter 1,8241
NP_001029560.1,7127111,7133556,1,23,Bos_taurus,PSMB9,proteasome subunit beta type-9 precursor,6445
NP_001108326.1,7150820,7151201,1,23,Bos_taurus,H2B,histone H2B type 2-E,381
NP_001035571.1,7187385,7193432,-1,23,Bos_taurus,BOLA-DMB,"major histocompatibility complex, class II, DM beta precursor",6047
NP_001012692.2,7204349,7207030,1,23,Bos_taurus,BOLA-DMA,"HLA class II histocompatibility antigen, DM alpha chain precursor",2681
NP_001192849.1,7218988,7264202,-1,23,Bos_taurus,BOLA-DOA,"HLA class II histocompatibility antigen, DO alpha chain precursor",45214
NP_001039331.1,7240059,7247225,1,23,Bos_taurus,BRD2,bromodomain-containing protein 2,7166
NP_001039664.1,7290454,7318840,-1,23,Bos_taurus,COL11A2,collagen alpha-2(XI) chain precursor,28386
NP_001077109.1,7321253,7326765,-1,23,Bos_taurus,RXRB,retinoic acid receptor RXR-beta,5512
NP_001069705.2,7327540,7331098,1,23,Bos_taurus,SLC39A7,zinc transporter SLC39A7 precursor,3558
NP_001039789.1,7331904,7333829,1,23,Bos_taurus,HSD17B8,estradiol 17-beta-dehydrogenase 8,1925
NP_001098521.1,7338398,7341191,1,23,Bos_taurus,RING1,E3 ubiquitin-protein ligase RING1,2793
NP_001179989.1,7371501,7388338,-1,23,Bos_taurus,VPS52,vacuolar protein sorting-associated protein 52 homolog,16837
NP_001028786.1,7388745,7393324,1,23,Bos_taurus,RPS18,40S ribosomal protein S18,4579
NP_001070565.1,7394421,7395558,1,23,Bos_taurus,B3GALT4,"beta-1,3-galactosyltransferase 4 precursor",1137
NP_001015564.1,7396283,7405420,-1,23,Bos_taurus,WDR46,WD repeat-containing protein 46,9137
NP_001068889.1,7406076,7407024,1,23,Bos_taurus,PFDN6,prefoldin subunit 6,948
NP_001068622.1,7408357,7414640,-1,23,Bos_taurus,RGL2,ral guanine nucleotide dissociation stimulator-like 2,6283
NP_001039350.1,7416811,7425484,-1,23,Bos_taurus,TAPBP,tapasin precursor,8673
XP_005223345.1,7426486,7428391,-1,23,Bos_taurus,ZBTB22,zinc finger and BTB domain-containing protein 22,1905
NP_001068623.1,7430007,7433175,-1,23,Bos_taurus,DAXX,death domain-associated protein 6,3168
NP_001095406.1,7512905,7527481,1,23,Bos_taurus,KIFC1,kinesin-like protein KIFC1,14576
NP_001092384.2,7529643,7533769,1,23,Bos_taurus,PHF1,PHD finger protein 1,4126
NP_001068847.1,7534316,7535286,-1,23,Bos_taurus,CUTA,protein CutA precursor,970
NP_001192395.1,7537951,7566234,1,23,Bos_taurus,SYNGAP1,ras/Rap GTPase-activating protein SynGAP,28283
NP_001178391.1,7569199,7570585,1,23,Bos_taurus,ZBTB9,zinc finger and BTB domain-containing protein 9,1386
NP_001071386.1,7655891,7658885,-1,23,Bos_taurus,BAK1,bcl-2 homologous antagonist/killer,2994
NP_001092463.1,7662116,7666998,1,23,Bos_taurus,LOC516410,gametogenetin-binding protein 1,4882
XP_015315241.1,7675174,7679416,1,23,Bos_taurus,LOC100847319,uncharacterized protein LOC100847319,4242
NP_776795.1,7687273,7756518,1,23,Bos_taurus,ITPR3,"inositol 1,4,5-trisphosphate receptor type 3",69245
NP_001193543.1,7758195,7783928,-1,23,Bos_taurus,MNF1,uncharacterized protein C6orf125 homolog,25733
NP_001035632.2,7797291,7810505,-1,23,Bos_taurus,IP6K3,ubiquinol-cytochrome-c reductase complex assembly factor 2,13214
NP_001179408.1,7843194,7858338,-1,23,Bos_taurus,LEMD2,LEM domain-containing protein 2,15144
NP_776363.1,7865269,7870112,-1,23,Bos_taurus,MLN,promotilin precursor,4843
XP_003587709.1,8085749,8188237,-1,23,Bos_taurus,GRM4,LOW QUALITY PROTEIN: metabotropic glutamate receptor 4,102488
NP_001069991.1,8263647,8267618,1,23,Bos_taurus,HMGA1,high mobility group protein HMG-I/HMG-Y,3971
NP_001103917.1,8269435,8270377,-1,23,Bos_taurus,LOC100126544,uncharacterized protein LOC100126544,942
NP_001075935.1,8299345,8414435,-1,23,Bos_taurus,NUDT3,diphosphoinositol polyphosphate phosphohydrolase 1,115090
NP_001029888.1,8434615,8440388,-1,23,Bos_taurus,RPS10,40S ribosomal protein S10,5773
NP_001094571.1,8525929,8531878,1,23,Bos_taurus,PACSIN1,protein kinase C and casein kinase substrate in neurons protein 1,5949
NP_001075047.1,8537857,8544735,-1,23,Bos_taurus,SPDEF,SAM pointed domain-containing Ets transcription factor,6878
NP_001069939.1,8592159,8688735,-1,23,Bos_taurus,C23H6orf106,uncharacterized protein C6orf106 homolog,96576
NP_001069802.1,8726741,8737181,-1,23,Bos_taurus,SNRPC,U1 small nuclear ribonucleoprotein C,10440
NP_001029448.1,8829704,8836752,-1,23,Bos_taurus,TAF11,transcription initiation factor TFIID subunit 11,7048
NP_001103549.1,9023111,9051908,-1,23,Bos_taurus,TCP11,T-complex protein 11 homolog,28797
XP_002697245.2,9196405,9201776,1,23,Bos_taurus,LOC107131220,zinc finger protein 76-like,5371
XP_003587718.4,9225816,9235277,1,23,Bos_taurus,ZNF76,zinc finger protein 76,9461
NP_001092464.1,9237803,9263491,1,23,Bos_taurus,DEF6,differentially expressed in FDCP 6 homolog,25688
NP_001077105.1,9340997,9353750,1,23,Bos_taurus,PPARD,peroxisome proliferator-activated receptor delta,12753
NP_001179278.1,9381625,9390135,1,23,Bos_taurus,FANCE,Fanconi anemia group E protein,8510
NP_001015647.1,9391550,9393982,1,23,Bos_taurus,RPL10A,60S ribosomal protein L10a,2432
NP_001193657.1,9422867,9437261,-1,23,Bos_taurus,TULP1,tubby-related protein 1,14394
NP_001179791.1,9523457,9593213,-1,23,Bos_taurus,FKBP5,peptidyl-prolyl cis-trans isomerase FKBP5,69756
XP_002697259.1,9711821,9714190,1,23,Bos_taurus,CLPSL2,colipase-like protein 2,2369
NP_001071435.1,9723924,9726190,-1,23,Bos_taurus,CLPS,colipase precursor,2266
XP_015315260.1,9732875,9733271,-1,23,Bos_taurus,LOC107131713,splicing factor 3A subunit 2-like,396
NP_001192875.1,9733330,9742158,1,23,Bos_taurus,LHFPL5,tetraspan membrane protein of hair cell stereocilia,8828
XP_002697249.2,9753394,9824588,-1,23,Bos_taurus,SRPK1,LOW QUALITY PROTEIN: SRSF protein kinase 1,71194
NP_001095600.1,9853525,9935037,-1,23,Bos_taurus,SLC26A8,testis anion transporter 1,81512
NP_001095644.1,9945204,10020848,1,23,Bos_taurus,MAPK14,mitogen-activated protein kinase 14,75644
NP_001014947.1,10036740,10044800,1,23,Bos_taurus,MAPK13,mitogen-activated protein kinase 13,8060
NP_001192556.1,10099946,10130192,1,23,Bos_taurus,BRPF3,bromodomain and PHD finger-containing protein 3,30246
NP_001092670.1,10167496,10222306,1,23,Bos_taurus,PNPLA1,patatin-like phospholipase domain-containing protein 1,54810
XP_015315266.1,10319263,10338707,-1,23,Bos_taurus,PXT1,peroxisomal testis-specific protein 1,19444
NP_001094563.1,10376706,10388224,1,23,Bos_taurus,KCTD20,BTB/POZ domain-containing protein KCTD20,11518
NP_001075071.1,10397543,10431778,-1,23,Bos_taurus,STK38,serine/threonine-protein kinase 38,34235
NP_001029872.1,10483016,10487325,1,23,Bos_taurus,SRSF3,serine/arginine-rich splicing factor 3,4309
NP_001075891.1,10528535,10529327,-1,23,Bos_taurus,RPS4Y1,40S ribosomal protein S4,792
NP_001092428.1,10565064,10567022,1,23,Bos_taurus,CDKN1A,cyclin-dependent kinase inhibitor 1,1958
XP_003587720.1,10627252,10628281,1,23,Bos_taurus,LOC520334,galanin receptor type 3-like,1029
NP_001192568.1,10632881,10734548,-1,23,Bos_taurus,CPNE5,copine-5,101667
NP_001014869.1,10749915,10769294,-1,23,Bos_taurus,PPIL1,peptidyl-prolyl cis-trans isomerase-like 1,19379
XP_005223417.1,10785266,10808457,1,23,Bos_taurus,C23H6orf89,bombesin receptor-activated protein C6orf89 homolog,23191
NP_001019658.1,10836849,10847835,1,23,Bos_taurus,PI16,peptidase inhibitor 16 precursor,10986
NP_001096775.1,10854951,10873743,-1,23,Bos_taurus,MTCH1,mitochondrial carrier homolog 1,18792
NP_001069038.1,10892239,10917998,1,23,Bos_taurus,FGD2,"FYVE, RhoGEF and PH domain-containing protein 2",25759
NP_776569.1,11051838,11055416,-1,23,Bos_taurus,PIM1,serine/threonine-protein kinase pim-1,3578
NP_001073096.1,11109986,11110565,-1,23,Bos_taurus,TMEM217,transmembrane protein 217,579
NP_001092618.1,11133141,11205614,1,23,Bos_taurus,TBC1D22B,TBC1 domain family member 22B,72473
NP_001039681.1,11229849,11266714,1,23,Bos_taurus,RNF8,E3 ubiquitin-protein ligase RNF8,36865
NP_001075899.1,11305605,11355819,1,23,Bos_taurus,CMTR1,cap-specific mRNA (nucleoside-2'-O-)-methyltransferase 1,50214
NP_001073705.1,11358397,11373667,-1,23,Bos_taurus,CCDC167,coiled-coil domain-containing protein 167,15270
NP_001179811.1,11531142,11594184,-1,23,Bos_taurus,MDGA1,MAM domain-containing glycosylphosphatidylinositol anchor protein 1 precursor,63042
NP_001095615.1,11712948,12038930,1,23,Bos_taurus,ZFAND3,AN1-type zinc finger protein 3,325982
NP_001121970.1,12047050,12066121,-1,23,Bos_taurus,BTBD9,BTB/POZ domain-containing protein 9,19071
NP_001076965.1,12484841,12509188,-1,23,Bos_taurus,GLO1,lactoylglutathione lyase,24347
XP_015315271.1,12550366,12883810,1,23,Bos_taurus,DNAH8,"dynein heavy chain 8, axonemal",333444
XP_015315270.1,12913567,12940627,1,23,Bos_taurus,GLP1R,glucagon-like peptide 1 receptor,27060
NP_001033314.1,12964618,12970995,-1,23,Bos_taurus,SAYSD1,SAYSvFN domain-containing protein 1,6377
NP_001178073.1,13057052,13095305,-1,23,Bos_taurus,KCNK5,potassium channel subfamily K member 5,38253
NP_776983.1,13160630,13172855,-1,23,Bos_taurus,KCNK17,potassium channel subfamily K member 17,12225
XP_003587722.1,13175050,13181345,-1,23,Bos_taurus,KCNK16,potassium channel subfamily K member 16,6295
XP_015315273.1,13191045,13212289,-1,23,Bos_taurus,LOC104968668,kinesin-like protein KIF6,21244
XP_015315272.1,13483734,13613272,-1,23,Bos_taurus,LOC100139627,kinesin-like protein KIF6,129538
XP_015315274.1,13821468,13831009,-1,23,Bos_taurus,LOC107131718,uncharacterized protein LOC107131718,9541
NP_001159769.1,13833190,13866914,-1,23,Bos_taurus,MOCS1,molybdenum cofactor biosynthesis protein 1 isoform a,33724
NP_001179524.1,14309127,14351087,-1,23,Bos_taurus,LRFN2,leucine-rich repeat and fibronectin type-III domain-containing protein 2 precursor,41960
XP_005223572.1,14959071,14965828,-1,23,Bos_taurus,UNC5CL,UNC5C-like protein,6757
XP_015315306.1,14974417,14975436,1,23,Bos_taurus,TSPO2,translocator protein 2,1019
NP_001029527.1,14985546,14994946,1,23,Bos_taurus,APOBEC2,probable C->U-editing enzyme APOBEC-2,9400
NP_001070581.1,15000774,15005102,-1,23,Bos_taurus,OARD1,O-acetyl-ADP-ribose deacetylase 1,4328
NP_001014956.1,15013685,15029907,1,23,Bos_taurus,NFYA,nuclear transcription factor Y subunit alpha,16222
NP_001073048.1,15090366,15094707,-1,23,Bos_taurus,TREM2,triggering receptor expressed on myeloid cells 2 precursor,4341
NP_996853.1,15148526,15163157,-1,23,Bos_taurus,TREM1,triggering receptor expressed on myeloid cells 1 precursor,14631
NP_001192453.1,15391989,15423646,1,23,Bos_taurus,FOXP4,forkhead box protein P4,31657
NP_001192466.1,15467449,15482104,1,23,Bos_taurus,MDFI,myoD family inhibitor,14655
NP_001192595.1,15507709,15514007,-1,23,Bos_taurus,TFEB,transcription factor EB,6298
NP_001192720.1,15544731,15568677,-1,23,Bos_taurus,PGC,gastricsin precursor,23946
NP_001092388.1,15592630,15598158,-1,23,Bos_taurus,FRS3,fibroblast growth factor receptor substrate 3,5528
NP_001107190.1,15609410,15610160,1,23,Bos_taurus,TOMM6,mitochondrial import receptor subunit TOM6 homolog,750
NP_001096763.1,15687640,15696662,-1,23,Bos_taurus,MED20,mediator of RNA polymerase II transcription subunit 20,9022
NP_001014924.1,15697194,15705885,1,23,Bos_taurus,BYSL,bystin,8691
NP_001029881.1,15708570,15714284,-1,23,Bos_taurus,CCND3,G1/S-specific cyclin-D3,5714
NP_001094670.1,15803563,15820671,1,23,Bos_taurus,TAF8,transcription initiation factor TFIID subunit 8,17108
XP_015315308.1,15841663,15874544,-1,23,Bos_taurus,C23H6orf132,LOW QUALITY PROTEIN: uncharacterized protein C6orf132 homolog,32881
NP_001070551.1,15887225,15893213,1,23,Bos_taurus,MGC137036,uncharacterized protein LOC768024,5988
NP_776971.1,15901354,15908049,1,23,Bos_taurus,GUCA1A,guanylyl cyclase-activating protein 1,6695
NP_777211.1,15910681,15920974,-1,23,Bos_taurus,GUCA1B,guanylyl cyclase-activating protein 2,10293
NP_001030391.1,15930317,15941557,-1,23,Bos_taurus,MRPS10,"28S ribosomal protein S10, mitochondrial",11240
NP_001179567.1,16264296,16369924,1,23,Bos_taurus,UBR2,E3 ubiquitin-protein ligase UBR2,105628
NP_001159959.1,16376477,16390351,-1,23,Bos_taurus,PRPH2,peripherin-2,13874
NP_001069177.1,16406537,16407575,-1,23,Bos_taurus,TBCC,tubulin-specific chaperone C,1038
NP_001192709.1,16478579,16509798,1,23,Bos_taurus,GLTSCR1L,GLTSCR1-like protein,31219
NP_001193230.1,16520011,16524508,1,23,Bos_taurus,RPL7L1,60S ribosomal protein L7-like 1,4497
XP_002697289.1,16541218,16541560,-1,23,Bos_taurus,C23H6orf226,uncharacterized protein C6orf226 homolog,342
NP_001069101.1,16554188,16559231,1,23,Bos_taurus,PTCRA,pre T-cell antigen receptor alpha precursor,5043
NP_001068907.1,16562967,16571110,1,23,Bos_taurus,CNPY3,protein canopy homolog 3 precursor,8143
NP_001193045.1,16579608,16582852,1,23,Bos_taurus,GNMT,glycine N-methyltransferase,3244
NP_001179876.1,16583614,16597347,-1,23,Bos_taurus,PEX6,peroxisome biogenesis factor 6,13733
NP_001193287.1,16602270,16624415,1,23,Bos_taurus,PPP2R5D,serine/threonine-protein phosphatase 2A 56 kDa regulatory subunit delta isoform,22145
NP_777073.1,16625595,16626515,-1,23,Bos_taurus,MEA1,male-enhanced antigen 1,920
NP_001014966.1,16629725,16633148,1,23,Bos_taurus,KLHDC3,kelch domain-containing protein 3,3423
NP_001098949.1,16634042,16637619,1,23,Bos_taurus,RRP36,ribosomal RNA processing protein 36 homolog,3577
XP_005223608.1,16640985,16654717,-1,23,Bos_taurus,CUL7,cullin-7,13732
NP_001035617.2,16656329,16660414,-1,23,Bos_taurus,MRPL2,"39S ribosomal protein L2, mitochondrial",4085
NP_001179894.1,16677998,16739973,1,23,Bos_taurus,PTK7,inactive tyrosine-protein kinase 7 precursor,61975
NP_001192945.1,16747957,16754379,1,23,Bos_taurus,SRF,serum response factor,6422
XP_010816567.1,16795449,16797797,-1,23,Bos_taurus,DNPH1,LOW QUALITY PROTEIN: 2'-deoxynucleoside 5'-phosphate N-hydrolase 1,2348
NP_001094517.1,16865903,16871554,1,23,Bos_taurus,SLC22A7,solute carrier family 22 member 7,5651
NP_001179618.1,16872591,16875110,-1,23,Bos_taurus,CRIP3,cysteine-rich protein 3,2519
NP_001076963.1,16981991,16985997,-1,23,Bos_taurus,DLK2,protein delta homolog 2 precursor,4006
NP_001179348.1,17018937,17024703,1,23,Bos_taurus,TJAP1,tight junction-associated protein 1,5766
NP_001069687.1,17031400,17035246,-1,23,Bos_taurus,YIPF3,protein YIPF3,3846
NP_001033213.1,17035558,17042137,1,23,Bos_taurus,POLR1C,DNA-directed RNA polymerases I and III subunit RPAC1,6579
XP_002697347.2,17044425,17085615,-1,23,Bos_taurus,XPO5,exportin-5,41190
NP_001029622.1,17092571,17115947,1,23,Bos_taurus,POLH,DNA polymerase eta,23376
NP_001076890.1,17119814,17126853,-1,23,Bos_taurus,GTPBP2,GTP-binding protein 2,7039
NP_001069849.1,17131608,17135248,1,23,Bos_taurus,MAD2L1BP,MAD2L1-binding protein,3640
NP_001039732.1,17138234,17151388,1,23,Bos_taurus,RSPH9,radial spoke head protein 9 homolog,13154
NP_001094699.1,17152109,17168144,-1,23,Bos_taurus,MRPS18A,"28S ribosomal protein S18a, mitochondrial precursor",16035
XP_005223613.3,17257442,17260947,-1,23,Bos_taurus,LOC107131286,vascular endothelial growth factor A-like,3505
NP_001303885.1,17260415,17269399,1,23,Bos_taurus,VEGFA,vascular endothelial growth factor A isoform 4 precursor,8984
XP_010816570.1,17512651,17513651,1,23,Bos_taurus,C23H6orf223,LOW QUALITY PROTEIN: uncharacterized protein C6orf223 homolog,1000
XP_015315310.1,17585592,17597948,-1,23,Bos_taurus,TCTE1,T-complex-associated testis-expressed protein 1,12356
NP_001178140.1,17609852,17676785,-1,23,Bos_taurus,AARS2,"alanine--tRNA ligase, mitochondrial",66933
NP_001157411.1,17663878,17797642,1,23,Bos_taurus,TMEM63B,CSC1-like protein 2,133764
XP_015315311.1,17807544,17820030,1,23,Bos_taurus,CAPN11,calpain-11,12486
NP_001029570.2,17846050,17855653,1,23,Bos_taurus,SLC29A1,equilibrative nucleoside transporter 1,9603
NP_001073105.1,17868994,17873174,1,23,Bos_taurus,HSP90AB1,heat shock protein HSP 90-beta,4180
NP_001070433.1,17875755,17878469,-1,23,Bos_taurus,SLC35B2,adenosine 3'-phospho 5'-phosphosulfate transporter 1 precursor,2714
NP_001124218.1,17880438,17886997,-1,23,Bos_taurus,NFKBIE,NF-kappa-B inhibitor epsilon,6559
NP_001192792.1,17891618,17895776,1,23,Bos_taurus,TMEM151B,transmembrane protein 151B,4158
NP_001098478.1,18223259,18611124,-1,23,Bos_taurus,SUPT3H,transcription initiation protein SPT3 homolog,387865
NP_776701.1,19167448,19333118,-1,23,Bos_taurus,CLIC5,chloride intracellular channel protein 5,165670
NP_001075004.1,19375919,19380975,1,23,Bos_taurus,ENPP4,bis(5'-adenosyl)-triphosphatase ENPP4 precursor,5056
NP_001193653.1,19388632,19395174,-1,23,Bos_taurus,ENPP5,ectonucleotide pyrophosphatase/phosphodiesterase family member 5 precursor,6542
NP_001015632.2,19437662,19537357,-1,23,Bos_taurus,RCAN2,calcipressin-2 isoform 2,99695
NP_001092408.1,19777772,19860182,-1,23,Bos_taurus,CYP39A1,24-hydroxycholesterol 7-alpha-hydroxylase,82410
NP_001193123.1,19860794,19882600,1,23,Bos_taurus,SLC25A27,mitochondrial uncoupling protein 4,21806
NP_001179259.1,19892714,19903575,1,23,Bos_taurus,TDRD6,tudor domain-containing protein 6,10861
NP_777003.2,19907187,19928621,-1,23,Bos_taurus,PLA2G7,platelet-activating factor acetylhydrolase precursor,21434
XP_002697314.1,19956588,19965986,1,23,Bos_taurus,ANKRD66,ankyrin repeat domain-containing protein 66,9398
XP_010816580.1,20014169,20040232,1,23,Bos_taurus,MEP1A,LOW QUALITY PROTEIN: meprin A subunit alpha,26063
NP_001180172.1,20053545,20110595,-1,23,Bos_taurus,ADGRF5,probable G-protein coupled receptor 116,57050
NP_001179256.1,20206492,20236403,-1,23,Bos_taurus,ADGRF1,probable G-protein coupled receptor 110,29911
XP_002697352.4,20383917,20384229,1,23,Bos_taurus,LOC100296156,peptidyl-prolyl cis-trans isomerase A,312
NP_001070379.1,20412019,20474574,-1,23,Bos_taurus,TNFRSF21,tumor necrosis factor receptor superfamily member 21,62555
NP_001193468.1,20597063,20680179,1,23,Bos_taurus,CD2AP,CD2-associated protein,83116
NP_001178191.1,20708928,20731119,1,23,Bos_taurus,ADGRF2,probable G-protein coupled receptor 111 precursor,22191
NP_001137347.1,20745535,20758331,1,23,Bos_taurus,ADGRF4,probable G-protein coupled receptor 115 precursor,12796
NP_001193009.1,20801931,20834318,1,23,Bos_taurus,OPN5,opsin-5,32387
XP_015315313.1,20893700,20895233,-1,23,Bos_taurus,LOC107131722,patched domain-containing protein 4,1533
NP_001095613.1,21090639,21091248,-1,23,Bos_taurus,PTCHD4,patched domain-containing protein 4,609
NP_776364.2,21938807,21972915,-1,23,Bos_taurus,MUT,"methylmalonyl-CoA mutase, mitochondrial precursor",34108
NP_001071533.1,21985013,21997135,1,23,Bos_taurus,CENPQ,centromere protein Q,12122
NP_001138533.1,22011841,22024395,1,23,Bos_taurus,GLYATL3,glycine N-acyltransferase-like protein 3,12554
NP_001139125.1,22040538,22041105,1,23,Bos_taurus,C23H6orf141,uncharacterized protein C6orf141 homolog,567
NP_776596.1,22088890,22109630,-1,23,Bos_taurus,RHAG,ammonium transporter Rh type A,20740
NP_001033178.1,22131367,22146648,-1,23,Bos_taurus,CRISP2,cysteine-rich secretory protein 2 precursor,15281
NP_001073103.1,22164420,22178460,-1,23,Bos_taurus,CRISP3,cysteine-rich secretory protein 3 precursor,14040
NP_001116507.1,22221076,22222330,-1,23,Bos_taurus,PGK2,phosphoglycerate kinase 2,1254
NP_001193188.1,22245232,22261583,-1,23,Bos_taurus,CRISP1,cysteine-rich secretory protein 1 precursor,16351
XP_002697354.1,22369893,22374864,-1,23,Bos_taurus,DEFB110,beta-defensin 110,4971
XP_015315314.1,22381952,22423235,-1,23,Bos_taurus,DEFB112,beta-defensin 112,41283
NP_001179258.1,22998427,23057489,1,23,Bos_taurus,TFAP2D,transcription factor AP-2-delta,59062
NP_001069715.1,23097807,23122686,1,23,Bos_taurus,TFAP2B,transcription factor AP-2-beta,24879
XP_002697357.2,23795771,24250799,-1,23,Bos_taurus,PKHD1,fibrocystin,455028
NP_001008412.1,24347044,24350010,1,23,Bos_taurus,IL17A,interleukin-17A precursor,2966
NP_001179011.1,24391184,24397891,-1,23,Bos_taurus,IL17F,interleukin-17F precursor,6707
NP_001013604.2,24439485,24456276,-1,23,Bos_taurus,MCM3,DNA replication licensing factor MCM3,16791
XP_015315334.1,24547395,24547635,1,23,Bos_taurus,LOC107131728,translation machinery-associated protein 7,240
NP_001094605.1,24567893,24568958,1,23,Bos_taurus,PAQR8,membrane progestin receptor beta,1065
NP_001179173.1,24588128,24627606,1,23,Bos_taurus,EFHC1,EF-hand domain-containing protein 1,39478
NP_001180079.1,24638149,24702830,-1,23,Bos_taurus,TRAM2,translocating chain-associated membrane protein 2,64681
NP_001029551.1,24807975,24813528,1,23,Bos_taurus,TMEM14A,transmembrane protein 14A,5553
NP_803481.1,24823887,24831484,-1,23,Bos_taurus,GSTA2,glutathione S-transferase A2,7597
NP_001071617.1,24875680,24883511,-1,23,Bos_taurus,GSTA3,glutathione S-transferase A1,7831
NP_001092486.1,24895015,24909300,-1,23,Bos_taurus,GSTA5,glutathione S-transferase A5,14285
NP_001070580.1,24935716,24948163,-1,23,Bos_taurus,GSTA3,glutathione S-transferase A4,12447
NP_001015651.1,24963701,24976300,-1,23,Bos_taurus,GSTA4,glutathione S-transferase A4,12599
NP_001092357.1,24984469,25012392,-1,23,Bos_taurus,ICK,serine/threonine-protein kinase ICK,27923
NP_001029584.1,25030689,25051289,1,23,Bos_taurus,FBXO9,F-box only protein 9,20600
NP_001179034.1,25067220,25084501,-1,23,Bos_taurus,GCM1,chorion-specific transcription factor GCMa,17281
NP_001040062.1,25157473,25186845,-1,23,Bos_taurus,ELOVL5,elongation of very long chain fatty acids protein 5,29372
XP_015315336.1,25351285,25356908,-1,23,Bos_taurus,BOLA-DQA2,"major histocompatibility complex, class II, DQ alpha 2",5623
NP_001012694.2,25375347,25388103,1,23,Bos_taurus,BOLA-DQB,"major histocompatibility complex, class II, DQ beta precursor",12756
NP_001012693.2,25405112,25411578,-1,23,Bos_taurus,BOLA-DQA5,"major histocompatibility complex, class II, DQ alpha 5 precursor",6466
XP_003587740.1,25426572,25430097,-1,23,Bos_taurus,LOC100848815,"LOW QUALITY PROTEIN: SLA class II histocompatibility antigen, DQ haplotype D alpha chain-like",3525
XP_015330756.1,25472160,25476537,1,23,Bos_taurus,BOLA-DRB3,"major histocompatibility complex, class II, DRB3",4377
NP_001013619.3,25489989,25490245,-1,23,Bos_taurus,BOLA-DQA1,"major histocompatibility complex, class II, DQ alpha, type 1 precursor",256
XP_010816599.2,25539596,25557851,1,23,Bos_taurus,BOLA-DRB2,"LOW QUALITY PROTEIN: DLA class II histocompatibility antigen, DR-1 beta chain",18255
XP_015315343.1,25574617,25586120,1,23,Bos_taurus,LOC101902890,"H-2 class II histocompatibility antigen, E-S beta chain-like",11503
NP_001012695.1,25588639,25592144,-1,23,Bos_taurus,BOLA-DRA,"major histocompatibility complex, class II, DR alpha precursor",3505
NP_001095821.1,25618595,25631944,1,23,Bos_taurus,BTNL2,butyrophilin-like protein 2,13349
NP_001075192.1,25634966,25642597,-1,23,Bos_taurus,LOC525599,butyrophilin family member precursor,7631
NP_001029379.1,25649539,25656197,1,23,Bos_taurus,LOC504295,butyrophilin-like protein 1 precursor,6658
NP_001029840.2,25855492,25862994,-1,23,Bos_taurus,BLA-DQB,"boLa class II histocompatibility antigen, DQB*0101 beta chain precursor",7502
XP_015315347.1,26226530,26269588,1,23,Bos_taurus,LOC104972343,CAP-Gly domain-containing linker protein 1-like,43058
XP_015315348.1,26404304,26412906,1,23,Bos_taurus,LOC107131729,butyrophilin subfamily 1 member A1-like,8602
XP_015315385.1,26726613,26795033,1,23,Bos_taurus,C23H6orf10,uncharacterized protein C6orf10 homolog,68420
XP_002697389.3,26932836,26938393,1,23,Bos_taurus,LOC786065,butyrophilin-like protein 1,5557
NP_001193877.1,26973190,26998620,1,23,Bos_taurus,NOTCH4,neurogenic locus notch homolog protein 4 precursor,25430
NP_001243812.1,27003268,27006729,1,23,Bos_taurus,PBX2,pre-B-cell leukemia transcription factor 2,3461
NP_776407.1,27008849,27011781,1,23,Bos_taurus,AGER,advanced glycosylation end product-specific receptor precursor,2932
NP_001098915.1,27012545,27014357,-1,23,Bos_taurus,RNF5,E3 ubiquitin-protein ligase RNF5,1812
NP_803484.1,27021362,27023483,1,23,Bos_taurus,AGPAT1,1-acyl-sn-glycerol-3-phosphate acyltransferase alpha precursor,2121
NP_001092657.1,27024789,27026621,-1,23,Bos_taurus,EGFL8,epidermal growth factor-like protein 8 precursor,1832
NP_001030395.2,27028828,27035444,-1,23,Bos_taurus,PPT2,lysosomal thioesterase PPT2 precursor,6616
NP_001070415.1,27038297,27040649,1,23,Bos_taurus,PRRT1,proline-rich transmembrane protein 1,2352
NP_001095452.1,27056298,27057274,1,23,Bos_taurus,FKBPL,FK506-binding protein-like,976
NP_001077152.1,27057896,27067313,1,23,Bos_taurus,ATF6B,cyclic AMP-dependent transcription factor ATF-6 beta,9417
XP_005223750.1,27076266,27079933,1,23,Bos_taurus,LOC107131209,complement C4-like,3667
XP_015315387.1,27083668,27084155,1,23,Bos_taurus,LOC107131730,steroid 21-hydroxylase-like,487
NP_777128.1,27085606,27140674,-1,23,Bos_taurus,TNXB,tenascin-X precursor,55068
XP_015315388.1,27152124,27162956,1,23,Bos_taurus,LOC781663,LOW QUALITY PROTEIN: complement C4-A-like,10832
NP_001013614.1,27169511,27172439,-1,23,Bos_taurus,CYP21,steroid 21-hydroxylase,2928
NP_001091466.1,27199777,27206513,-1,23,Bos_taurus,STK19,serine/threonine-protein kinase 19,6736
NP_001014872.2,27207267,27209706,1,23,Bos_taurus,DXO,decapping and exoribonuclease protein,2439
XP_003587743.1,27209206,27219157,-1,23,Bos_taurus,LOC100139548,helicase SKI2W,9951
NP_001069672.1,27219882,27225046,1,23,Bos_taurus,NELFE,negative elongation factor E,5164
NP_001035616.1,27225317,27231182,-1,23,Bos_taurus,CFB,complement factor B precursor,5865
NP_001029664.1,27232001,27243331,-1,23,Bos_taurus,C2,complement C2 precursor,11330
XP_005223753.1,27274033,27275413,1,23,Bos_taurus,ZBTB12,zinc finger and BTB domain-containing protein 12,1380
NP_001193192.1,27277595,27291159,1,23,Bos_taurus,EHMT2,histone-lysine N-methyltransferase EHMT2,13564
NP_001076911.1,27291972,27305226,1,23,Bos_taurus,SLC44A4,choline transporter-like protein 4,13254
NP_001077111.1,27305749,27309102,1,23,Bos_taurus,NEU1,sialidase-1 precursor,3353
NP_976067.2,27331772,27333698,-1,23,Bos_taurus,HSPA1A,heat shock 70 kDa protein 1B,1926
NP_001161367.1,27336058,27337984,1,23,Bos_taurus,HSPA1L,heat shock 70 kDa protein 1-like,1926
NP_001094647.1,27339721,27344137,1,23,Bos_taurus,LSM2,U6 snRNA-associated Sm-like protein LSm2,4416
NP_001068674.1,27356280,27364477,-1,23,Bos_taurus,VWA7,von Willebrand factor A domain-containing protein 7 precursor,8197
XP_002697393.2,27365290,27373768,-1,23,Bos_taurus,VARS,valine--tRNA ligase,8478
NP_001075936.1,27374662,27375211,-1,23,Bos_taurus,SAPCD1,suppressor APC domain-containing protein 1,549
NP_001192428.1,27376010,27389175,-1,23,Bos_taurus,MSH5,mutS protein homolog 5,13165
NP_001015608.1,27393514,27398704,1,23,Bos_taurus,CLIC1,chloride intracellular channel protein 1,5190
NP_001029876.1,27400387,27402628,1,23,Bos_taurus,DDAH2,"N(G),N(G)-dimethylarginine dimethylaminohydrolase 2",2241
NP_001071549.1,27404677,27406348,-1,23,Bos_taurus,C23H6orf25,protein G6b precursor,1671
NP_001071324.1,27407664,27409835,1,23,Bos_taurus,LY6G6C,lymphocyte antigen 6 complex locus protein G6c precursor,2171
XP_003587745.1,27411104,27412890,-1,23,Bos_taurus,LY6G6D,lymphocyte antigen 6 complex locus protein G6d,1786
NP_001074989.1,27414664,27415981,1,23,Bos_taurus,LY6G6E,"lymphocyte antigen 6 complex, locus G6E precursor",1317
NP_001069662.1,27417917,27420583,-1,23,Bos_taurus,LY6G6F,lymphocyte antigen 6 complex locus protein G6f precursor,2666
NP_001069073.1,27423467,27435476,1,23,Bos_taurus,ABHD16A,abhydrolase domain-containing protein 16A,12009
XP_010816698.1,27440559,27442830,1,23,Bos_taurus,LY6G5C,lymphocyte antigen 6 complex locus protein G5c,2271
NP_001179131.1,27445629,27446642,-1,23,Bos_taurus,LY6G5B,lymphocyte antigen 6 complex locus protein G5b precursor,1013
NP_001039919.1,27447650,27450752,-1,23,Bos_taurus,CSNK2B,casein kinase II subunit beta,3102
NP_001069936.1,27453294,27454932,1,23,Bos_taurus,GPANK1,G patch domain and ankyrin repeat-containing protein 1,1638
NP_001094737.1,27457507,27458401,1,23,Bos_taurus,C23H6orf47,uncharacterized protein C6orf47 homolog,894
NP_001029429.2,27459385,27461297,-1,23,Bos_taurus,APOM,apolipoprotein M precursor,1912
NP_001068834.2,27464366,27474569,1,23,Bos_taurus,BAG6,large proline-rich protein BAG6,10203
NP_001192486.1,27475780,27488714,-1,23,Bos_taurus,PRRC2A,protein PRRC2A,12934
NP_776410.1,27503302,27505358,-1,23,Bos_taurus,AIF1,allograft inflammatory factor 1,2056
NP_001035614.1,27521487,27523736,1,23,Bos_taurus,NCR3,natural cytotoxicity triggering receptor 3 precursor,2249
NP_776391.2,27534701,27536481,-1,23,Bos_taurus,TNF,tumor necrosis factor,1780
NP_001013419.1,27538543,27539457,-1,23,Bos_taurus,LTA,lymphotoxin-alpha precursor,914
NP_001015597.1,27550805,27560565,-1,23,Bos_taurus,NFKBIL1,NF-kappa-B inhibitor-like protein 1,9760
NP_001069132.1,27561650,27562821,1,23,Bos_taurus,ATP6V1G2,V-type proton ATPase subunit G 2,1171
NP_001028801.1,27567309,27576518,1,23,Bos_taurus,DDX39B,spliceosome RNA helicase DDX39B,9209
XP_002697394.1,27576912,27578064,-1,23,Bos_taurus,MCCD1,mitochondrial coiled-coil domain protein 1,1152
XP_010816685.2,27600072,27602201,1,23,Bos_taurus,MGC126945,LOW QUALITY PROTEIN: uncharacterized protein LOC767904,2129
NP_001108327.1,27647098,27651987,1,23,Bos_taurus,BoLA,"major histocompatibility complex, class I, A precursor",4889
NP_001120789.1,27659408,27729696,-1,23,Bos_taurus,MIC1,major histocompatibility class I related protein precursor,70288
XP_015315396.1,27689389,27691564,1,23,Bos_taurus,BOLA,"BOLA class I histocompatibility antigen, alpha chain BL3-6",2175
XP_015315397.1,27715004,27718274,1,23,Bos_taurus,LOC788634,"LOW QUALITY PROTEIN: BOLA class I histocompatibility antigen, alpha chain BL3-7-like",3270
NP_777005.1,27769892,27774392,1,23,Bos_taurus,POU5F1,"POU domain, class 5, transcription factor 1",4500
NP_001077153.1,27776232,27778556,-1,23,Bos_taurus,TCF19,transcription factor 19,2324
NP_001019707.1,27780957,27791106,1,23,Bos_taurus,CCHCR1,coiled-coil alpha-helical rod protein 1,10149
NP_001073843.1,27793301,27794338,1,23,Bos_taurus,PSORS1C2,psoriasis susceptibility 1 candidate gene 2 protein precursor,1037
NP_001071418.1,27808500,27812246,1,23,Bos_taurus,CDSN,corneodesmosin precursor,3746
NP_001193388.1,27842301,27845887,1,23,Bos_taurus,LOC616942,"major histocompatibility complex, class I, A-like precursor",3586
XP_002697398.4,27908223,27912268,-1,23,Bos_taurus,MUC21,mucin-21,4045
XP_005223770.1,27927623,27936148,-1,23,Bos_taurus,DPCR1,diffuse panbronchiolitis critical region protein 1,8525
NP_001107995.1,27945614,27946212,1,23,Bos_taurus,SFTA2,surfactant-associated protein 2 precursor,598
NP_001243473.1,27949848,27961390,-1,23,Bos_taurus,VARS2,"valine--tRNA ligase, mitochondrial",11542
NP_001094527.1,27962286,27967930,-1,23,Bos_taurus,GTF2H4,general transcription factor IIH subunit 4,5644
NP_001069480.2,27976470,27986825,-1,23,Bos_taurus,DDR1,epithelial discoidin domain-containing receptor 1 precursor,10355
XP_015315398.1,27991050,27994058,-1,23,Bos_taurus,LOC107131732,uncharacterized protein LOC107131732,3008
NP_001068670.1,28088485,28089056,1,23,Bos_taurus,IER3,radiation-inducible immediate-early gene IEX-1,571
NP_001070355.1,28090672,28099794,1,23,Bos_taurus,FLOT1,flotillin-1,9122
NP_001040014.1,28101901,28105152,-1,23,Bos_taurus,TUBB,tubulin beta-5 chain,3251
NP_001032685.1,28112227,28114509,-1,23,Bos_taurus,NRM,nurim,2282
XP_002697401.2,28117863,28128504,-1,23,Bos_taurus,MDC1,mediator of DNA damage checkpoint protein 1,10641
NP_001070387.1,28128502,28136174,1,23,Bos_taurus,PPP1R18,phostensin,7672
NP_001193139.1,28140392,28152392,1,23,Bos_taurus,DHX16,putative pre-mRNA-splicing factor ATP-dependent RNA helicase DHX16,12000
NP_001033267.1,28152846,28156283,-1,23,Bos_taurus,C23H6orf136,uncharacterized protein C6orf136 homolog,3437
NP_001263252.1,28156840,28169399,-1,23,Bos_taurus,ATAT1,alpha-tubulin N-acetyltransferase 1,12559
NP_001033613.1,28170189,28176461,-1,23,Bos_taurus,MRPS18B,"28S ribosomal protein S18b, mitochondrial",6272
NP_001137335.1,28183953,28192535,1,23,Bos_taurus,PPP1R10,serine/threonine-protein phosphatase 1 regulatory subunit 10,8582
NP_001193838.1,28199128,28211313,-1,23,Bos_taurus,ABCF1,ATP-binding cassette sub-family F member 1,12185
NP_001029726.1,28219794,28223657,-1,23,Bos_taurus,PRR3,proline-rich protein 3,3863
NP_001096742.1,28224817,28231252,1,23,Bos_taurus,GNL1,guanine nucleotide-binding protein-like 1,6435
XP_003587749.2,28262694,28271496,-1,23,Bos_taurus,LOC615278,E3 ubiquitin-protein ligase TRIM39,8802
NP_001070309.1,28299512,28307097,1,23,Bos_taurus,LOC512672,"major histocompatibility complex, class I precursor",7585
NP_001099086.1,28355357,28358325,-1,23,Bos_taurus,BOLA-NC1,non-classical MHC class I antigen precursor,2968
NP_001035588.1,28470055,28473371,-1,23,Bos_taurus,JSP.1,MHC Class I JSP.1 precursor,3316
NP_001033607.1,28502825,28506291,-1,23,Bos_taurus,BOLA,MHC class I heavy chain isoform 1 precursor,3466
XP_002697385.1,28570977,28579480,1,23,Bos_taurus,LOC785873,tripartite motif-containing protein 26,8503
NP_001192693.1,28600574,28610886,-1,23,Bos_taurus,TRIM15,tripartite motif-containing protein 15,10312
NP_001015607.1,28614283,28622043,1,23,Bos_taurus,TRIM10,tripartite motif-containing protein 10,7760
NP_001096776.1,28626338,28638013,-1,23,Bos_taurus,TRIM40,tripartite motif-containing protein 40,11675
XP_003587753.4,28702051,28706222,1,23,Bos_taurus,RNF39,RING finger protein 39,4171
NP_001093765.1,28708301,28710184,-1,23,Bos_taurus,PPP1R11,protein phosphatase 1 regulatory subunit 11,1883
NP_001039865.1,28714663,28717599,-1,23,Bos_taurus,ZNRD1,DNA-directed RNA polymerase I subunit RPA12,2936
NP_001013602.1,28740641,28750890,-1,23,Bos_taurus,MOG,myelin-oligodendrocyte glycoprotein precursor,10249
NP_001156747.1,28775568,28802663,1,23,Bos_taurus,GABBR1,gamma-aminobutyric acid type B receptor subunit 1 isoform 1 precursor,27095
XP_002697423.1,28873685,28875436,-1,23,Bos_taurus,LOC504548,ubiquitin D,1751
XP_010816709.1,28889173,28890127,-1,23,Bos_taurus,LOC506486,olfactory receptor 2H1,954
XP_010816708.1,28902964,28903903,-1,23,Bos_taurus,OR2H1,olfactory receptor 2H1,939
NP_001193402.1,28918458,28920198,1,23,Bos_taurus,UBD,ubiquitin D,1740
XP_015315412.1,28921913,28925097,-1,23,Bos_taurus,LOC107131305,putative olfactory receptor 2I1,3184
XP_002697445.1,28950028,28950967,-1,23,Bos_taurus,OR10C1,olfactory receptor 10C1,939
XP_002697446.1,28955605,28956565,-1,23,Bos_taurus,LOC523768,olfactory receptor 6Q1,960
XP_002697447.2,28967923,28968892,1,23,Bos_taurus,LOC523769,olfactory receptor 11A1,969
XP_015315402.1,28984363,28985380,1,23,Bos_taurus,LOC523389,olfactory receptor 11A1,1017
XP_002697449.2,28992087,28993017,-1,23,Bos_taurus,LOC786846,olfactory receptor 1361,930
XP_002697450.1,29004624,29005551,-1,23,Bos_taurus,LOC785910,olfactory receptor 12D2,927
XP_002697427.1,29032405,29033332,-1,23,Bos_taurus,LOC785811,olfactory receptor 12D2,927
XP_002697454.1,29038752,29039682,-1,23,Bos_taurus,LOC785779,olfactory receptor 1361,930
XP_002707943.2,29061839,29062766,-1,23,Bos_taurus,LOC789690,olfactory receptor 12D2,927
XP_003587759.2,29071804,29072758,-1,23,Bos_taurus,LOC616306,olfactory receptor 12D2-like,954
XP_015315405.1,29078909,29079824,-1,23,Bos_taurus,LOC785712,olfactory receptor 12D2,915
XP_002697432.1,29092561,29093488,-1,23,Bos_taurus,LOC785639,olfactory receptor 12D2,927
NP_001091852.1,29107825,29108752,-1,23,Bos_taurus,OR12D2,"olfactory receptor, family 12, subfamily D, member 2",927
XP_003587755.2,29122353,29123280,-1,23,Bos_taurus,LOC785582,olfactory receptor 12D2-like,927
XP_002697457.1,29143550,29144498,1,23,Bos_taurus,LOC514434,olfactory receptor 5V1,948
XP_002697434.1,29149973,29150924,1,23,Bos_taurus,OR12D3,olfactory receptor 12D3,951
XP_002697458.2,29157653,29158610,1,23,Bos_taurus,LOC512579,olfactory receptor 12D3,957
XP_002697459.2,29167548,29168487,1,23,Bos_taurus,LOC618034,olfactory receptor 12D3,939
XP_002697435.1,29176695,29177619,1,23,Bos_taurus,LOC785431,olfactory receptor 5V1,924
XP_002697436.1,29186919,29187873,1,23,Bos_taurus,OR5V1,olfactory receptor 5V1,954
XP_002697437.2,29206926,29207889,-1,23,Bos_taurus,OR14J1,olfactory receptor 14J1,963
XP_005223773.1,29212490,29213456,-1,23,Bos_taurus,LOC510530,olfactory receptor 14J1,966
XP_002697438.1,29223811,29224756,-1,23,Bos_taurus,LOC618052,olfactory receptor 2B2,945
XP_002697461.3,29241748,29242690,-1,23,Bos_taurus,LOC785277,olfactory receptor 2G3,942
XP_015315403.1,29268470,29269403,1,23,Bos_taurus,LOC107131736,olfactory receptor 2G3-like,933
XP_002697463.4,29280760,29281705,1,23,Bos_taurus,LOC618064,LOW QUALITY PROTEIN: olfactory receptor 2G3,945
XP_002697464.2,29290562,29291507,1,23,Bos_taurus,LOC785162,LOW QUALITY PROTEIN: olfactory receptor 2G3,945
XP_010816714.1,29299941,29300874,1,23,Bos_taurus,LOC516273,olfactory receptor 2G6-like,933
XP_002697466.1,29314809,29315760,1,23,Bos_taurus,LOC516274,olfactory receptor 2G3,951
XP_002697467.1,29327102,29328065,-1,23,Bos_taurus,LOC618070,putative olfactory receptor 2B8,963
XP_002697468.1,29349631,29350570,1,23,Bos_taurus,LOC782341,olfactory receptor 2W1,939
XP_002697469.1,29360767,29361715,1,23,Bos_taurus,LOC782301,olfactory receptor 2W1,948
XP_002697471.1,29387308,29388250,1,23,Bos_taurus,LOC515704,putative olfactory receptor 2B3,942
XP_015315404.1,29394474,29395409,1,23,Bos_taurus,LOC782379,LOW QUALITY PROTEIN: olfactory receptor 2W1-like,935
XP_002697440.1,29403152,29403978,1,23,Bos_taurus,LOC785479,non-histone chromosomal protein HMG-14,826
XP_002697474.2,29411405,29412041,-1,23,Bos_taurus,LOC509155,protein FAM177A1,636
XP_010816717.1,29412971,29414889,-1,23,Bos_taurus,LOC784614,LOW QUALITY PROTEIN: olfactory receptor 2H2-like,1918
XP_002697484.1,29451996,29452938,1,23,Bos_taurus,LOC784652,putative olfactory receptor 2B3,942
XP_002697485.1,29462781,29463723,1,23,Bos_taurus,LOC784681,olfactory receptor 2B11,942
XP_002697486.1,29480529,29481468,1,23,Bos_taurus,LOC528343,olfactory receptor 2B6,939
XP_002697487.1,29503334,29504264,-1,23,Bos_taurus,OR2J3,olfactory receptor 2J3,930
XP_015315413.1,29518648,29519287,1,23,Bos_taurus,LOC784787,olfactory receptor 10C1,639
XP_010816718.1,29540766,29541693,-1,23,Bos_taurus,LOC511103,olfactory receptor 2J3,927
XP_002697490.1,29552974,29553937,1,23,Bos_taurus,LOC784858,olfactory receptor 10C1,963
XP_002697477.1,29572203,29573142,1,23,Bos_taurus,LOC616517,olfactory receptor 2B11,939
XP_002697478.3,29581501,29582479,1,23,Bos_taurus,LOC789367,olfactory receptor 10C1,978
XP_015315414.1,29593367,29594294,-1,23,Bos_taurus,LOC789358,olfactory receptor 2J3,927
XP_003587760.1,29622275,29623226,1,23,Bos_taurus,LOC788675,olfactory receptor 10C1-like,951
XP_010816722.1,29632637,29633571,1,23,Bos_taurus,LOC788663,LOW QUALITY PROTEIN: olfactory receptor 2B11-like,934
XP_010816720.1,29661569,29662598,-1,23,Bos_taurus,OR2J2,olfactory receptor 2J3,1029
XP_010816721.1,29678972,29679926,1,23,Bos_taurus,LOC509280,olfactory receptor 2W1,954
XP_002697483.1,29698015,29698978,1,23,Bos_taurus,OR2W1,olfactory receptor 2W1,963
XP_010816738.1,29764538,29765510,1,23,Bos_taurus,LOC782475,putative olfactory receptor 2W6,972
XP_002697522.1,29784663,29785587,1,23,Bos_taurus,LOC782554,putative olfactory receptor 2W6,924
NP_001069267.1,29906705,29920283,1,23,Bos_taurus,TRIM27,zinc finger protein RFP,13578
NP_001070606.1,30080783,30090123,1,23,Bos_taurus,ZSCAN12,zinc finger and SCAN domain-containing protein 12,9340
NP_001039702.1,30121195,30123823,1,23,Bos_taurus,ZSCAN31,zinc finger and SCAN domain-containing protein 31,2628
NP_001069642.1,30154311,30154773,-1,23,Bos_taurus,PGBD1,piggyBac transposable element-derived protein 1,462
NP_001095427.1,30161122,30166332,-1,23,Bos_taurus,ZSCAN26,zinc finger and SCAN domain-containing protein 26,5210
NP_001095968.1,30178136,30178959,-1,23,Bos_taurus,NKAPL,NKAP-like protein,823
XP_002697494.2,30186450,30193866,-1,23,Bos_taurus,ZKSCAN4,zinc finger protein with KRAB and SCAN domains 4,7416
XP_015315428.1,30206788,30211745,-1,23,Bos_taurus,ZSCAN9,LOW QUALITY PROTEIN: zinc finger and SCAN domain-containing protein 9,4957
XP_015315425.1,30237436,30241949,-1,23,Bos_taurus,LOC104975673,LOW QUALITY PROTEIN: pre-mRNA-splicing regulator WTAP,4513
NP_001138603.1,30265551,30266367,-1,23,Bos_taurus,ZNF389,zinc finger protein 389,816
NP_001093814.1,30279018,30287143,-1,23,Bos_taurus,ZKSCAN8,zinc finger protein with KRAB and SCAN domains 8,8125
NP_001029583.1,30305198,30311510,-1,23,Bos_taurus,ZSCAN16,zinc finger and SCAN domain-containing protein 16,6312
NP_001178305.1,30332604,30336576,-1,23,Bos_taurus,ZNF165,zinc finger protein 165,3972
XP_002697531.3,30349198,30350140,-1,23,Bos_taurus,LOC528914,olfactory receptor 1F12,942
XP_003587763.1,30464776,30465715,1,23,Bos_taurus,LOC100849008,putative olfactory receptor 2B8,939
XP_005223788.1,30474842,30475787,-1,23,Bos_taurus,LOC101904987,olfactory receptor 2G6-like,945
XP_002697537.1,30487471,30488416,-1,23,Bos_taurus,LOC619021,olfactory receptor 2G6,945
XP_002697539.1,30528180,30529125,-1,23,Bos_taurus,LOC783311,olfactory receptor 2G6,945
XP_002697540.1,30585742,30586705,-1,23,Bos_taurus,LOC783203,olfactory receptor 2B2,963
XP_002697541.2,30607389,30608346,1,23,Bos_taurus,LOC528373,putative olfactory receptor 2W6,957
XP_010816746.1,30620726,30621668,1,23,Bos_taurus,OR2B6,olfactory receptor 2B6,942
XP_015315429.1,30685947,30693562,-1,23,Bos_taurus,LOC783041,LOW QUALITY PROTEIN: putative olfactory receptor 2W6,7615
XP_010816747.1,30695955,30696900,1,23,Bos_taurus,LOC783002,olfactory receptor 2B2,945
XP_015315427.1,30713381,30713762,-1,23,Bos_taurus,HIST1H2BI,histone H2B type 1,381
XP_010816763.1,30714063,30714456,1,23,Bos_taurus,LOC104968446,histone H2A type 1,393
XP_002697506.1,30715879,30716290,1,23,Bos_taurus,HIST1H3C,histone H3.1,411
XP_010816762.1,30724825,30748119,1,23,Bos_taurus,LOC528329,uncharacterized protein LOC528329,23294
XP_005223785.1,30730259,30730652,-1,23,Bos_taurus,LOC529277,histone H2A type 1,393
XP_010816759.1,30730957,30731338,1,23,Bos_taurus,LOC104975676,histone H2B type 1,381
NP_001075211.1,30741267,30741648,-1,23,Bos_taurus,HIST1H2BB,histone H2B type 1-N,381
XP_003587761.1,30741967,30742360,1,23,Bos_taurus,LOC614970,histone H2A type 1-D,393
XP_002697516.1,30757274,30757586,-1,23,Bos_taurus,LOC527645,histone H4,312
XP_010816754.1,30760428,30760809,-1,23,Bos_taurus,LOC616868,histone H2B type 1,381
NP_001092190.1,30761115,30761508,1,23,Bos_taurus,HIST1H2AG,"histone cluster 1, H2ag",393
XP_010816767.1,30764309,30764720,1,23,Bos_taurus,LOC616819,histone H3.1,411
XP_010816748.1,30766956,30767343,-1,23,Bos_taurus,HIST1H2AJ,histone H2A type 1-J,387
XP_010816749.1,30767649,30768030,1,23,Bos_taurus,LOC100295221,histone H2B type 1,381
NP_001093842.1,30960834,30979663,1,23,Bos_taurus,ZNF184,zinc finger protein 184,18829
NP_001093822.1,30995073,30996150,-1,23,Bos_taurus,ZNF391,zinc finger protein 391,1077
NP_001156399.1,31040856,31043949,1,23,Bos_taurus,POM121L2,POM121-like protein 2,3093
XP_010816800.1,31067237,31073523,-1,23,Bos_taurus,PRSS16,thymus-specific serine protease,6286
XP_010816805.1,31111940,31112327,-1,23,Bos_taurus,HIST1H2AH,histone H2A type 1-H,387
NP_001071531.1,31112650,31113031,1,23,Bos_taurus,HIST1H2BN,histone H2B type 1-K,381
XP_002697546.1,31121373,31121754,1,23,Bos_taurus,HIST1H2BJ,histone H2B type 1-J,381
NP_001091624.1,31214786,31215995,1,23,Bos_taurus,ZNF322,zinc finger protein 322,1209
XP_010816806.1,31235373,31236321,1,23,Bos_taurus,LOC515414,olfactory receptor 2M3,948
XP_010816807.1,31250288,31251215,1,23,Bos_taurus,LOC514235,olfactory receptor 2M2,927
XP_002697600.1,31260280,31261204,1,23,Bos_taurus,LOC521167,olfactory receptor 2M2,924
NP_001069620.1,31279671,31281319,-1,23,Bos_taurus,ABT1,activator of basal transcription 1,1648
NP_001040012.1,31324374,31324647,-1,23,Bos_taurus,HMGN4,high mobility group nucleosome-binding domain-containing protein 4,273
XP_015315455.1,31343550,31344106,-1,23,Bos_taurus,BTN1A1,butyrophilin subfamily 1 member A1,556
XP_015315451.1,31344921,31348078,1,23,Bos_taurus,LOC107131743,butyrophilin subfamily 2 member A2-like,3157
NP_776933.1,31362492,31366608,1,23,Bos_taurus,BTN1A1,butyrophilin subfamily 1 member A1 precursor,4116
XP_015315461.1,31379280,31390409,-1,23,Bos_taurus,BTN3A3,LOW QUALITY PROTEIN: butyrophilin subfamily 3 member A3,11129
XP_010816809.2,31456885,31479686,1,23,Bos_taurus,LOC527388,uncharacterized protein LOC527388,22801
XP_010816810.1,31460913,31461294,-1,23,Bos_taurus,HIST1H2BM,histone H2B type 2-F,381
XP_002697551.1,31461685,31462078,1,23,Bos_taurus,HIST1H2AM,histone H2A type 1,393
XP_015315463.1,31463931,31464342,1,23,Bos_taurus,LOC107131750,histone H3.1,411
XP_002697553.1,31472338,31472719,-1,23,Bos_taurus,LOC104968456,histone H2B type 1,381
XP_010816812.2,31485394,31503087,-1,23,Bos_taurus,LOC518961,LOW QUALITY PROTEIN: uncharacterized protein LOC518961,17693
NP_001094536.1,31490519,31491185,1,23,Bos_taurus,HIST1H1D,histone H1.3,666
XP_015315464.1,31518524,31518917,-1,23,Bos_taurus,HIST1H2AC,histone H2A type 1,393
NP_001099113.1,31519420,31519624,1,23,Bos_taurus,H2B,histone H2B,204
XP_002697561.1,31525878,31526259,-1,23,Bos_taurus,LOC505183,histone H2B type 1,381
XP_010816815.1,31526581,31526974,1,23,Bos_taurus,LOC104975683,histone H2A type 1,393
NP_001092459.1,31531156,31531789,-1,23,Bos_taurus,HIST1H1E,"histone cluster 1, H1e",633
NP_001093194.1,31534758,31535070,1,23,Bos_taurus,LOC617875,histone H4-like,312
XP_010816816.1,31539668,31540049,-1,23,Bos_taurus,LOC787465,histone H2B type 1,381
NP_001039711.1,31554875,31555256,-1,23,Bos_taurus,HIST1H2BD,histone H2B type 1-D,381
XP_002697564.1,31556332,31556992,-1,23,Bos_taurus,HIST1H1E,histone H1.4,660
NP_001192525.1,31588780,31589173,-1,23,Bos_taurus,HIST1H2AC,histone H2A type 1-C,393
XP_003587771.1,31589503,31589884,1,23,Bos_taurus,LOC787269,histone H2B type 1,381
XP_010816820.1,31604876,31605513,1,23,Bos_taurus,LOC104975686,LOW QUALITY PROTEIN: histone H1t,637
XP_010816819.2,31607478,31669974,-1,23,Bos_taurus,LOC617905,uncharacterized protein LOC617905,62496
NP_001012399.1,31614300,31621316,1,23,Bos_taurus,HFE,hereditary hemochromatosis protein precursor,7016
NP_001076894.1,31636946,31637588,1,23,Bos_taurus,HIST1H1C,histone H1.2,642
XP_002697571.1,31646216,31646597,1,23,Bos_taurus,HIST1H2BB,histone H2B type 1-B,381
XP_010816817.1,31652713,31653106,1,23,Bos_taurus,LOC104975684,histone H2A type 1,393
XP_005223855.1,31654043,31654454,1,23,Bos_taurus,HIST1H3G,histone H3.1,411
NP_776305.1,31665599,31665911,1,23,Bos_taurus,H4,histone H4,312
XP_002697575.1,31670730,31671141,-1,23,Bos_taurus,HIST1H3I,histone H3.1,411
XP_010816821.1,31674089,31674746,1,23,Bos_taurus,HIST1H1A,histone H1.1,657
NP_001029746.1,31693877,31706914,-1,23,Bos_taurus,TRIM38,E3 ubiquitin-protein ligase TRIM38,13037
NP_001033207.1,31727728,31738931,1,23,Bos_taurus,SLC17A2,sodium-dependent phosphate transport protein 3,11203
NP_001069255.1,31761096,31778340,1,23,Bos_taurus,SLC17A3,sodium-dependent phosphate transport protein 4,17244
XP_010816831.2,31792595,31830098,1,23,Bos_taurus,SLC17A1,sodium-dependent phosphate transport protein 1,37503
XP_010816823.1,31914983,31915367,1,23,Bos_taurus,HIST1H2BA,histone H2B type 1-A,384
XP_015315477.1,31918124,31918676,-1,23,Bos_taurus,HIST1H2BA,histone H2B type 1-A,552
XP_015315478.1,31918730,31919276,1,23,Bos_taurus,HIST1H2AA,histone H2A type 1-A,546
NP_001092643.1,31952426,32004255,-1,23,Bos_taurus,SCGN,secretagogin,51829
NP_001179832.1,32030008,32339087,-1,23,Bos_taurus,LRRC16A,leucine-rich repeat-containing protein 16A,309079
NP_001030502.1,32713473,32763479,1,23,Bos_taurus,FAM65B,protein FAM65B,50006
XP_005223873.1,32769204,32772075,1,23,Bos_taurus,C23H6orf229,uncharacterized protein C6orf229 homolog,2871
NP_001020508.1,32775886,32784223,-1,23,Bos_taurus,GMNN,geminin,8337
NP_001071467.1,32823091,32833540,1,23,Bos_taurus,C23H6orf62,uncharacterized protein C6orf62 homolog,10449
NP_001095315.1,32836780,32848919,-1,23,Bos_taurus,ACOT13,acyl-coenzyme A thioesterase 13,12139
NP_001098811.1,32849365,32859925,1,23,Bos_taurus,TDP2,tyrosyl-DNA phosphodiesterase 2,10560
XP_002697584.1,32901067,32942266,1,23,Bos_taurus,KIAA0319,dyslexia-associated protein KIAA0319 homolog,41199
NP_001179664.1,32952153,32976657,-1,23,Bos_taurus,ALDH5A1,"succinate-semialdehyde dehydrogenase, mitochondrial",24504
NP_777241.1,32984494,33036019,1,23,Bos_taurus,GPLD1,phosphatidylinositol-glycan-specific phospholipase D precursor,51525
NP_001095373.1,33040800,33077125,-1,23,Bos_taurus,MRS2,"magnesium transporter MRS2 homolog, mitochondrial",36325
NP_001068937.1,33269564,33281467,-1,23,Bos_taurus,NRSN1,neurensin-1,11903
XP_003587783.2,34219297,34219825,-1,23,Bos_taurus,LOC788801,ferritin light chain,528
NP_997613.2,34357860,34368707,-1,23,Bos_taurus,PRP4,placental prolactin-related protein 4 precursor,10847
NP_001033289.1,34431221,34440564,-1,23,Bos_taurus,PRP8,uncharacterized protein LOC613971 precursor,9343
NP_991347.1,34479818,34491927,-1,23,Bos_taurus,PRP6,prolactin-related protein VI precursor,12109
NP_776584.1,34531553,34543417,-1,23,Bos_taurus,PRP1,placental prolactin-related protein 1 precursor,11864
XP_010816845.1,34576554,34588550,-1,23,Bos_taurus,LOC100298767,chorionic somatomammotropin hormone 2,11996
NP_001073846.2,34634194,34647033,-1,23,Bos_taurus,PRP2,placental prolactin-related protein 2 precursor,12839
XP_015315452.1,34667010,34678330,-1,23,Bos_taurus,LOC100336962,LOW QUALITY PROTEIN: chorionic somatomammotropin hormone 2-like,11320
NP_001091031.1,34693484,34705968,-1,23,Bos_taurus,PRP14,prolactin-related protein 14 precursor,12484
NP_001033221.1,34719463,34731112,-1,23,Bos_taurus,PRP9,uncharacterized protein LOC519859 precursor,11649
NP_001012286.1,34806750,34818831,-1,23,Bos_taurus,PRP-VII,prolactin-related protein VII precursor,12081
NP_776585.1,34861329,34866557,-1,23,Bos_taurus,PRP3,placental prolactin-related protein 3 precursor,5228
NP_851350.2,35059473,35072020,1,23,Bos_taurus,CSH2,chorionic somatomammotropin hormone 2 isoform 1,12547
NP_776378.2,35105283,35113696,-1,23,Bos_taurus,PRL,prolactin precursor,8413
NP_001001136.2,35438513,35439221,-1,23,Bos_taurus,HDGFL1,hepatoma-derived growth factor-like protein 1,708
XP_010816846.1,35789778,36174436,-1,23,Bos_taurus,LOC100847951,uncharacterized protein LOC100847951,384658
NP_001071596.1,36292361,36293944,-1,23,Bos_taurus,SOX4,transcription factor SOX-4,1583
NP_001179620.1,36602047,37210133,-1,23,Bos_taurus,CDKAL1,threonylcarbamoyladenosine tRNA methylthiotransferase,608086
NP_001179767.1,37262071,37343552,-1,23,Bos_taurus,E2F3,transcription factor E2F3,81481
NP_001179786.1,37498772,37608122,1,23,Bos_taurus,MBOAT1,lysophospholipid acyltransferase 1,109350
NP_001092498.1,38955598,39030849,-1,23,Bos_taurus,RNF144B,E3 ubiquitin-protein ligase RNF144B,75251
NP_001093187.1,39134122,39163796,1,23,Bos_taurus,DEK,protein DEK,29674
NP_001068999.1,39215601,39231827,1,23,Bos_taurus,TPMT,thiopurine S-methyltransferase,16226
XP_002697596.1,39239197,39240382,1,23,Bos_taurus,NHLRC1,E3 ubiquitin-protein ligase NHLRC1,1185
NP_001192683.1,39534811,39605312,1,23,Bos_taurus,NUP153,nuclear pore complex protein Nup153,70501
NP_001075187.1,39612050,39619566,-1,23,Bos_taurus,FAM8A1,protein FAM8A1,7516
NP_001092449.1,39646901,39758309,-1,23,Bos_taurus,CAP2,adenylyl cyclase-associated protein 2,111408
NP_001098455.1,39836076,39846177,-1,23,Bos_taurus,RBM24,RNA-binding protein 24,10101
XP_003587785.1,39906664,39927833,-1,23,Bos_taurus,STMND1,stathmin domain-containing protein 1,21169
NP_001020518.1,40610631,40610988,1,23,Bos_taurus,LOC574091,nucleoside-diphosphate kinase NBR-A,357
NP_001069445.1,40616625,40676937,-1,23,Bos_taurus,GMPR,GMP reductase 1,60312
NP_001095723.1,40771805,40789604,-1,23,Bos_taurus,MYLIP,E3 ubiquitin-protein ligase MYLIP,17799
NP_001039412.1,41076274,41165191,1,23,Bos_taurus,DTNBP1,dysbindin,88917
NP_001040055.1,42336229,42354809,-1,23,Bos_taurus,CD83,CD83 antigen precursor,18580
NP_001071406.1,42467106,42467856,-1,23,Bos_taurus,RNF182,E3 ubiquitin-protein ligase RNF182,750
NP_001095779.1,42547987,42567084,1,23,Bos_taurus,MCUR1,mitochondrial calcium uniporter regulator 1,19097
XP_010816870.2,42736665,42794220,1,23,Bos_taurus,RANBP9,ran-binding protein 9,57555
NP_001029556.1,42795874,42799980,-1,23,Bos_taurus,NOL7,nucleolar protein 7,4106
NP_001029467.1,42804422,42820539,-1,23,Bos_taurus,SIRT5,"NAD-dependent protein deacylase sirtuin-5, mitochondrial",16117
NP_001015643.1,43002796,43023933,1,23,Bos_taurus,TBC1D7,TBC1 domain family member 7,21137
NP_001179840.1,43054177,43249577,-1,23,Bos_taurus,PHACTR1,phosphatase and actin regulator 1,195400
XP_015315488.1,43504755,43647528,-1,23,Bos_taurus,LOC107131301,phosphatase and actin regulator 1-like,142773
NP_851353.1,44011560,44017131,-1,23,Bos_taurus,EDN1,endothelin-1 precursor,5571
XP_010816910.1,44139449,44268437,-1,23,Bos_taurus,HIVEP1,LOW QUALITY PROTEIN: zinc finger protein 40,128988
NP_001032710.1,44469120,44536106,1,23,Bos_taurus,ADTRP,androgen-dependent TFPI-regulating protein,66986
XP_002697637.2,44660174,44688019,-1,23,Bos_taurus,TMEM170B,transmembrane protein 170B,27845
NP_001095317.2,44955888,44986928,1,23,Bos_taurus,NEDD9,enhancer of filamentation 1,31040
NP_001129050.1,45024691,45041722,-1,23,Bos_taurus,SMIM13,small integral membrane protein 13,17031
NP_001076986.1,45093668,45111322,1,23,Bos_taurus,ELOVL2,elongation of very long chain fatty acids protein 2,17654
XP_002697663.3,45183078,45191309,1,23,Bos_taurus,GCM2,chorion-specific transcription factor GCMb,8231
NP_001039880.2,45215424,45258157,1,23,Bos_taurus,MAK,serine/threonine-protein kinase MAK,42733
NP_001030514.1,45266131,45271264,-1,23,Bos_taurus,TMEM14C,transmembrane protein 14C,5133
NP_001014852.1,45276647,45287337,-1,23,Bos_taurus,PAK1IP1,p21-activated protein kinase-interacting protein 1,10690
XP_005223944.1,45347953,45404713,-1,23,Bos_taurus,LOC100848875,"N-acetyllactosaminide beta-1,6-N-acetylglucosaminyl-transferase, isoform A-like",56760
NP_001073697.1,45480585,45497627,1,23,Bos_taurus,TFAP2A,transcription factor AP-2-alpha,17042
XP_015315497.1,45861270,45953579,1,23,Bos_taurus,OFCC1,uncharacterized protein OFCC1,92309
NP_001035689.1,47219521,47234197,1,23,Bos_taurus,EEF1E1,eukaryotic translation elongation factor 1 epsilon-1,14676
NP_001092345.1,47244999,47268188,1,23,Bos_taurus,BLOC1S5,biogenesis of lysosome-related organelles complex 1 subunit 5,23189
NP_001193661.1,47333405,47349788,-1,23,Bos_taurus,TXNDC5,thioredoxin domain-containing protein 5 precursor,16383
XP_002697643.1,47647916,47663909,-1,23,Bos_taurus,SNRNP48,U11/U12 small nuclear ribonucleoprotein 48 kDa protein,15993
NP_001179297.1,47671218,47714288,-1,23,Bos_taurus,DSP,desmoplakin,43070
XP_015315500.1,47807173,47846154,1,23,Bos_taurus,CAGE1,cancer-associated gene 1 protein,38981
NP_001095592.1,47853878,47869743,1,23,Bos_taurus,SSR1,translocon-associated protein subunit alpha precursor,15865
NP_001077230.1,48385735,48430517,-1,23,Bos_taurus,LY86,lymphocyte antigen 86 precursor,44782
NP_001161366.1,48635989,48775083,1,23,Bos_taurus,F13A1,coagulation factor XIII A chain,139094
NP_001039903.1,48868378,48876549,1,23,Bos_taurus,NRN1,neuritin precursor,8171
NP_001070273.1,48974819,49233786,-1,23,Bos_taurus,FARS2,"phenylalanine--tRNA ligase, mitochondrial",258967
NP_001069774.1,49283282,49373963,1,23,Bos_taurus,LYRM4,LYR motif-containing protein 4,90681
XP_010816926.1,49386707,49387742,-1,23,Bos_taurus,PPP1R3G,protein phosphatase 1 regulatory subunit 3G,1035
NP_001098872.1,49410733,49420147,1,23,Bos_taurus,RPP40,ribonuclease P protein subunit p40,9414
NP_001095693.1,49452872,49548143,-1,23,Bos_taurus,CDYL,chromodomain Y-like protein,95271
NP_001029414.2,49909572,49923551,1,23,Bos_taurus,ECI2,"enoyl-CoA delta isomerase 2, mitochondrial",13979
XP_015315489.1,49923711,49931181,-1,23,Bos_taurus,C23H6orf201,uncharacterized protein C6orf201 homolog,7470
XP_015315503.1,49939604,49947593,1,23,Bos_taurus,FAM217A,protein FAM217A,7989
NP_001069025.1,49954743,49977786,-1,23,Bos_taurus,PRPF4B,serine/threonine-protein kinase PRP4 homolog,23043
NP_001070400.1,50077730,50094900,1,23,Bos_taurus,PXDC1,PX domain-containing protein 1,17170
NP_001069809.1,50234200,50323372,1,23,Bos_taurus,SLC22A23,solute carrier family 22 member 23,89172
XP_002697651.1,50327519,50331670,-1,23,Bos_taurus,PSMG4,proteasome assembly chaperone 4,4151
NP_001003900.1,50354937,50357631,1,23,Bos_taurus,TUBB2B,tubulin beta-2B chain,2694
XP_010816931.1,50377724,50378817,1,23,Bos_taurus,LOC104969934,tubulin beta-4B chain-like,1093
NP_001039383.1,50395183,50417050,-1,23,Bos_taurus,BPHL,valacyclovir hydrolase,21867
NP_001030184.1,50421320,50446671,-1,23,Bos_taurus,RIPK1,receptor-interacting serine/threonine-protein kinase 1,25351
NP_001029495.1,50487524,50496961,-1,23,Bos_taurus,NQO2,ribosyldihydronicotinamide dehydrogenase [quinone],9437
XP_010816934.1,50573367,50581382,-1,23,Bos_taurus,LOC617396,serpin B6-like,8015
NP_777214.1,50609754,50617511,1,23,Bos_taurus,SERPINB6,serpin B6,7757
NP_001069327.1,50638189,50644250,1,23,Bos_taurus,SERPINB9,serpin B9,6061
NP_001193539.1,50673609,50678834,-1,23,Bos_taurus,SERPINB1,leukocyte elastase inhibitor,5225
NP_001096576.1,50703901,50742372,-1,23,Bos_taurus,WRNIP1,ATPase WRNIP1,38471
NP_001073800.1,51115435,51453348,1,23,Bos_taurus,GMDS,"GDP-mannose 4,6 dehydratase",337913
XP_015315491.1,51606432,51610902,1,23,Bos_taurus,LOC101905813,uncharacterized protein LOC101905813,4470
XP_010816950.1,51622496,51650353,1,23,Bos_taurus,LOC104969983,uncharacterized protein LOC104969983,27857
NP_001193088.1,51917536,52014590,1,23,Bos_taurus,EXOC2,exocyst complex component 2,97054
NP_001193091.1,52050984,52063652,-1,23,Bos_taurus,IRF4,interferon regulatory factor 4,12668
XP_010799069.1,52397482,52398420,-1,23,Bos_taurus,LOC613394,LOW QUALITY PROTEIN: olfactory receptor 1030-like,938
XP_010799071.2,52431757,52432741,1,23,Bos_taurus,LOC100138976,LOW QUALITY PROTEIN: olfactory receptor 5M11-like,984
XP_002683845.1,52444475,52445489,-1,23,Bos_taurus,OR5M10,olfactory receptor 5M10,1014
XP_010799072.2,52504147,52505054,-1,23,Bos_taurus,LOC101909723,LOW QUALITY PROTEIN: olfactory receptor 4P4-like,907
