acc,Unnamed: 0,start,end,strand,chromosome,species,symbol,name,length
NP_001273484.1,99928,292539,348951,1,6,Homo_sapiens,DUSP22,dual specificity protein phosphatase 22 isoform a,56412
XP_011513346.1,99929,364142,380671,-1,6,Homo_sapiens,LOC105375104,uncharacterized protein LOC105375104,16529
NP_002451.2,99930,393152,407598,1,6,Homo_sapiens,IRF4,interferon regulatory factor 4 isoform 1,14446
NP_060773.3,99931,486670,637818,-1,6,Homo_sapiens,EXOC2,exocyst complex component 2,151148
XP_011513331.1,99932,601142,602546,1,6,Homo_sapiens,LOC105374874,uncharacterized protein LOC105374874,1404
NP_683762.2,99933,656107,656944,-1,6,Homo_sapiens,HUS1B,checkpoint protein HUS1B,837
NP_150285.3,99934,1312704,1313916,1,6,Homo_sapiens,FOXQ1,forkhead box protein Q1,1212
NP_001443.1,99935,1389947,1394859,1,6,Homo_sapiens,FOXF2,forkhead box protein F2,4912
NP_001444.2,99936,1610445,1612107,1,6,Homo_sapiens,FOXC1,forkhead box protein C1,1662
NP_001240775.1,99937,1624168,2175943,-1,6,Homo_sapiens,GMDS,"GDP-mannose 4,6 dehydratase isoform 2",551775
NP_689767.2,99938,2623438,2623822,-1,6,Homo_sapiens,C6orf195,uncharacterized protein C6orf195,384
NP_001012418.2,99939,2671300,2749294,-1,6,Homo_sapiens,MYLK4,myosin light chain kinase family member 4,77994
NP_064520.2,99940,2765622,2785282,1,6,Homo_sapiens,WRNIP1,ATPase WRNIP1 isoform 1,19660
NP_109591.1,99941,2833607,2840586,-1,6,Homo_sapiens,SERPINB1,leukocyte elastase inhibitor,6979
NP_004146.1,99942,2890162,2900611,-1,6,Homo_sapiens,SERPINB9,serpin B9,10449
NP_004559.4,99943,2948297,2959332,-1,6,Homo_sapiens,SERPINB6,serpin B6 isoform a,11035
NP_000895.2,99944,3006552,3019655,1,6,Homo_sapiens,NQO2,ribosyldihydronicotinamide dehydrogenase [quinone] isoform 1,13103
NP_003795.2,99945,3076823,3113339,1,6,Homo_sapiens,RIPK1,receptor-interacting serine/threonine-protein kinase 1,36516
NP_004323.2,99946,3118740,3152575,1,6,Homo_sapiens,BPHL,valacyclovir hydrolase isoform 1 precursor,33835
NP_001060.1,99947,3153862,3157463,-1,6,Homo_sapiens,TUBB2A,tubulin beta-2A chain,3601
NP_821080.1,99948,3224750,3227543,-1,6,Homo_sapiens,TUBB2B,tubulin beta-2B chain,2793
NP_001129222.1,99949,3259022,3263824,1,6,Homo_sapiens,PSMG4,proteasome assembly chaperone 4 isoform c,4802
NP_068764.3,99950,3273054,3410257,-1,6,Homo_sapiens,SLC22A23,solute carrier family 22 member 23 isoform b,137203
NP_899229.2,99951,3723618,3751531,-1,6,Homo_sapiens,PXDC1,PX domain-containing protein 1,27913
NP_036267.1,99952,3849811,3850789,1,6,Homo_sapiens,FAM50B,protein FAM50B,978
NP_003904.3,99953,4021425,4060616,1,6,Homo_sapiens,PRPF4B,serine/threonine-protein kinase PRP4 homolog,39191
NP_775834.2,99954,4068695,4077414,-1,6,Homo_sapiens,FAM217A,protein FAM217A,8719
NP_001078870.1,99955,4087641,4130182,1,6,Homo_sapiens,C6orf201,uncharacterized protein C6orf201,42541
NP_001159482.1,99956,4115873,4133671,-1,6,Homo_sapiens,ECI2,"enoyl-CoA delta isomerase 2, mitochondrial isoform 1",17798
NP_004815.3,99957,4776783,4954056,1,6,Homo_sapiens,CDYL,chromodomain Y-like protein isoform a,177273
NP_001273061.1,99958,4995077,5004002,-1,6,Homo_sapiens,RPP40,ribonuclease P protein subunit p40 isoform b,8925
NP_001138587.1,99959,5085485,5086562,1,6,Homo_sapiens,PPP1R3G,protein phosphatase 1 regulatory subunit 3G,1077
NP_065141.3,99960,5109422,5260733,-1,6,Homo_sapiens,LYRM4,LYR motif-containing protein 4 isoform 1,151311
NP_006558.1,99961,5368570,5771429,1,6,Homo_sapiens,FARS2,"phenylalanine--tRNA ligase, mitochondrial precursor",402859
NP_001265640.1,99962,5998975,6003730,-1,6,Homo_sapiens,NRN1,neuritin isoform 2,4755
NP_000120.2,99963,6145618,6318664,-1,6,Homo_sapiens,F13A1,coagulation factor XIII A chain precursor,173046
NP_004262.1,99964,6588734,6654627,1,6,Homo_sapiens,LY86,lymphocyte antigen 86 precursor,65893
NP_001003699.1,99965,7181911,7248968,1,6,Homo_sapiens,RREB1,ras-responsive element-binding protein 1 isoform 1,67057
NP_001278937.1,99966,7289863,7313120,-1,6,Homo_sapiens,SSR1,translocon-associated protein subunit alpha isoform 2 precursor,23257
NP_995586.1,99967,7326857,7378895,-1,6,Homo_sapiens,CAGE1,cancer-associated gene 1 protein isoform 3,52038
NP_113668.2,99968,7390002,7417441,1,6,Homo_sapiens,RIOK1,serine/threonine-protein kinase RIO1 isoform 1,27439
NP_004406.2,99969,7541915,7585878,1,6,Homo_sapiens,DSP,desmoplakin isoform I,43963
NP_689764.3,99970,7590257,7608873,1,6,Homo_sapiens,SNRNP48,U11/U12 small nuclear ribonucleoprotein 48 kDa protein,18616
NP_001709.1,99971,7726955,7880343,1,6,Homo_sapiens,BMP6,bone morphogenetic protein 6 preproprotein,153388
NP_001139021.1,99972,7883143,7904662,-1,6,Homo_sapiens,TXNDC5,thioredoxin domain-containing protein 5 isoform 3,21519
XP_011513337.1,99973,7912543,7915712,1,6,Homo_sapiens,LOC105374908,uncharacterized protein LOC105374908,3169
NP_001186251.1,99974,8015648,8054272,-1,6,Homo_sapiens,BLOC1S5,biogenesis of lysosome-related organelles complex 1 subunit 5 isoform 2,38624
NP_001129122.1,99975,8073474,8102521,-1,6,Homo_sapiens,EEF1E1,eukaryotic translation elongation factor 1 epsilon-1 isoform 2,29047
NP_057032.2,99976,8413548,8434387,-1,6,Homo_sapiens,SLC35B3,adenosine 3'-phospho 5'-phosphosulfate transporter 2,20839
XP_011513347.1,99977,9702022,9809706,-1,6,Homo_sapiens,OFCC1,orofacial cleft 1 candidate gene 1 protein,107684
XP_011513338.1,99978,9896883,10159398,-1,6,Homo_sapiens,LOC105369145,orofacial cleft 1 candidate gene 1 protein,262515
NP_001027451.1,99979,10398416,10411596,-1,6,Homo_sapiens,TFAP2A,transcription factor AP-2-alpha isoform b,13180
NP_663624.1,99980,10528911,10626607,1,6,Homo_sapiens,GCNT2,"N-acetyllactosaminide beta-1,6-N-acetylglucosaminyl-transferase isoform A",97696
NP_001138492.1,99981,10671455,10687550,-1,6,Homo_sapiens,C6orf52,putative uncharacterized protein C6orf52,16095
NP_060376.2,99982,10694985,10709452,1,6,Homo_sapiens,PAK1IP1,p21-activated protein kinase-interacting protein 1,14467
NP_001158730.1,99983,10724613,10730666,1,6,Homo_sapiens,TMEM14C,transmembrane protein 14C,6053
NP_001273413.1,99984,10749201,10756518,1,6,Homo_sapiens,TMEM14B,transmembrane protein 14B isoform c,7317
NP_001229314.1,99985,10764451,10830648,-1,6,Homo_sapiens,MAK,serine/threonine-protein kinase MAK isoform 2,66197
NP_004743.1,99986,10873994,10881793,-1,6,Homo_sapiens,GCM2,chorion-specific transcription factor GCMb,7799
NP_001035364.2,99987,10887126,10963806,1,6,Homo_sapiens,SYCP2L,synaptonemal complex protein 2-like,76680
NP_060240.3,99988,10983780,11044230,-1,6,Homo_sapiens,ELOVL2,elongation of very long chain fatty acids protein 2,60450
NP_001129047.1,99989,11094313,11134602,1,6,Homo_sapiens,SMIM13,small integral membrane protein 13,40289
NP_997465.1,99990,11103693,11105310,-1,6,Homo_sapiens,ERVFRD-1,syncytin-2 preproprotein,1617
NP_001257962.1,99991,11185161,11232515,-1,6,Homo_sapiens,NEDD9,enhancer of filamentation 1 isoform 4,47354
NP_001094299.1,99992,11538277,11575561,1,6,Homo_sapiens,TMEM170B,transmembrane protein 170B,37284
NP_116133.1,99993,11714477,11778759,-1,6,Homo_sapiens,ADTRP,androgen-dependent TFPI-regulating protein isoform 2,64282
NP_002105.3,99994,12015628,12164461,1,6,Homo_sapiens,HIVEP1,zinc finger protein 40,148833
NP_001946.3,99995,12290629,12296067,1,6,Homo_sapiens,EDN1,endothelin-1 isoform 1 preproprotein,5438
NP_001229577.1,99996,12718744,13287078,1,6,Homo_sapiens,PHACTR1,phosphatase and actin regulator 1,568334
NP_001229627.1,99997,13280959,13295311,-1,6,Homo_sapiens,LOC100130357,uncharacterized protein LOC100130357,14352
NP_001137438.1,99998,13305100,13326898,-1,6,Homo_sapiens,TBC1D7,TBC1 domain family member 7 isoform b,21798
NP_001229557.1,99999,13364742,13365606,-1,6,Homo_sapiens,GFOD1,glucose-fructose oxidoreductase domain-containing protein 1 isoform 2,864
NP_001229558.1,100000,13470436,13486890,-1,6,Homo_sapiens,GFOD1,glucose-fructose oxidoreductase domain-containing protein 1 isoform 3 precursor,16454
NP_112534.1,100001,13584110,13604518,1,6,Homo_sapiens,SIRT5,"NAD-dependent protein deacylase sirtuin-5, mitochondrial isoform 2",20408
NP_057251.2,100002,13615358,13620827,1,6,Homo_sapiens,NOL7,nucleolar protein 7,5469
NP_005484.2,100003,13622361,13711505,-1,6,Homo_sapiens,RANBP9,ran-binding protein 9,89144
NP_001026883.1,100004,13790808,13814429,-1,6,Homo_sapiens,MCUR1,mitochondrial calcium uniporter regulator 1,23621
NP_689950.1,100005,13977119,13977863,1,6,Homo_sapiens,RNF182,E3 ubiquitin-protein ligase RNF182,744
NP_004224.1,100006,14117811,14135236,1,6,Homo_sapiens,CD83,CD83 antigen isoform a precursor,17425
NP_004964.2,100007,15246539,15520251,1,6,Homo_sapiens,JARID2,protein Jumonji isoform 1,273712
NP_001258596.1,100008,15522974,15627454,-1,6,Homo_sapiens,DTNBP1,dysbindin isoform C,104480
NP_037394.2,100009,16129322,16146751,1,6,Homo_sapiens,MYLIP,E3 ubiquitin-protein ligase MYLIP,17429
NP_006868.3,100010,16238693,16295186,1,6,Homo_sapiens,GMPR,GMP reductase 1,56493
NP_001121636.1,100011,16306328,16328310,-1,6,Homo_sapiens,ATXN1,ataxin-1,21982
NP_001177695.1,100012,17102257,17130881,1,6,Homo_sapiens,STMND1,stathmin domain-containing protein 1,28624
NP_001137414.1,100013,17281581,17292119,1,6,Homo_sapiens,RBM24,RNA-binding protein 24 isoform 1,10538
NP_006357.1,100014,17421555,17556442,1,6,Homo_sapiens,CAP2,adenylyl cyclase-associated protein 2,134887
NP_057339.1,100015,17600409,17608339,1,6,Homo_sapiens,FAM8A1,protein FAM8A1,7930
NP_001265139.1,100016,17616096,17706387,-1,6,Homo_sapiens,NUP153,nuclear pore complex protein Nup153 isoform 3,90291
NP_001099038.1,100017,17760856,17987463,-1,6,Homo_sapiens,KIF13A,kinesin-like protein KIF13A isoform d,226607
NP_940988.2,100018,18121418,18122606,-1,6,Homo_sapiens,NHLRC1,E3 ubiquitin-protein ligase NHLRC1,1188
NP_000358.1,100019,18130667,18149127,-1,6,Homo_sapiens,TPMT,thiopurine S-methyltransferase,18460
NP_694587.3,100020,18159895,18221992,1,6,Homo_sapiens,KDM1B,lysine-specific histone demethylase 1B,62097
NP_001128181.1,100021,18225718,18263987,-1,6,Homo_sapiens,DEK,protein DEK isoform 2,38269
NP_877434.2,100022,18399534,18465067,1,6,Homo_sapiens,RNF144B,E3 ubiquitin-protein ligase RNF144B,65533
NP_001537.1,100023,19837754,19838628,1,6,Homo_sapiens,ID4,DNA-binding protein inhibitor ID-4,874
NP_001073949.1,100024,20102285,20212234,-1,6,Homo_sapiens,MBOAT1,lysophospholipid acyltransferase 1,109949
XP_011513348.1,100025,20401554,20402772,-1,6,Homo_sapiens,LOC105375105,uncharacterized protein LOC105375105,1218
NP_001940.1,100026,20402232,20490430,1,6,Homo_sapiens,E2F3,transcription factor E2F3 isoform 1,88198
NP_060244.2,100027,20546350,21231039,1,6,Homo_sapiens,CDKAL1,threonylcarbamoyladenosine tRNA methylthiotransferase,684689
NP_003098.1,100028,21594534,21595959,1,6,Homo_sapiens,SOX4,transcription factor SOX-4,1425
NP_001157030.1,100029,22287401,22296982,-1,6,Homo_sapiens,PRL,prolactin precursor,9581
NP_612641.2,100030,22569575,22570331,1,6,Homo_sapiens,HDGFL1,hepatoma-derived growth factor-like protein 1,756
NP_542454.3,100031,24134327,24145946,1,6,Homo_sapiens,NRSN1,neurensin-1,11619
NP_057440.2,100032,24174729,24357750,-1,6,Homo_sapiens,DCDC2,doublecortin domain-containing protein 2,183021
NP_851854.1,100033,24357639,24357894,1,6,Homo_sapiens,KAAG1,kidney-associated antigen 1,255
NP_001273194.1,100034,24403046,24423056,1,6,Homo_sapiens,MRS2,"magnesium transporter MRS2 homolog, mitochondrial isoform c",20010
NP_001494.2,100035,24429031,24489511,-1,6,Homo_sapiens,GPLD1,phosphatidylinositol-glycan-specific phospholipase D precursor,60480
NP_733936.1,100036,24494996,24533712,1,6,Homo_sapiens,ALDH5A1,"succinate-semialdehyde dehydrogenase, mitochondrial isoform 1 precursor",38716
NP_001239257.1,100037,24547164,24576373,-1,6,Homo_sapiens,KIAA0319,dyslexia-associated protein KIAA0319 isoform e,29209
NP_057698.2,100038,24650787,24666862,-1,6,Homo_sapiens,TDP2,tyrosyl-DNA phosphodiesterase 2,16075
NP_060943.1,100039,24667263,24701615,1,6,Homo_sapiens,ACOT13,acyl-coenzyme A thioesterase 13 isoform 1,34352
NP_112201.1,100040,24706136,24718668,-1,6,Homo_sapiens,C6orf62,uncharacterized protein C6orf62,12532
NP_001238918.1,100041,24777246,24785799,1,6,Homo_sapiens,GMNN,geminin,8553
NP_001269421.1,100042,24797409,24798857,-1,6,Homo_sapiens,C6orf229,uncharacterized protein C6orf229,1448
NP_055537.2,100043,24806372,24875791,-1,6,Homo_sapiens,FAM65B,protein FAM65B isoform 1,69419
XP_011513349.1,100044,25273477,25279412,1,6,Homo_sapiens,LOC105375106,uncharacterized protein LOC105375106,5935
NP_060110.4,100045,25279795,25619583,1,6,Homo_sapiens,LRRC16A,leucine-rich repeat-containing protein 16A isoform 1,339788
NP_008929.2,100046,25652403,25701335,1,6,Homo_sapiens,SCGN,secretagogin,48932
NP_734466.1,100047,25726131,25726527,-1,6,Homo_sapiens,HIST1H2AA,histone H2A type 1-A,396
NP_733759.1,100048,25726908,25727292,1,6,Homo_sapiens,HIST1H2BA,histone H2B type 1-A,384
NP_005486.1,100049,25761962,25779188,1,6,Homo_sapiens,SLC17A4,probable small intestine urate exporter isoform a,17226
NP_005065.2,100050,25798784,25830557,-1,6,Homo_sapiens,SLC17A1,sodium-dependent phosphate transport protein 1,31773
NP_006623.2,100051,25845381,25868387,-1,6,Homo_sapiens,SLC17A3,sodium-dependent phosphate transport protein 4 isoform b,23006
NP_005826.1,100052,25913294,25925796,-1,6,Homo_sapiens,SLC17A2,sodium-dependent phosphate transport protein 3 isoform b,12502
NP_006346.1,100053,25966522,25983687,1,6,Homo_sapiens,TRIM38,E3 ubiquitin-protein ligase TRIM38,17165
NP_005316.1,100054,26017084,26017732,-1,6,Homo_sapiens,HIST1H1A,histone H1.1,648
NP_003520.1,100055,26020489,26020900,1,6,Homo_sapiens,HIST1H3A,histone H3.1,411
NP_003529.1,100056,26021678,26021990,1,6,Homo_sapiens,HIST1H4A,histone H4,312
NP_003535.1,100057,26026940,26027252,-1,6,Homo_sapiens,HIST1H4B,histone H4,312
NP_003528.1,100058,26031649,26032060,-1,6,Homo_sapiens,HIST1H3B,histone H3.1,411
NP_003504.2,100059,26033175,26033568,-1,6,Homo_sapiens,HIST1H2AB,histone H2A type 1-B/E,393
NP_066406.1,100060,26043276,26043657,-1,6,Homo_sapiens,HIST1H2BB,histone H2B type 1-B,381
NP_003522.1,100061,26045410,26045821,1,6,Homo_sapiens,HIST1H3C,histone H3.1,411
NP_005310.1,100062,26055786,26056428,-1,6,Homo_sapiens,HIST1H1C,histone H1.2,642
NP_000401.1,100063,26087440,26094226,1,6,Homo_sapiens,HFE,hereditary hemochromatosis protein isoform 1 precursor,6786
NP_003533.1,100064,26103947,26104259,1,6,Homo_sapiens,HIST1H4C,histone H4,312
NP_005314.2,100065,26107469,26108093,-1,6,Homo_sapiens,HIST1H1T,histone H1t,624
NP_003517.2,100066,26123523,26123904,-1,6,Homo_sapiens,HIST1H2BC,histone H2B type 1-C/E/F/G/I,381
NP_003503.1,100067,26124232,26124625,1,6,Homo_sapiens,HIST1H2AC,histone H2A type 1-C,393
NP_005312.1,100068,26156390,26157050,1,6,Homo_sapiens,HIST1H1E,histone H1.4,660
NP_066407.1,100069,26158169,26158550,1,6,Homo_sapiens,HIST1H2BD,histone H2B type 1-D,381
NP_003514.2,100070,26183795,26184176,1,6,Homo_sapiens,HIST1H2BE,histone H2B type 1-C/E/F/G/I,381
NP_003530.1,100071,26188764,26189076,-1,6,Homo_sapiens,HIST1H4D,histone H4,312
NP_003521.2,100072,26196839,26197250,-1,6,Homo_sapiens,HIST1H3D,histone H3.1,411
NP_066409.1,100073,26198850,26199243,-1,6,Homo_sapiens,HIST1H2AD,histone H2A type 1-D,393
NP_003513.1,100074,26199558,26199939,1,6,Homo_sapiens,HIST1H2BF,histone H2B type 1-C/E/F/G/I,381
NP_003536.1,100075,26204644,26204956,1,6,Homo_sapiens,HIST1H4E,histone H4,312
NP_003509.1,100076,26216262,26216643,-1,6,Homo_sapiens,HIST1H2BG,histone H2B type 1-C/E/F/G/I,381
NP_066390.1,100077,26216974,26217367,1,6,Homo_sapiens,HIST1H2AE,histone H2A type 1-B/E,393
NP_003523.1,100078,26225154,26225565,1,6,Homo_sapiens,HIST1H3E,histone H3.1,411
NP_005311.1,100079,26234267,26234933,-1,6,Homo_sapiens,HIST1H1D,histone H1.3,666
NP_003531.1,100080,26240425,26240737,1,6,Homo_sapiens,HIST1H4F,histone H4,312
NP_003538.1,100081,26246680,26246977,-1,6,Homo_sapiens,HIST1H4G,histone H4-like protein type G,297
NP_066298.1,100082,26250194,26250605,-1,6,Homo_sapiens,HIST1H3F,histone H3.1,411
NP_003515.1,100083,26251650,26252031,1,6,Homo_sapiens,HIST1H2BH,histone H2B type 1-H,381
NP_003525.1,100084,26270973,26271384,-1,6,Homo_sapiens,HIST1H3G,histone H3.1,411
NP_003516.1,100085,26272975,26273356,1,6,Homo_sapiens,HIST1H2BI,histone H2B type 1-C/E/F/G/I,381
NP_003534.1,100086,26285187,26285499,-1,6,Homo_sapiens,HIST1H4H,histone H4,312
NP_001184177.1,100087,26365336,26374367,1,6,Homo_sapiens,BTN3A2,butyrophilin subfamily 3 member A2 isoform b,9031
NP_001184169.1,100088,26383821,26392295,1,6,Homo_sapiens,BTN2A2,butyrophilin subfamily 2 member A2 isoform e precursor,8474
NP_001138481.1,100089,26405563,26412530,1,6,Homo_sapiens,BTN3A1,butyrophilin subfamily 3 member A1 isoform d precursor,6967
NP_008925.1,100090,26443574,26452411,1,6,Homo_sapiens,BTN3A3,butyrophilin subfamily 3 member A3 isoform a precursor,8837
NP_510961.1,100091,26458636,26467741,1,6,Homo_sapiens,BTN2A1,butyrophilin subfamily 2 member A1 isoform 2 precursor,9105
NP_001723.2,100092,26501286,26509174,1,6,Homo_sapiens,BTN1A1,butyrophilin subfamily 1 member A1 precursor,7888
NP_006344.1,100093,26545206,26545479,1,6,Homo_sapiens,HMGN4,high mobility group nucleosome-binding domain-containing protein 4,273
NP_037507.1,100094,26596982,26598645,1,6,Homo_sapiens,ABT1,activator of basal transcription 1,1663
NP_001229727.1,100095,26637344,26638553,-1,6,Homo_sapiens,ZNF322,zinc finger protein 322,1209
NP_066402.2,100096,27132369,27132750,-1,6,Homo_sapiens,HIST1H2BJ,histone H2B type 1-J,381
NP_066408.1,100097,27133071,27133464,1,6,Homo_sapiens,HIST1H2AG,histone H2A type 1,393
NP_003486.1,100098,27139308,27139620,1,6,Homo_sapiens,HIST1H4I,histone H4,312
NP_542160.1,100099,27146417,27146798,-1,6,Homo_sapiens,HIST1H2BK,histone H2B type 1-K,381
NP_542163.1,100100,27147128,27147515,1,6,Homo_sapiens,HIST1H2AH,histone H2A type 1-H,387
NP_005856.1,100101,27247737,27255315,1,6,Homo_sapiens,PRSS16,thymus-specific serine protease,7578
NP_258443.2,100102,27309062,27312170,-1,6,Homo_sapiens,POM121L2,POM121-like protein 2,3108
XP_011513350.1,100103,27312168,27313212,1,6,Homo_sapiens,LOC105375107,uncharacterized protein LOC105375107,1044
NP_001070249.1,100104,27400370,27401447,1,6,Homo_sapiens,ZNF391,zinc finger protein 391,1077
NP_009080.2,100105,27451302,27472294,-1,6,Homo_sapiens,ZNF184,zinc finger protein 184,20992
NP_003510.1,100106,27807525,27807906,-1,6,Homo_sapiens,HIST1H2BL,histone H2B type 1-L,381
NP_003500.1,100107,27808209,27808602,1,6,Homo_sapiens,HIST1H2AI,histone H2A type 1,393
NP_003527.1,100108,27810073,27810484,1,6,Homo_sapiens,HIST1H3H,histone H3.1,411
NP_066544.1,100109,27814353,27814740,-1,6,Homo_sapiens,HIST1H2AJ,"histone cluster 1, H2aj",387
NP_003512.1,100110,27815043,27815424,1,6,Homo_sapiens,HIST1H2BM,histone H2B type 1-M,381
NP_068803.1,100111,27824124,27824436,1,6,Homo_sapiens,HIST1H4J,histone H4,312
NP_003532.1,100112,27831215,27831527,-1,6,Homo_sapiens,HIST1H4K,histone H4,312
NP_003501.1,100113,27837946,27838339,-1,6,Homo_sapiens,HIST1H2AK,histone H2A type 1,393
NP_003511.1,100114,27838661,27839042,1,6,Homo_sapiens,HIST1H2BN,histone H2B type 1-N,381
NP_003502.1,100115,27865354,27865747,1,6,Homo_sapiens,HIST1H2AL,histone H2A type 1,393
NP_005313.1,100116,27866848,27867529,-1,6,Homo_sapiens,HIST1H1B,histone H1.5,681
NP_003524.1,100117,27871904,27872315,-1,6,Homo_sapiens,HIST1H3I,histone H3.1,411
NP_003537.1,100118,27873198,27873510,-1,6,Homo_sapiens,HIST1H4L,histone H4,312
NP_003526.1,100119,27890381,27890792,-1,6,Homo_sapiens,HIST1H3J,histone H3.1,411
NP_003505.1,100120,27892756,27893149,-1,6,Homo_sapiens,HIST1H2AM,histone H2A type 1,393
NP_003518.2,100121,27893462,27893843,1,6,Homo_sapiens,HIST1H2BO,histone H2B type 1-O,381
NP_149046.2,100122,27911245,27912319,-1,6,Homo_sapiens,OR2B2,olfactory receptor 2B2,1074
NP_036499.1,100123,27957240,27958182,1,6,Homo_sapiens,OR2B6,olfactory receptor 2B6,942
NP_003438.1,100124,28085480,28089470,1,6,Homo_sapiens,ZNF165,zinc finger protein 165,3990
NP_079507.1,100125,28125443,28129950,1,6,Homo_sapiens,ZSCAN16,zinc finger and SCAN domain-containing protein 16,4507
NP_001265048.1,100126,28148407,28154017,1,6,Homo_sapiens,ZKSCAN8,zinc finger protein with KRAB and SCAN domains 8 isoform 1,5610
NP_001186408.1,100127,28227084,28233178,1,6,Homo_sapiens,ZSCAN9,zinc finger and SCAN domain-containing protein 9 isoform 1,6094
NP_001291435.1,100128,28245115,28249792,-1,6,Homo_sapiens,ZKSCAN4,zinc finger protein with KRAB and SCAN domains 4 isoform 2,4677
NP_001007532.1,100129,28259371,28260580,1,6,Homo_sapiens,NKAPL,NKAP-like protein,1209
NP_001018854.2,100130,28271919,28277096,1,6,Homo_sapiens,ZSCAN26,zinc finger and SCAN domain-containing protein 26 isoform a,5177
NP_115896.1,100131,28283813,28302284,1,6,Homo_sapiens,PGBD1,piggyBac transposable element-derived protein 1,18471
NP_001230171.1,100132,28326165,28327437,-1,6,Homo_sapiens,ZSCAN31,zinc finger and SCAN domain-containing protein 31 isoform 2,1272
NP_077819.2,100133,28359586,28366285,1,6,Homo_sapiens,ZKSCAN3,zinc finger protein with KRAB and SCAN domains 3 isoform 1,6699
NP_001156863.1,100134,28390453,28398405,-1,6,Homo_sapiens,ZSCAN12,zinc finger and SCAN domain-containing protein 12,7952
NP_001012458.1,100135,28434464,28436266,-1,6,Homo_sapiens,ZSCAN23,zinc finger and SCAN domain-containing protein 23,1802
NP_874360.1,100136,28504291,28515743,-1,6,Homo_sapiens,GPX6,glutathione peroxidase 6 precursor,11452
NP_003987.2,100137,28526013,28532382,1,6,Homo_sapiens,GPX5,epididymal secretory glutathione peroxidase isoform 2 precursor,6369
NP_443155.1,100138,28571910,28586717,-1,6,Homo_sapiens,ZBED9,SCAN domain-containing protein 3,14807
NP_006501.1,100139,28904069,28923632,-1,6,Homo_sapiens,TRIM27,zinc finger protein RFP,19563
NP_001010877.2,100140,28995000,29003954,-1,6,Homo_sapiens,ZNF311,zinc finger protein 311,8954
NP_112165.1,100141,29044212,29045175,-1,6,Homo_sapiens,OR2W1,olfactory receptor 2W1,963
NP_001005226.1,100142,29086306,29087248,-1,6,Homo_sapiens,OR2B3,putative olfactory receptor 2B3,942
NP_001005216.2,100143,29111890,29112826,1,6,Homo_sapiens,OR2J3,olfactory receptor 2J3,936
NP_112167.2,100144,29173635,29174574,1,6,Homo_sapiens,OR2J2,olfactory receptor 2J2,939
NP_112208.1,100145,29306689,29307655,1,6,Homo_sapiens,OR14J1,olfactory receptor 14J1,966
NP_110503.3,100146,29355229,29356195,-1,6,Homo_sapiens,OR5V1,olfactory receptor 5V1,966
NP_112221.1,100147,29374336,29375287,-1,6,Homo_sapiens,OR12D3,olfactory receptor 12D3,951
NP_039224.2,100148,29396699,29397623,1,6,Homo_sapiens,OR12D2,olfactory receptor 12D2,924
NP_039225.1,100149,29426693,29427641,-1,6,Homo_sapiens,OR11A1,olfactory receptor 11A1,948
NP_039229.3,100150,29440015,29440954,1,6,Homo_sapiens,OR10C1,olfactory receptor 10C1,939
NP_112145.1,100151,29461769,29462720,1,6,Homo_sapiens,OR2H1,olfactory receptor 2H1,951
NP_443199.1,100152,29486765,29487902,-1,6,Homo_sapiens,MAS1L,mas-related G-protein coupled receptor MRG,1137
XP_011513340.1,100153,29490319,29494175,-1,6,Homo_sapiens,LOC105375007,uncharacterized protein LOC105375007,3856
NP_006389.2,100154,29555879,29559701,-1,6,Homo_sapiens,UBD,ubiquitin D,3822
NP_009091.3,100155,29587944,29588883,1,6,Homo_sapiens,OR2H2,olfactory receptor 2H2,939
NP_068703.1,100156,29603542,29627791,-1,6,Homo_sapiens,GABBR1,gamma-aminobutyric acid type B receptor subunit 1 isoform b precursor,24249
NP_001008229.1,100157,29657209,29671185,1,6,Homo_sapiens,MOG,myelin-oligodendrocyte glycoprotein isoform alpha3 precursor,13976
NP_001103279.2,100158,29672499,29677003,-1,6,Homo_sapiens,ZFP57,zinc finger protein 57 homolog,4504
NP_061823.2,100159,29723463,29726407,1,6,Homo_sapiens,HLA-F,"HLA class I histocompatibility antigen, alpha chain F isoform 2 precursor",2944
NP_001193972.1,100160,29792007,29797194,1,6,Homo_sapiens,LOC554223,histocompatibility antigen-related,5187
NP_002118.1,100161,29827844,29830382,1,6,Homo_sapiens,HLA-G,"HLA class I histocompatibility antigen, alpha chain G precursor",2538
NP_002107.3,100162,29942553,29945455,1,6,Homo_sapiens,HLA-A,"HLA class I histocompatibility antigen, A-1 alpha chain precursor",2902
NP_740753.1,100163,30061524,30064697,1,6,Homo_sapiens,ZNRD1,DNA-directed RNA polymerase I subunit RPA12,3173
NP_068778.1,100164,30067410,30069306,1,6,Homo_sapiens,PPP1R11,protein phosphatase 1 regulatory subunit 11,1896
NP_739575.2,100165,30071110,30075789,-1,6,Homo_sapiens,RNF39,RING finger protein 39 isoform 2,4679
NP_008959.3,100166,30103535,30112805,-1,6,Homo_sapiens,TRIM31,E3 ubiquitin-protein ligase TRIM31,9270
NP_001273562.1,100167,30137036,30147812,1,6,Homo_sapiens,TRIM40,tripartite motif-containing protein 40 isoform a,10776
NP_439893.2,100168,30153687,30160858,-1,6,Homo_sapiens,TRIM10,tripartite motif-containing protein 10 isoform 2,7171
NP_150232.2,100169,30163684,30172349,1,6,Homo_sapiens,TRIM15,tripartite motif-containing protein 15,8665
NP_001229712.1,100170,30185875,30199103,-1,6,Homo_sapiens,TRIM26,tripartite motif-containing protein 26,13228
NP_067076.2,100171,30329317,30342259,1,6,Homo_sapiens,TRIM39,E3 ubiquitin-protein ligase TRIM39 isoform 1,12942
NP_001186050.1,100172,30345171,30346773,1,6,Homo_sapiens,RPP21,ribonuclease P protein subunit p21 isoform 3,1602
XP_011513351.1,100173,30464728,30467855,-1,6,Homo_sapiens,LOC105375108,uncharacterized protein LOC105375108,3127
NP_005507.3,100174,30489531,30492581,1,6,Homo_sapiens,HLA-E,"HLA class I histocompatibility antigen, alpha chain E precursor",3050
NP_005266.2,100175,30546071,30556203,-1,6,Homo_sapiens,GNL1,guanine nucleotide-binding protein-like 1,10132
NP_079539.2,100176,30557344,30562495,1,6,Homo_sapiens,PRR3,proline-rich protein 3 isoform a,5151
NP_001020262.1,100177,30571487,30590701,1,6,Homo_sapiens,ABCF1,ATP-binding cassette sub-family F member 1 isoform a,19214
NP_002705.2,100178,30601548,30609944,-1,6,Homo_sapiens,PPP1R10,serine/threonine-protein phosphatase 1 regulatory subunit 10,8396
NP_054765.1,100179,30617865,30625797,1,6,Homo_sapiens,MRPS18B,"28S ribosomal protein S18b, mitochondrial",7932
NP_079185.2,100180,30626885,30643562,1,6,Homo_sapiens,ATAT1,alpha-tubulin N-acetyltransferase 1 isoform 2,16677
NP_001154848.1,100181,30647231,30652915,1,6,Homo_sapiens,C6orf136,uncharacterized protein C6orf136 isoform 3,5684
NP_003578.2,100182,30653241,30672841,-1,6,Homo_sapiens,DHX16,putative pre-mRNA-splicing factor ATP-dependent RNA helicase DHX16 isoform 1,19600
NP_597728.1,100183,30677268,30686018,-1,6,Homo_sapiens,PPP1R18,phostensin,8750
NP_001257638.1,100184,30688660,30690974,-1,6,Homo_sapiens,NRM,nurim isoform 4,2314
NP_055456.2,100185,30700464,30715175,-1,6,Homo_sapiens,MDC1,mediator of DNA damage checkpoint protein 1,14711
NP_821133.1,100186,30720506,30724397,1,6,Homo_sapiens,TUBB,tubulin beta chain isoform b,3891
NP_005794.1,100187,30728115,30742189,-1,6,Homo_sapiens,FLOT1,flotillin-1,14074
NP_003888.2,100188,30743935,30744518,-1,6,Homo_sapiens,IER3,radiation-inducible immediate-early gene IEX-1,583
NP_001189452.1,100189,30885219,30899296,1,6,Homo_sapiens,DDR1,epithelial discoidin domain-containing receptor 1 isoform 6 precursor,14077
NP_001508.1,100190,30909036,30913983,1,6,Homo_sapiens,GTF2H4,general transcription factor IIH subunit 4,4947
NP_001161206.1,100191,30914411,30926210,1,6,Homo_sapiens,VARS2,"valine--tRNA ligase, mitochondrial isoform 1",11799
NP_995326.1,100192,30931487,30932096,-1,6,Homo_sapiens,SFTA2,surfactant-associated protein 2 precursor,609
NP_543146.2,100193,30940999,30953117,1,6,Homo_sapiens,DPCR1,diffuse panbronchiolitis critical region protein 1 precursor,12118
NP_001010909.2,100194,30983958,30988194,1,6,Homo_sapiens,MUC21,mucin-21 precursor,4236
NP_001185744.1,100195,31010706,31034938,1,6,Homo_sapiens,MUC22,mucin-22 precursor,24232
NP_054789.2,100196,31111380,31112555,-1,6,Homo_sapiens,C6orf15,uncharacterized protein C6orf15 precursor,1175
NP_001255.3,100197,31116024,31120419,-1,6,Homo_sapiens,CDSN,corneodesmosin precursor,4395
NP_054787.2,100198,31129632,31139932,1,6,Homo_sapiens,PSORS1C1,psoriasis susceptibility 1 candidate gene 1 protein,10300
NP_054788.2,100199,31137950,31139026,-1,6,Homo_sapiens,PSORS1C2,psoriasis susceptibility 1 candidate gene 2 protein precursor,1076
NP_061925.2,100200,31142591,31157038,-1,6,Homo_sapiens,CCHCR1,coiled-coil alpha-helical rod protein 1 isoform 3,14447
NP_001070979.1,100201,31159469,31162717,1,6,Homo_sapiens,TCF19,transcription factor 19,3248
NP_001272915.1,100202,31164600,31165639,-1,6,Homo_sapiens,POU5F1,"POU domain, class 5, transcription factor 1 isoform 4",1039
NP_002108.4,100203,31269168,31272071,-1,6,Homo_sapiens,HLA-C,"HLA class I histocompatibility antigen, Cw-1 alpha chain precursor",2903
NP_005505.2,100204,31354482,31357158,-1,6,Homo_sapiens,HLA-B,"major histocompatibility complex, class I, B precursor",2676
NP_001170990.1,100205,31403632,31412431,1,6,Homo_sapiens,MICA,MHC class I polypeptide-related sequence A isoform 2 (MICA*00801) precursor,8799
NP_005922.2,100206,31498193,31509909,1,6,Homo_sapiens,MICB,MHC class I polypeptide-related sequence B isoform 1 precursor,11716
NP_001011700.2,100207,31529014,31529935,1,6,Homo_sapiens,MCCD1,mitochondrial coiled-coil domain protein 1 precursor,921
NP_542165.1,100208,31530433,31540532,-1,6,Homo_sapiens,DDX39B,spliceosome RNA helicase DDX39B,10099
NP_612139.1,100209,31545407,31546168,-1,6,Homo_sapiens,ATP6V1G2,V-type proton ATPase subunit G 2 isoform b,761
NP_004998.3,100210,31547694,31558611,1,6,Homo_sapiens,NFKBIL1,NF-kappa-B inhibitor-like protein 1 isoform 1,10917
NP_001153212.1,100211,31572742,31573693,1,6,Homo_sapiens,LTA,lymphotoxin-alpha precursor,951
NP_000585.2,100212,31575741,31577537,1,6,Homo_sapiens,TNF,tumor necrosis factor,1796
NP_002332.1,100213,31580708,31582417,-1,6,Homo_sapiens,LTB,lymphotoxin-beta isoform a,1709
NP_995309.2,100214,31587299,31588585,1,6,Homo_sapiens,LST1,leukocyte-specific transcript 1 protein isoform 2,1286
NP_667341.1,100215,31589066,31592721,-1,6,Homo_sapiens,NCR3,natural cytotoxicity triggering receptor 3 isoform a precursor,3655
NP_001614.3,100216,31615329,31616900,1,6,Homo_sapiens,AIF1,allograft inflammatory factor 1 isoform 3,1571
NP_542417.2,100217,31622789,31637586,1,6,Homo_sapiens,PRRC2A,protein PRRC2A,14797
NP_001186626.1,100218,31639130,31651763,-1,6,Homo_sapiens,BAG6,large proline-rich protein BAG6 isoform c,12633
NP_061974.2,100219,31655966,31658089,1,6,Homo_sapiens,APOM,apolipoprotein M isoform 1,2123
NP_067007.3,100220,31659062,31659947,-1,6,Homo_sapiens,C6orf47,uncharacterized protein C6orf47,885
NP_149417.1,100221,31662265,31664478,-1,6,Homo_sapiens,GPANK1,G patch domain and ankyrin repeat-containing protein 1,2213
NP_001311.3,100222,31666831,31669926,1,6,Homo_sapiens,CSNK2B,casein kinase II subunit beta isoform 1,3095
NP_067044.2,100223,31670950,31672282,1,6,Homo_sapiens,LY6G5B,lymphocyte antigen 6 complex locus protein G5b precursor,1332
NP_079538.3,100224,31676956,31680373,-1,6,Homo_sapiens,LY6G5C,lymphocyte antigen 6 complex locus protein G5c precursor,3417
NP_001170986.1,100225,31687211,31702768,-1,6,Homo_sapiens,ABHD16A,abhydrolase domain-containing protein 16A isoform b,15557
NP_001003693.1,100226,31706906,31710591,1,6,Homo_sapiens,LY6G6F,lymphocyte antigen 6 complex locus protein G6f precursor,3685
NP_067069.2,100227,31715355,31717804,1,6,Homo_sapiens,LY6G6D,lymphocyte antigen 6 complex locus protein G6d precursor,2449
NP_079537.1,100228,31719095,31721679,-1,6,Homo_sapiens,LY6G6C,lymphocyte antigen 6 complex locus protein G6c precursor,2584
NP_612121.1,100229,31723383,31724873,1,6,Homo_sapiens,C6orf25,protein G6b isoform G6b-G precursor,1490
NP_001289936.1,100230,31727236,31729161,-1,6,Homo_sapiens,DDAH2,"N(G),N(G)-dimethylarginine dimethylaminohydrolase 2",1925
NP_001279.2,100231,31730841,31736300,-1,6,Homo_sapiens,CLIC1,chloride intracellular channel protein 1,5459
NP_079535.4,100232,31740466,31762531,1,6,Homo_sapiens,MSH5,mutS protein homolog 5 isoform a,22065
NP_001034740.1,100233,31763054,31764531,1,6,Homo_sapiens,SAPCD1,suppressor APC domain-containing protein 1,1477
NP_079534.2,100234,31765593,31776779,-1,6,Homo_sapiens,VWA7,von Willebrand factor A domain-containing protein 7 precursor,11186
NP_006286.1,100235,31777593,31795217,-1,6,Homo_sapiens,VARS,valine--tRNA ligase,17624
NP_067000.1,100236,31797756,31806757,-1,6,Homo_sapiens,LSM2,U6 snRNA-associated Sm-like protein LSm2,9001
NP_005518.3,100237,31810046,31811972,-1,6,Homo_sapiens,HSPA1L,heat shock 70 kDa protein 1-like,1926
NP_005336.3,100238,31815756,31817682,1,6,Homo_sapiens,HSPA1A,heat shock 70 kDa protein 1A/1B,1926
NP_005337.2,100239,31827950,31829876,1,6,Homo_sapiens,HSPA1B,heat shock 70 kDa protein 1A/1B,1926
NP_001274412.1,100240,31837328,31839663,1,6,Homo_sapiens,C6orf48,protein G8,2335
NP_000425.1,100241,31859718,31862776,-1,6,Homo_sapiens,NEU1,sialidase-1 precursor,3058
NP_001171516.1,100242,31863626,31875865,-1,6,Homo_sapiens,SLC44A4,choline transporter-like protein 4 isoform 3,12239
NP_001276342.1,100243,31880083,31897202,-1,6,Homo_sapiens,EHMT2,histone-lysine N-methyltransferase EHMT2 isoform c,17119
NP_862825.1,100244,31899925,31901305,-1,6,Homo_sapiens,ZBTB12,zinc finger and BTB domain-containing protein 12,1380
NP_001171534.1,100245,31901066,31945357,1,6,Homo_sapiens,C2,complement C2 isoform 3,44291
NP_001701.2,100246,31946221,31952030,1,6,Homo_sapiens,CFB,complement factor B preproprotein,5809
NP_002895.3,100247,31952300,31958446,-1,6,Homo_sapiens,NELFE,negative elongation factor E,6146
NP_008860.4,100248,31959192,31969715,1,6,Homo_sapiens,SKIV2L,helicase SKI2W,10523
NP_005501.2,100249,31969876,31971675,-1,6,Homo_sapiens,DXO,decapping and exoribonuclease protein,1799
NP_115830.1,100250,31971996,31981049,1,6,Homo_sapiens,STK19,serine/threonine-protein kinase 19 isoform 2,9053
NP_009224.2,100251,31982107,32002540,1,6,Homo_sapiens,C4A,complement C4-A isoform 1 preproprotein,20433
NP_001002029.3,100252,32014845,32035277,1,6,Homo_sapiens,C4B,complement C4-B preproprotein,20432
NP_000491.4,100253,32038422,32041134,1,6,Homo_sapiens,CYP21A2,steroid 21-hydroxylase isoform a,2712
NP_115859.2,100254,32041348,32045219,-1,6,Homo_sapiens,TNXB,tenascin-X isoform 2,3871
NP_001129625.1,100255,32115738,32128207,-1,6,Homo_sapiens,ATF6B,cyclic AMP-dependent transcription factor ATF-6 beta isoform b,12469
NP_071393.2,100256,32128730,32129780,-1,6,Homo_sapiens,FKBPL,FK506-binding protein-like,1050
NP_085154.3,100257,32149221,32151827,-1,6,Homo_sapiens,PRRT1,proline-rich transmembrane protein 1,2606
NP_619731.2,100258,32153626,32162950,1,6,Homo_sapiens,PPT2,lysosomal thioesterase PPT2 isoform b precursor,9324
NP_085155.1,100259,32166165,32167956,1,6,Homo_sapiens,EGFL8,epidermal growth factor-like protein 8 precursor,1791
NP_116130.2,100260,32169275,32171496,-1,6,Homo_sapiens,AGPAT1,1-acyl-sn-glycerol-3-phosphate acyltransferase alpha,2221
NP_008844.1,100261,32178511,32180326,1,6,Homo_sapiens,RNF5,E3 ubiquitin-protein ligase RNF5,1815
NP_001193861.1,100262,32181142,32184222,-1,6,Homo_sapiens,AGER,advanced glycosylation end product-specific receptor isoform 3 precursor,3080
NP_002577.2,100263,32186381,32189915,-1,6,Homo_sapiens,PBX2,pre-B-cell leukemia transcription factor 2,3534
NP_071390.1,100264,32191365,32192513,-1,6,Homo_sapiens,GPSM3,G-protein-signaling modulator 3,1148
NP_004548.3,100265,32195436,32223928,-1,6,Homo_sapiens,NOTCH4,neurogenic locus notch homolog protein 4 preproprotein,28492
NP_001273404.1,100266,32292980,32371706,-1,6,Homo_sapiens,C6orf10,uncharacterized protein C6orf10 isoform c,78726
NP_001291490.1,100267,32393968,32407123,-1,6,Homo_sapiens,BTNL2,butyrophilin-like protein 2,13155
NP_061984.2,100268,32439950,32443910,1,6,Homo_sapiens,HLA-DRA,"HLA class II histocompatibility antigen, DR alpha chain precursor",3960
NP_002116.2,100269,32517738,32530224,-1,6,Homo_sapiens,HLA-DRB5,"major histocompatibility complex, class II, DR beta 5 precursor",12486
NP_002115.2,100270,32579090,32589742,-1,6,Homo_sapiens,HLA-DRB1,"major histocompatibility complex, class II, DR beta 1 precursor",10652
NP_002113.2,100271,32637458,32642764,1,6,Homo_sapiens,HLA-DQA1,"HLA class II histocompatibility antigen, DQ alpha 1 chain precursor",5306
NP_002114.3,100272,32660235,32666607,-1,6,Homo_sapiens,HLA-DQB1,"HLA class II histocompatibility antigen, DQ beta 1 chain isoform 1 precursor",6372
NP_064440.1,100273,32741443,32746394,1,6,Homo_sapiens,HLA-DQA2,"HLA class II histocompatibility antigen, DQ alpha 2 chain precursor",4951
NP_001185787.1,100274,32756452,32763470,-1,6,Homo_sapiens,HLA-DQB2,"HLA class II histocompatibility antigen, DQ beta 2 chain isoform 2 precursor",7018
NP_002111.1,100275,32813215,32816951,-1,6,Homo_sapiens,HLA-DOB,"HLA class II histocompatibility antigen, DO beta chain precursor",3736
NP_061313.2,100276,32822288,32838233,-1,6,Homo_sapiens,TAP2,antigen peptide transporter 2 isoform 2,15945
NP_683720.2,100277,32840958,32843996,-1,6,Homo_sapiens,PSMB8,proteasome subunit beta type-8 isoform E2 proprotein,3038
NP_001278951.1,100278,32845578,32852497,-1,6,Homo_sapiens,TAP1,antigen peptide transporter 1 isoform 2,6919
NP_002791.1,100279,32854229,32859532,1,6,Homo_sapiens,PSMB9,proteasome subunit beta type-9 proprotein,5303
NP_002109.2,100280,32934970,32940807,-1,6,Homo_sapiens,HLA-DMB,"HLA class II histocompatibility antigen, DM beta chain precursor",5837
NP_006111.2,100281,32948863,32953036,-1,6,Homo_sapiens,HLA-DMA,"HLA class II histocompatibility antigen, DM alpha chain precursor",4173
XP_011513352.1,100282,32966704,32972229,1,6,Homo_sapiens,LOC105375109,skin secretory protein xP2-like,5525
NP_001186384.1,100283,32972898,32980718,1,6,Homo_sapiens,BRD2,bromodomain-containing protein 2 isoform 2,7820
NP_002110.1,100284,33006837,33009536,-1,6,Homo_sapiens,HLA-DOA,"HLA class II histocompatibility antigen, DO alpha chain precursor",2699
NP_291032.2,100285,33068649,33073570,-1,6,Homo_sapiens,HLA-DPA1,"HLA class II histocompatibility antigen, DP alpha 1 chain precursor",4921
NP_002112.3,100286,33076041,33086238,1,6,Homo_sapiens,HLA-DPB1,"HLA class II histocompatibility antigen, DP beta 1 chain precursor",10197
NP_542410.2,100287,33163677,33192240,-1,6,Homo_sapiens,COL11A2,collagen alpha-2(XI) chain isoform 3 preproprotein,28563
NP_068811.1,100288,33194681,33200476,-1,6,Homo_sapiens,RXRB,retinoic acid receptor RXR-beta isoform 2,5795
NP_008910.2,100289,33201245,33203813,1,6,Homo_sapiens,SLC39A7,zinc transporter SLC39A7 isoform 1 precursor,2568
NP_055049.1,100290,33204668,33206654,1,6,Homo_sapiens,HSD17B8,estradiol 17-beta-dehydrogenase 8,1986
NP_002922.2,100291,33208822,33212399,1,6,Homo_sapiens,RING1,E3 ubiquitin-protein ligase RING1,3577
NP_001276105.1,100292,33250840,33269186,-1,6,Homo_sapiens,VPS52,vacuolar protein sorting-associated protein 52 homolog isoform 4,18346
NP_072045.1,100293,33272119,33276466,1,6,Homo_sapiens,RPS18,40S ribosomal protein S18,4347
NP_003773.1,100294,33277419,33278556,1,6,Homo_sapiens,B3GALT4,"beta-1,3-galactosyltransferase 4",1137
NP_001157739.1,100295,33279275,33289170,-1,6,Homo_sapiens,WDR46,WD repeat-containing protein 46 isoform 2,9895
NP_001172110.1,100296,33289856,33290845,1,6,Homo_sapiens,PFDN6,prefoldin subunit 6,989
NP_001230667.1,100297,33292101,33296770,-1,6,Homo_sapiens,RGL2,ral guanine nucleotide dissociation stimulator-like 2 isoform 2,4669
NP_757346.2,100298,33301759,33314041,-1,6,Homo_sapiens,TAPBP,tapasin isoform 3 precursor,12282
NP_005444.4,100299,33315011,33316916,-1,6,Homo_sapiens,ZBTB22,zinc finger and BTB domain-containing protein 22,1905
NP_001241646.1,100300,33318742,33321549,-1,6,Homo_sapiens,DAXX,death domain-associated protein 6 isoform c,2807
NP_002254.2,100301,33391985,33409690,1,6,Homo_sapiens,KIFC1,kinesin-like protein KIFC1,17705
NP_002627.1,100302,33412263,33415874,1,6,Homo_sapiens,PHF1,PHD finger protein 1 isoform a,3611
NP_001014837.1,100303,33416649,33417668,-1,6,Homo_sapiens,CUTA,protein CutA isoform 2 precursor,1019
NP_006763.2,100304,33420264,33451906,1,6,Homo_sapiens,SYNGAP1,ras/Rap GTPase-activating protein SynGAP,31642
NP_689948.1,100305,33455100,33456522,1,6,Homo_sapiens,ZBTB9,zinc finger and BTB domain-containing protein 9,1422
NP_001179.1,100306,33573802,33577604,-1,6,Homo_sapiens,BAK1,bcl-2 homologous antagonist/killer,3802
NP_002215.2,100307,33621602,33695780,1,6,Homo_sapiens,ITPR3,"inositol 1,4,5-trisphosphate receptor type 3",74178
NP_115716.1,100308,33697652,33711686,-1,6,Homo_sapiens,UQCC2,ubiquinol-cytochrome-c reductase complex assembly factor 2,14034
NP_001136355.1,100309,33722719,33735476,-1,6,Homo_sapiens,IP6K3,inositol hexakisphosphate kinase 3,12757
NP_001137416.1,100310,33772627,33781100,-1,6,Homo_sapiens,LEMD2,LEM domain-containing protein 2 isoform 2,8473
NP_001171627.1,100311,33794824,33801163,-1,6,Homo_sapiens,MLN,promotilin isoform 3 preproprotein,6339
NP_001269776.1,100312,34022820,34059076,-1,6,Homo_sapiens,GRM4,metabotropic glutamate receptor 4 isoform 8,36256
NP_665906.1,100313,34240780,34244884,1,6,Homo_sapiens,HMGA1,high mobility group protein HMG-I/HMG-Y isoform a,4104
NP_001274327.1,100314,34246513,34247108,-1,6,Homo_sapiens,C6orf1,uncharacterized protein C6orf1 isoform 2,595
NP_006694.1,100315,34288752,34392362,-1,6,Homo_sapiens,NUDT3,diphosphoinositol polyphosphate phosphohydrolase 1,103610
NP_001190174.1,100316,34417505,34425221,-1,6,Homo_sapiens,RPS10,40S ribosomal protein S10,7716
NP_065855.1,100317,34526305,34532530,1,6,Homo_sapiens,PACSIN1,protein kinase C and casein kinase substrate in neurons protein 1,6225
NP_001239223.1,100318,34538273,34544455,-1,6,Homo_sapiens,SPDEF,SAM pointed domain-containing Ets transcription factor isoform 2,6182
NP_073595.2,100319,34590564,34696603,-1,6,Homo_sapiens,C6orf106,uncharacterized protein C6orf106 isoform b,106039
NP_003084.1,100320,34757543,34773570,1,6,Homo_sapiens,SNRPC,U1 small nuclear ribonucleoprotein C,16027
NP_060224.3,100321,34792250,34872438,1,6,Homo_sapiens,UHRF1BP1,UHRF1-binding protein 1,80188
NP_005634.1,100322,34878589,34887957,-1,6,Homo_sapiens,TAF11,transcription initiation factor TFIID subunit 11 isoform 1,9368
NP_056060.2,100323,34889402,35088609,1,6,Homo_sapiens,ANKS1A,ankyrin repeat and SAM domain-containing protein 1A,199207
NP_001248749.1,100324,35118268,35136153,-1,6,Homo_sapiens,TCP11,T-complex protein 11 homolog isoform 6,17885
NP_689966.2,100325,35214418,35248705,1,6,Homo_sapiens,SCUBE3,"signal peptide, CUB and EGF-like domain-containing protein 3 isoform 1 precursor",34287
NP_003418.2,100326,35281151,35295248,1,6,Homo_sapiens,ZNF76,zinc finger protein 76 isoform 1,14097
NP_071330.3,100327,35297856,35321410,1,6,Homo_sapiens,DEF6,differentially expressed in FDCP 6 homolog,23554
NP_001165290.1,100328,35347137,35426079,1,6,Homo_sapiens,PPARD,peroxisome proliferator-activated receptor delta isoform 3,78942
NP_068741.1,100329,35452545,35466345,1,6,Homo_sapiens,FANCE,Fanconi anemia group E protein,13800
NP_009035.3,100330,35468434,35470750,1,6,Homo_sapiens,RPL10A,60S ribosomal protein L10a,2316
NP_003205.2,100331,35475043,35486662,-1,6,Homo_sapiens,TEAD3,transcriptional enhancer factor TEF-5,11619
NP_001276324.1,100332,35498326,35512858,-1,6,Homo_sapiens,TULP1,tubby-related protein 1 isoform 2,14532
NP_001139247.1,100333,35575834,35642824,-1,6,Homo_sapiens,FKBP5,peptidyl-prolyl cis-trans isomerase FKBP5 isoform 1,66990
XP_011513353.1,100334,35688089,35689106,-1,6,Homo_sapiens,LOC105375110,collagen alpha-1(III) chain-like,1017
NP_659465.2,100335,35737108,35748870,1,6,Homo_sapiens,ARMC12,armadillo repeat-containing protein 12 isoform a,11762
NP_997292.2,100336,35776618,35779450,1,6,Homo_sapiens,CLPSL2,colipase-like protein 2 isoform b precursor,2832
NP_001010886.1,100337,35781110,35788010,1,6,Homo_sapiens,CLPSL1,colipase-like protein 1 precursor,6900
NP_001239526.1,100338,35795145,35796850,-1,6,Homo_sapiens,CLPS,colipase isoform 2,1705
NP_872354.1,100339,35805670,35819447,1,6,Homo_sapiens,LHFPL5,tetraspan membrane protein of hair cell stereocilia,13777
NP_003128.3,100340,35835303,35921056,-1,6,Homo_sapiens,SRPK1,SRSF protein kinase 1,85753
NP_619732.2,100341,35943899,36019707,-1,6,Homo_sapiens,SLC26A8,testis anion transporter 1 isoform b,75808
NP_620582.1,100342,36028157,36102702,1,6,Homo_sapiens,MAPK14,mitogen-activated protein kinase 14 isoform 3,74545
NP_002745.1,100343,36130582,36139373,1,6,Homo_sapiens,MAPK13,mitogen-activated protein kinase 13,8791
NP_056510.2,100344,36200322,36230609,1,6,Homo_sapiens,BRPF3,bromodomain and PHD finger-containing protein 3,30287
NP_001139189.2,100345,36270459,36307716,1,6,Homo_sapiens,PNPLA1,patatin-like phospholipase domain-containing protein 1 isoform 3,37257
NP_001010903.3,100346,36317355,36330690,-1,6,Homo_sapiens,C6orf222,uncharacterized protein C6orf222,13335
NP_001193968.1,100347,36354641,36387541,-1,6,Homo_sapiens,ETV7,transcription factor ETV7 isoform 6,32900
NP_694535.2,100348,36391769,36426082,-1,6,Homo_sapiens,PXT1,peroxisomal testis-specific protein 1,34313
NP_775833.2,100349,36470097,36487175,1,6,Homo_sapiens,KCTD20,BTB/POZ domain-containing protein KCTD20 isoform a,17078
NP_009202.1,100350,36495783,36540202,-1,6,Homo_sapiens,STK38,serine/threonine-protein kinase 38,44419
NP_003008.1,100351,36596762,36601989,1,6,Homo_sapiens,SRSF3,serine/arginine-rich splicing factor 3,5227
NP_001278478.1,100352,36677836,36685800,1,6,Homo_sapiens,CDKN1A,cyclin-dependent kinase inhibitor 1 isoform 2,7964
NP_001244286.1,100353,36704235,36732093,1,6,Homo_sapiens,RAB44,ras-related protein Rab-44,27858
NP_065990.1,100354,36742267,36839377,-1,6,Homo_sapiens,CPNE5,copine-5,97110
NP_057143.1,100355,36855812,36874772,-1,6,Homo_sapiens,PPIL1,peptidyl-prolyl cis-trans isomerase-like 1,18960
NP_689947.2,100356,36886026,36923441,1,6,Homo_sapiens,C6orf89,bombesin receptor-activated protein C6orf89 isoform a,37415
NP_001186088.1,100357,36954760,36963944,1,6,Homo_sapiens,PI16,peptidase inhibitor 16 precursor,9184
NP_055156.1,100358,36968902,36986173,-1,6,Homo_sapiens,MTCH1,mitochondrial carrier homolog 1 PSAP-LS,17271
NP_775829.2,100359,37005817,37028163,1,6,Homo_sapiens,FGD2,"FYVE, RhoGEF and PH domain-containing protein 2",22346
NP_001230115.1,100360,37170302,37174091,1,6,Homo_sapiens,PIM1,serine/threonine-protein kinase pim-1 isoform 1,3789
NP_001273330.1,100361,37212965,37219030,-1,6,Homo_sapiens,TMEM217,transmembrane protein 217 isoform 3,6065
NP_060242.2,100362,37257917,37331172,1,6,Homo_sapiens,TBC1D22B,TBC1 domain family member 22B,73255
NP_003949.1,100363,37354164,37390758,1,6,Homo_sapiens,RNF8,E3 ubiquitin-protein ligase RNF8 isoform 1,36594
NP_055865.1,100364,37435629,37480145,1,6,Homo_sapiens,CMTR1,cap-specific mRNA (nucleoside-2'-O-)-methyltransferase 1,44516
NP_612502.1,100365,37483185,37499863,-1,6,Homo_sapiens,CCDC167,coiled-coil domain-containing protein 167,16678
NP_705691.1,100366,37637367,37696811,-1,6,Homo_sapiens,MDGA1,MAM domain-containing glycosylphosphatidylinositol anchor protein 1 precursor,59444
NP_068762.1,100367,37819945,38152389,1,6,Homo_sapiens,ZFAND3,AN1-type zinc finger protein 3,332444
NP_689946.2,100368,38174984,38594308,-1,6,Homo_sapiens,BTBD9,BTB/POZ domain-containing protein 9 isoform b,419324
NP_006699.2,100369,38677294,38703054,-1,6,Homo_sapiens,GLO1,lactoylglutathione lyase,25760
NP_001193856.1,100370,38722809,39030392,1,6,Homo_sapiens,DNAH8,"dynein heavy chain 8, axonemal",307583
NP_002053.3,100371,39048840,39086073,1,6,Homo_sapiens,GLP1R,glucagon-like peptide 1 receptor precursor,37233
NP_001291722.1,100372,39105431,39109319,-1,6,Homo_sapiens,SAYSD1,SAYSvFN domain-containing protein 1 isoform 2,3888
NP_003731.1,100373,39190889,39229111,-1,6,Homo_sapiens,KCNK5,potassium channel subfamily K member 5,38222
NP_113648.2,100374,39299426,39314320,-1,6,Homo_sapiens,KCNK17,potassium channel subfamily K member 17 isoform 1,14894
NP_001128579.1,100375,39315001,39322540,-1,6,Homo_sapiens,KCNK16,potassium channel subfamily K member 16 isoform 4,7539
NP_001275953.1,100376,39336531,39431159,-1,6,Homo_sapiens,KIF6,kinesin-like protein KIF6 isoform 4,94628
NP_001188356.1,100377,39856302,39902037,1,6,Homo_sapiens,DAAM2,disheveled-associated activator of morphogenesis 2 isoform 1,45735
NP_005934.2,100378,39909046,39927578,-1,6,Homo_sapiens,MOCS1,molybdenum cofactor biosynthesis protein 1 isoform 1,18532
NP_065788.1,100379,40391942,40433113,-1,6,Homo_sapiens,LRFN2,leucine-rich repeat and fibronectin type-III domain-containing protein 2 precursor,41171
NP_775832.2,100380,41028372,41035074,-1,6,Homo_sapiens,UNC5CL,UNC5C-like protein,6702
NP_001153198.1,100381,41042985,41044137,1,6,Homo_sapiens,TSPO2,translocator protein 2,1152
NP_006780.1,100382,41053347,41061871,1,6,Homo_sapiens,APOBEC2,probable C->U-editing enzyme APOBEC-2,8524
NP_659500.1,100383,41067334,41071634,-1,6,Homo_sapiens,OARD1,O-acetyl-ADP-ribose deacetylase 1,4300
NP_002496.1,100384,41079089,41097410,1,6,Homo_sapiens,NFYA,nuclear transcription factor Y subunit alpha isoform 1,18321
NP_001258737.1,100385,41149603,41154288,-1,6,Homo_sapiens,TREML1,trem-like transcript 1 protein isoform c precursor,4685
NP_001258750.1,100386,41158602,41163082,-1,6,Homo_sapiens,TREM2,triggering receptor expressed on myeloid cells 2 precursor isoform 2 precursor,4480
NP_079083.2,100387,41192426,41201008,-1,6,Homo_sapiens,TREML2,trem-like transcript 2 protein precursor,8582
NP_937796.1,100388,41228427,41236582,1,6,Homo_sapiens,TREML4,trem-like transcript 4 protein precursor,8155
XP_011513344.1,100389,41250181,41252885,1,6,Homo_sapiens,LOC105375057,triggering receptor expressed on myeloid cells 1-like,2704
NP_061113.1,100390,41276124,41286655,-1,6,Homo_sapiens,TREM1,triggering receptor expressed on myeloid cells 1 isoform 1 precursor,10531
NP_001186438.1,100391,41335876,41350703,1,6,Homo_sapiens,NCR2,natural cytotoxicity triggering receptor 2 isoform 2 precursor,14827
NP_001012426.1,100392,41565760,41598936,1,6,Homo_sapiens,FOXP4,forkhead box protein P4 isoform 1,33176
NP_005577.1,100393,41638749,41653575,1,6,Homo_sapiens,MDFI,myoD family inhibitor isoform 1,14826
NP_001258872.1,100394,41684598,41691213,-1,6,Homo_sapiens,TFEB,transcription factor EB isoform 3,6615
NP_002621.1,100395,41736851,41747334,-1,6,Homo_sapiens,PGC,gastricsin isoform 1 preproprotein,10483
NP_006644.1,100396,41770618,41776987,-1,6,Homo_sapiens,FRS3,fibroblast growth factor receptor substrate 3,6369
NP_037529.3,100397,41783473,41787129,1,6,Homo_sapiens,PRICKLE4,prickle-like protein 4,3656
NP_001127965.1,100398,41787697,41789328,1,6,Homo_sapiens,TOMM6,mitochondrial import receptor subunit TOM6 homolog,1631
NP_001273483.1,100399,41796532,41806983,-1,6,Homo_sapiens,USP49,ubiquitin carboxyl-terminal hydrolase 49 isoform a,10451
NP_004266.2,100400,41907071,41921018,-1,6,Homo_sapiens,MED20,mediator of RNA polymerase II transcription subunit 20,13947
NP_004044.3,100401,41921562,41932706,1,6,Homo_sapiens,BYSL,bystin,11144
NP_001129598.1,100402,41935939,41936681,-1,6,Homo_sapiens,CCND3,G1/S-specific cyclin-D3 isoform 4,742
NP_612639.2,100403,42050541,42077545,1,6,Homo_sapiens,TAF8,transcription initiation factor TFIID subunit 8,27004
NP_001157918.1,100404,42103760,42142444,-1,6,Homo_sapiens,C6orf132,uncharacterized protein C6orf132,38684
NP_000400.2,100405,42173613,42179403,1,6,Homo_sapiens,GUCA1A,guanylyl cyclase-activating protein 1,5790
NP_002089.4,100406,42184814,42194820,-1,6,Homo_sapiens,GUCA1B,guanylyl cyclase-activating protein 2,10006
NP_060611.2,100407,42208288,42217849,-1,6,Homo_sapiens,MRPS10,"28S ribosomal protein S10, mitochondrial",9561
NP_277037.1,100408,42228344,42269590,-1,6,Homo_sapiens,TRERF1,transcriptional-regulating factor 1 isoform 2,41246
NP_001171730.1,100409,42564319,42619506,1,6,Homo_sapiens,UBR2,E3 ubiquitin-protein ligase UBR2 isoform 2,55187
NP_000313.2,100410,42698294,42722334,-1,6,Homo_sapiens,PRPH2,peripherin-2,24040
NP_003183.1,100411,42745032,42746073,-1,6,Homo_sapiens,TBCC,tubulin-specific chaperone C,1041
NP_056164.1,100412,42822022,42865446,1,6,Homo_sapiens,GLTSCR1L,GLTSCR1-like protein,43424
NP_940888.2,100413,42879937,42886464,1,6,Homo_sapiens,RPL7L1,60S ribosomal protein L7-like 1,6527
NP_001008739.1,100414,42890482,42890788,-1,6,Homo_sapiens,C6orf226,uncharacterized protein C6orf226,306
NP_001230098.1,100415,42916069,42925682,1,6,Homo_sapiens,PTCRA,pre T-cell antigen receptor alpha isoform 3 precursor,9613
NP_006577.2,100416,42929570,42938791,1,6,Homo_sapiens,CNPY3,protein canopy homolog 3 precursor,9221
NP_061833.1,100417,42960767,42963706,1,6,Homo_sapiens,GNMT,glycine N-methyltransferase,2939
NP_000278.3,100418,42964334,42979150,-1,6,Homo_sapiens,PEX6,peroxisome biogenesis factor 6,14816
NP_006236.1,100419,42984677,43011286,1,6,Homo_sapiens,PPP2R5D,serine/threonine-protein phosphatase 2A 56 kDa regulatory subunit delta isoform isoform 1,26609
NP_055438.1,100420,43012469,43013813,-1,6,Homo_sapiens,MEA1,male-enhanced antigen 1,1344
NP_476502.1,100421,43017192,43020733,1,6,Homo_sapiens,KLHDC3,kelch domain-containing protein 3,3541
NP_149103.1,100422,43021654,43029228,1,6,Homo_sapiens,RRP36,ribosomal RNA processing protein 36 homolog,7574
NP_055595.2,100423,43037687,43052788,-1,6,Homo_sapiens,CUL7,cullin-7 isoform 2,15101
NP_057034.2,100424,43054273,43059381,-1,6,Homo_sapiens,MRPL2,"39S ribosomal protein L2, mitochondrial isoform 1",5108
NP_958931.1,100425,43060209,43074672,1,6,Homo_sapiens,KLC4,kinesin light chain 4 isoform b,14463
NP_002812.2,100426,43076488,43160881,1,6,Homo_sapiens,PTK7,inactive tyrosine-protein kinase 7 isoform a precursor,84393
NP_003122.1,100427,43171656,43179190,1,6,Homo_sapiens,SRF,serum response factor isoform 1,7534
NP_055904.1,100428,43184310,43224445,1,6,Homo_sapiens,CUL9,cullin-9,40135
NP_006434.1,100429,43225732,43229456,-1,6,Homo_sapiens,DNPH1,2'-deoxynucleoside 5'-phosphate N-hydrolase 1 isoform 1,3724
NP_115927.1,100430,43246660,43285376,1,6,Homo_sapiens,TTBK1,tau-tubulin kinase 1,38716
NP_696961.2,100431,43298358,43304725,1,6,Homo_sapiens,SLC22A7,solute carrier family 22 member 7 isoform b,6367
NP_996805.2,100432,43305813,43308792,-1,6,Homo_sapiens,CRIP3,cysteine-rich protein 3,2979
NP_055160.2,100433,43337157,43369365,-1,6,Homo_sapiens,ZNF318,zinc finger protein 318,32208
NP_001185863.1,100434,43427978,43450091,1,6,Homo_sapiens,ABCC10,multidrug resistance-associated protein 7 isoform MRP7,22113
NP_001273584.1,100435,43450538,43454825,-1,6,Homo_sapiens,DLK2,protein delta homolog 2 isoform b precursor,4287
NP_001139488.1,100436,43499001,43505855,1,6,Homo_sapiens,TJAP1,tight junction-associated protein 1 isoform a,6854
NP_001258811.1,100437,43507237,43508823,-1,6,Homo_sapiens,LRRC73,leucine-rich repeat-containing protein 73 isoform 2,1586
NP_056203.2,100438,43512166,43516807,-1,6,Homo_sapiens,YIPF3,protein YIPF3,4641
NP_976035.1,100439,43517109,43521300,1,6,Homo_sapiens,POLR1C,DNA-directed RNA polymerases I and III subunit RPAC1,4191
NP_065801.1,100440,43523867,43575864,-1,6,Homo_sapiens,XPO5,exportin-5,51997
NP_001278899.1,100441,43582319,43613731,1,6,Homo_sapiens,POLH,DNA polymerase eta isoform 3,31412
NP_001273145.1,100442,43621613,43626359,-1,6,Homo_sapiens,GTPBP2,GTP-binding protein 2 isoform b,4746
NP_001003690.1,100443,43629749,43640533,1,6,Homo_sapiens,MAD2L1BP,MAD2L1-binding protein isoform 1,10784
NP_689945.2,100444,43645098,43670949,1,6,Homo_sapiens,RSPH9,radial spoke head protein 9 homolog isoform 1,25851
NP_060605.1,100445,43671761,43687779,-1,6,Homo_sapiens,MRPS18A,"28S ribosomal protein S18a, mitochondrial isoform 1 precursor",16018
NP_001020540.2,100446,43770706,43784546,1,6,Homo_sapiens,VEGFA,vascular endothelial growth factor A isoform e,13840
NP_001165463.1,100447,44000619,44002119,1,6,Homo_sapiens,C6orf223,uncharacterized protein C6orf223 isoform 2,1500
NP_115487.2,100448,44113842,44116611,-1,6,Homo_sapiens,MRPL14,"39S ribosomal protein L14, mitochondrial",2769
NP_060896.1,100449,44134584,44154883,1,6,Homo_sapiens,TMEM63B,CSC1-like protein 2,20299
NP_008989.2,100450,44158848,44183932,1,6,Homo_sapiens,CAPN11,calpain-11,25084
NP_001291391.1,100451,44219696,44233528,1,6,Homo_sapiens,SLC29A1,equilibrative nucleoside transporter 1 isoform 5,13832
NP_031381.2,100452,44248629,44253598,1,6,Homo_sapiens,HSP90AB1,heat shock protein HSP 90-beta isoform a,4969
NP_001273448.1,100453,44254705,44255605,-1,6,Homo_sapiens,SLC35B2,adenosine 3'-phospho 5'-phosphosulfate transporter 1 isoform f,900
NP_004547.2,100454,44259218,44265763,-1,6,Homo_sapiens,NFKBIE,NF-kappa-B inhibitor epsilon,6545
NP_001131032.1,100455,44270742,44276527,1,6,Homo_sapiens,TMEM151B,transmembrane protein 151B,5785
NP_872345.2,100456,44280180,44287825,-1,6,Homo_sapiens,TCTE1,T-complex-associated testis-expressed protein 1,7645
NP_065796.1,100457,44300546,44313323,-1,6,Homo_sapiens,AARS2,"alanine--tRNA ligase, mitochondrial",12777
NP_659463.1,100458,44343095,44377063,1,6,Homo_sapiens,SPATS1,spermatogenesis-associated serine-rich protein 1,33968
NP_001244.1,100459,44387823,44446711,1,6,Homo_sapiens,CDC5L,cell division cycle 5-like protein,58888
NP_001248752.1,100460,44829815,45003700,-1,6,Homo_sapiens,SUPT3H,transcription initiation protein SPT3 homolog isoform 3,173885
NP_001019801.3,100461,45328726,45547305,1,6,Homo_sapiens,RUNX2,runt-related transcription factor 2 isoform a,218579
NP_058625.2,100462,45903087,46015542,-1,6,Homo_sapiens,CLIC5,chloride intracellular channel protein 5 isoform b,112455
NP_055751.1,100463,46139583,46143640,1,6,Homo_sapiens,ENPP4,bis(5'-adenosyl)-triphosphatase ENPP4 precursor,4057
NP_001277002.1,100464,46161325,46167980,-1,6,Homo_sapiens,ENPP5,ectonucleotide pyrophosphatase/phosphodiesterase family member 5 isoform 2,6655
NP_005813.2,100465,46223140,46325479,-1,6,Homo_sapiens,RCAN2,calcipressin-2 isoform 1,102339
NP_001265668.1,100466,46550365,46637950,-1,6,Homo_sapiens,CYP39A1,24-hydroxycholesterol 7-alpha-hydroxylase isoform 3,87585
NP_004268.3,100467,46653192,46676454,1,6,Homo_sapiens,SLC25A27,mitochondrial uncoupling protein 4 isoform 1,23262
NP_001010870.1,100468,46688128,46701887,1,6,Homo_sapiens,TDRD6,tudor domain-containing protein 6 isoform 1,13759
NP_005075.3,100469,46704559,46722891,-1,6,Homo_sapiens,PLA2G7,platelet-activating factor acetylhydrolase precursor,18332
NP_001155907.2,100470,46746921,46758921,1,6,Homo_sapiens,ANKRD66,ankyrin repeat domain-containing protein 66,12000
NP_005579.2,100471,46793398,46839136,1,6,Homo_sapiens,MEP1A,meprin A subunit alpha precursor,45738
NP_001091988.1,100472,46853991,46906762,-1,6,Homo_sapiens,ADGRF5,probable G-protein coupled receptor 116 precursor,52771
NP_722582.2,100473,47000221,47029061,-1,6,Homo_sapiens,ADGRF1,probable G-protein coupled receptor 110 isoform 1 precursor,28840
NP_055267.1,100474,47232764,47309511,-1,6,Homo_sapiens,TNFRSF21,tumor necrosis factor receptor superfamily member 21 precursor,76747
NP_036252.1,100475,47478244,47624227,1,6,Homo_sapiens,CD2AP,CD2-associated protein,145983
NP_722581.4,100476,47673419,47690565,1,6,Homo_sapiens,ADGRF2,probable G-protein coupled receptor 111 precursor,17146
NP_722580.3,100477,47707245,47718442,1,6,Homo_sapiens,ADGRF4,probable G-protein coupled receptor 115 precursor,11197
NP_859528.1,100478,47782066,47823991,1,6,Homo_sapiens,OPN5,opsin-5,41925
NP_001013754.3,100479,47878302,48068655,-1,6,Homo_sapiens,PTCHD4,patched domain-containing protein 4 isoform 1,190353
NP_000246.2,100480,49431727,49459466,-1,6,Homo_sapiens,MUT,"methylmalonyl-CoA mutase, mitochondrial precursor",27739
NP_060602.2,100481,49470176,49492275,1,6,Homo_sapiens,CENPQ,centromere protein Q,22099
NP_001010904.1,100482,49511990,49526914,1,6,Homo_sapiens,GLYATL3,glycine N-acyltransferase-like protein 3,14924
NP_001139124.1,100483,49550792,49551527,1,6,Homo_sapiens,C6orf141,uncharacterized protein C6orf141,735
NP_000315.2,100484,49605812,49636812,-1,6,Homo_sapiens,RHAG,ammonium transporter Rh type A,31000
NP_001135879.1,100485,49692772,49709196,-1,6,Homo_sapiens,CRISP2,cysteine-rich secretory protein 2 precursor,16424
NP_006052.2,100486,49728729,49744367,-1,6,Homo_sapiens,CRISP3,cysteine-rich secretory protein 3 isoform 1 precursor,15638
NP_620061.2,100487,49785933,49787187,-1,6,Homo_sapiens,PGK2,phosphoglycerate kinase 2,1254
NP_001122.2,100488,49835315,49857400,-1,6,Homo_sapiens,CRISP1,cysteine-rich secretory protein 1 isoform 1 precursor,22085
NP_001159950.1,100489,49946100,49949444,-1,6,Homo_sapiens,DEFB133,beta-defensin 133 precursor,3344
NP_001032588.1,100490,49960291,49964105,-1,6,Homo_sapiens,DEFB114,beta-defensin 114 precursor,3814
NP_001032818.1,100491,49968676,49969625,-1,6,Homo_sapiens,DEFB113,beta-defensin 113 precursor,949
NP_001032817.1,100492,50009137,50021935,-1,6,Homo_sapiens,DEFB110,beta-defensin 110 isoform b,12798
NP_001032587.1,100493,50043574,50048651,-1,6,Homo_sapiens,DEFB112,beta-defensin 112,5077
NP_758438.2,100494,50714055,50772864,1,6,Homo_sapiens,TFAP2D,transcription factor AP-2-delta,58809
NP_003212.2,100495,50818891,50843392,1,6,Homo_sapiens,TFAP2B,transcription factor AP-2-beta,24501
NP_619639.3,100496,51619080,52084933,-1,6,Homo_sapiens,PKHD1,fibrocystin isoform 1 precursor,465853
NP_002181.1,100497,52186431,52189292,1,6,Homo_sapiens,IL17A,interleukin-17A precursor,2861
NP_443104.1,100498,52236930,52244429,-1,6,Homo_sapiens,IL17F,interleukin-17F precursor,7499
NP_002379.3,100499,52264587,52284809,-1,6,Homo_sapiens,MCM3,DNA replication licensing factor MCM3 isoform 1,20222
NP_588608.1,100500,52403213,52404278,1,6,Homo_sapiens,PAQR8,membrane progestin receptor beta,1065
NP_060570.2,100501,52420410,52492341,1,6,Homo_sapiens,EFHC1,EF-hand domain-containing protein 1 isoform 1,71931
NP_036420.1,100502,52503196,52576915,-1,6,Homo_sapiens,TRAM2,translocating chain-associated membrane protein 2,73719
NP_054770.1,100503,52677102,52686049,1,6,Homo_sapiens,TMEM14A,transmembrane protein 14A,8947
NP_000837.3,100504,52750576,52757947,-1,6,Homo_sapiens,GSTA2,glutathione S-transferase A2,7371
NP_665683.1,100505,52791857,52799267,-1,6,Homo_sapiens,GSTA1,glutathione S-transferase A1,7410
NP_714543.1,100506,52831847,52840813,-1,6,Homo_sapiens,GSTA5,glutathione S-transferase A5,8966
NP_000838.3,100507,52896805,52905834,-1,6,Homo_sapiens,GSTA3,glutathione S-transferase A3,9029
NP_001503.1,100508,52978469,52994243,-1,6,Homo_sapiens,GSTA4,glutathione S-transferase A4,15774
NP_057597.2,100509,53005148,53041236,-1,6,Homo_sapiens,ICK,serine/threonine-protein kinase ICK,36088
XP_011513345.1,100510,53065332,53065791,-1,6,Homo_sapiens,LOC105375092,uncharacterized protein LOC105375092,459
NP_258441.1,100511,53065789,53097830,1,6,Homo_sapiens,FBXO9,F-box only protein 9 isoform 2,32041
NP_003634.2,100512,53128205,53145632,-1,6,Homo_sapiens,GCM1,chorion-specific transcription factor GCMa,17427
NP_001229759.1,100513,53269112,53295699,-1,6,Homo_sapiens,ELOVL5,elongation of very long chain fatty acids protein 5 isoform 3,26587
NP_001184044.1,100514,53498755,53544645,-1,6,Homo_sapiens,GCLC,glutamate--cysteine ligase catalytic subunit isoform b,45890
NP_001003760.2,100515,53651597,53655272,-1,6,Homo_sapiens,KLHL31,kelch-like protein 31,3675
NP_060684.4,100516,53795256,53922793,1,6,Homo_sapiens,LRRC1,leucine-rich repeat-containing protein 1,127537
NP_001268675.1,100517,54019028,54215202,1,6,Homo_sapiens,MLIP,muscular LMNA-interacting protein isoform 2,196174
NP_055279.3,100518,54308550,54389925,1,6,Homo_sapiens,TINAG,tubulointerstitial nephritis antigen,81375
NP_001010872.1,100519,54870246,54942007,1,6,Homo_sapiens,FAM83B,protein FAM83B,71761
NP_001517.2,100520,55174587,55282454,1,6,Homo_sapiens,HCRTR2,orexin receptor type 2,107867
NP_997293.2,100521,55327554,55401853,1,6,Homo_sapiens,GFRAL,GDNF family receptor alpha-like precursor,74299
NP_001274675.1,100522,55435661,55516603,-1,6,Homo_sapiens,HMGCLL1,"3-hydroxymethyl-3-methylglutaryl-CoA lyase, cytoplasmic isoform d",80942
NP_066551.1,100523,55755532,55874865,-1,6,Homo_sapiens,BMP5,bone morphogenetic protein 5 preproprotein,119333
NP_110447.2,100524,56057656,56182618,-1,6,Homo_sapiens,COL21A1,collagen alpha-1(XXI) chain precursor,124962
NP_056363.2,100525,56459004,56642788,-1,6,Homo_sapiens,DST,dystonin isoform 1eA precursor,183784
NP_689944.2,100526,56981810,57018548,1,6,Homo_sapiens,BEND6,BEN domain-containing protein 6,36738
NP_065982.1,100527,57046755,57054863,1,6,Homo_sapiens,KIAA1586,uncharacterized protein KIAA1586 isoform a,8108
NP_001244202.1,100528,57090253,57102096,1,6,Homo_sapiens,ZNF451,zinc finger protein 451 isoform 3,11843
NP_004273.1,100529,57172697,57184190,1,6,Homo_sapiens,BAG2,BAG family molecular chaperone regulator 2,11493
NP_057361.3,100530,57190460,57210380,-1,6,Homo_sapiens,RAB23,ras-related protein Rab-23,19920
NP_001269416.1,100531,57318445,57326063,1,6,Homo_sapiens,PRIM2,DNA primase large subunit isoform b,7618
NP_001177635.1,100532,61574327,61574402,1,6,Homo_sapiens,MTRNR2L9,humanin-like 9,75
NP_689901.2,100533,61680962,62285948,-1,6,Homo_sapiens,KHDRBS2,"KH domain-containing, RNA-binding, signal transduction-associated protein 2",604986
NP_057655.2,100534,63280020,63319943,-1,6,Homo_sapiens,LGSN,lengsin isoform a,39923
NP_003454.1,100535,63576880,63580174,1,6,Homo_sapiens,PTP4A1,protein tyrosine phosphatase type IVA 1,3294
NP_001277189.1,100536,63646551,63685933,1,6,Homo_sapiens,PHF3,PHD finger protein 3 isoform 3,39382
NP_001136272.1,100537,63720595,65495410,-1,6,Homo_sapiens,EYS,protein eyes shut homolog isoform 1 precursor,1774815
NP_001258604.1,100538,65302521,65304939,1,6,Homo_sapiens,LOC441155,zinc finger CCCH-type domain-containing-like,2418
NP_001136273.1,100539,65332323,65495410,-1,6,Homo_sapiens,EYS,protein eyes shut homolog isoform 2 precursor,163087
NP_001695.1,100540,68638675,69388891,1,6,Homo_sapiens,ADGRB3,brain-specific angiogenesis inhibitor 3,750216
NP_060838.3,100541,69676157,69796881,-1,6,Homo_sapiens,LMBRD1,probable lysosomal cobalamin transporter,120724
NP_001849.2,100542,69879567,70207274,1,6,Homo_sapiens,COL19A1,collagen alpha-1(XIX) chain precursor,327707
NP_511040.2,100543,70216896,70283052,-1,6,Homo_sapiens,COL9A1,collagen alpha-1(IX) chain isoform 2 precursor,66156
NP_001156001.1,100544,70428342,70559921,1,6,Homo_sapiens,FAM135A,protein FAM135A isoform c,131579
NP_660310.2,100545,70566940,70588724,1,6,Homo_sapiens,SDHAF4,"succinate dehydrogenase assembly factor 4, mitochondrial precursor",21784
NP_001268368.1,100546,70668023,70860234,1,6,Homo_sapiens,SMAP1,stromal membrane-associated protein 1 isoform C,192211
NP_542780.1,100547,70861662,70956429,-1,6,Homo_sapiens,B3GAT2,galactosylgalactosylxylosylprotein 3-beta-glucuronosyltransferase 2,94767
NP_078852.3,100548,71288936,71302049,1,6,Homo_sapiens,OGFRL1,opioid growth factor receptor-like protein 1,13113
NP_055804.2,100549,71887023,72400714,1,6,Homo_sapiens,RIMS1,regulating synaptic membrane exocytosis protein 1 isoform 1,513691
NP_001153605.1,100550,72622189,73195414,1,6,Homo_sapiens,KCNQ5,potassium voltage-gated channel subfamily KQT member 5 isoform 4,573225
NP_001119535.1,100551,73223747,73225408,-1,6,Homo_sapiens,KHDC1L,putative KHDC1-like protein,1661
NP_085045.3,100552,73241528,73242517,-1,6,Homo_sapiens,KHDC1,KH homology domain-containing protein 1 isoform 2,989
NP_001020461.1,100553,73353319,73354225,-1,6,Homo_sapiens,DPPA5,developmental pluripotency-associated 5 protein,906
NP_001017361.1,100554,73362729,73363860,1,6,Homo_sapiens,KHDC3L,KHDC3-like protein,1131
NP_001073976.1,100555,73368783,73369792,-1,6,Homo_sapiens,OOEP,oocyte-expressed protein homolog,1009
NP_061135.2,100556,73394905,73416226,1,6,Homo_sapiens,DDX43,probable ATP-dependent RNA helicase DDX43,21321
NP_612450.2,100557,73425226,73452181,-1,6,Homo_sapiens,MB21D1,cyclic GMP-AMP synthase,26955
NP_598400.1,100558,73461854,73500735,1,6,Homo_sapiens,MTO1,"protein MTO1 homolog, mitochondrial isoform b",38881
NP_001393.1,100559,73517809,73520026,-1,6,Homo_sapiens,EEF1A1,elongation factor 1-alpha 1,2217
NP_036566.1,100560,73595076,73653886,-1,6,Homo_sapiens,SLC17A5,sialin,58810
NP_598000.2,100561,73696215,73823633,1,6,Homo_sapiens,CD109,CD109 antigen isoform 1 preproprotein,127418
NP_542376.2,100562,75086546,75202792,-1,6,Homo_sapiens,COL12A1,collagen alpha-1(XII) chain short isoform precursor,116246
NP_001856.2,100563,75237929,75243830,-1,6,Homo_sapiens,COX7A2,"cytochrome c oxidase subunit 7A2, mitochondrial precursor",5901
NP_001137430.1,100564,75256101,75284638,-1,6,Homo_sapiens,TMEM30A,cell cycle control protein 50A isoform 2,28537
NP_001287795.1,100565,75295909,75414972,-1,6,Homo_sapiens,FILIP1,filamin-A-interacting protein 1 isoform 3,119063
NP_001291721.1,100566,75602524,75678931,1,6,Homo_sapiens,SENP6,sentrin-specific protease 6 isoform 3,76407
NP_004990.3,100567,75817547,75915012,1,6,Homo_sapiens,MYO6,unconventional myosin-VI isoform 1,97465
NP_001269297.1,100568,75922088,76072488,-1,6,Homo_sapiens,IMPG1,interphotoreceptor matrix proteoglycan 1 isoform 2 precursor,150400
NP_000854.1,100569,77462230,77463403,-1,6,Homo_sapiens,HTR1B,5-hydroxytryptamine receptor 1B,1173
NP_001269065.1,100570,77690671,77923346,1,6,Homo_sapiens,MEI4,meiosis-specific protein MEI4-like,232675
NP_001010844.1,100571,78867576,78898334,1,6,Homo_sapiens,IRAK1BP1,interleukin-1 receptor-associated kinase 1-binding protein 1,30758
NP_060404.3,100572,78940692,79078068,-1,6,Homo_sapiens,PHIP,PH-interacting protein,137376
NP_004233.1,100573,79201687,79234560,-1,6,Homo_sapiens,HMGN3,high mobility group nucleosome-binding domain-containing protein 3 isoform HMGN3a,32873
NP_859065.2,100574,79487003,79518894,-1,6,Homo_sapiens,LCA5,Lebercilin,31891
XP_011534584.1,100575,79537860,79631009,1,6,Homo_sapiens,LOC105377866,uncharacterized protein LOC105377866,93149
NP_113657.1,100576,79631461,79699509,1,6,Homo_sapiens,SH3BGRL2,SH3 domain-binding glutamic acid-rich-like protein 2,68048
NP_001230237.1,100577,79803874,79870321,-1,6,Homo_sapiens,C6orf7,uncharacterized protein LOC89758,66447
NP_073563.1,100578,79916607,79947279,-1,6,Homo_sapiens,ELOVL4,elongation of very long chain fatty acids protein 4,30672
NP_003309.2,100579,80005843,80042202,1,6,Homo_sapiens,TTK,dual specificity protein kinase TTK isoform 1,36359
NP_898871.1,100580,80106693,80343804,1,6,Homo_sapiens,BCKDHB,"2-oxoisovalerate dehydrogenase subunit beta, mitochondrial precursor",237111
NP_060103.2,100581,81749694,81752141,-1,6,Homo_sapiens,FAM46A,protein FAM46A,2447
NP_001287835.1,100582,82171424,82240486,-1,6,Homo_sapiens,IBTK,inhibitor of Bruton tyrosine kinase isoform 2,69062
NP_001159864.1,100583,82364961,82366224,1,6,Homo_sapiens,TPBG,trophoblast glycoprotein precursor,1263
NP_001291366.1,100584,82893021,83058003,-1,6,Homo_sapiens,UBE3D,E3 ubiquitin-protein ligase E3D isoform 2,164982
NP_055833.2,100585,83096977,83168167,1,6,Homo_sapiens,DOPEY1,protein dopey-1 isoform a,71190
NP_001186848.1,100586,83166386,83191012,-1,6,Homo_sapiens,PGM3,phosphoacetylglucosamine mutase isoform 4,24626
NP_219479.2,100587,83194451,83196272,1,6,Homo_sapiens,RWDD2A,RWD domain-containing protein 2A,1821
NP_002386.1,100588,83211923,83430954,-1,6,Homo_sapiens,ME1,NADP-dependent malic enzyme,219031
NP_699193.2,100589,83523441,83524683,1,6,Homo_sapiens,PRSS35,inactive serine protease 35 precursor,1242
NP_001243647.1,100590,83556152,83661596,-1,6,Homo_sapiens,SNAP91,clathrin coat assembly protein AP180 isoform e,105444
XP_011534604.1,100591,83708511,83736364,1,6,Homo_sapiens,LOC105378158,basic proline-rich protein-like,27853
NP_001009994.1,100592,83853416,83857389,1,6,Homo_sapiens,RIPPLY2,protein ripply2,3973
NP_057314.2,100593,83859782,83959878,1,6,Homo_sapiens,CYB5R4,cytochrome b5 reductase 4,100096
NP_612418.2,100594,84055318,84089481,1,6,Homo_sapiens,MRAP2,melanocortin-2 receptor accessory protein 2,34163
NP_001273135.1,100595,84125069,84215866,-1,6,Homo_sapiens,CEP162,centrosomal protein of 162 kDa isoform b,90797
NP_001073977.1,100596,84736684,84764181,-1,6,Homo_sapiens,TBX18,T-box transcription factor TBX18,27497
NP_002517.1,100597,85450139,85494004,1,6,Homo_sapiens,NT5E,5'-nucleotidase isoform 1 preproprotein,43865
NP_001291408.1,100598,85505966,85574362,-1,6,Homo_sapiens,SNX14,sorting nexin-14 isoform d,68396
NP_001240700.1,100599,85612881,85637301,-1,6,Homo_sapiens,SYNCRIP,heterogeneous nuclear ribonucleoprotein Q isoform 7,24420
NP_000856.1,100600,87015334,87016432,1,6,Homo_sapiens,HTR1E,5-hydroxytryptamine receptor 1E,1098
NP_000726.1,100601,87085755,87088200,-1,6,Homo_sapiens,CGA,glycoprotein hormones alpha chain isoform 2 precursor,2445
XP_011534605.1,100602,87155196,87155589,1,6,Homo_sapiens,LOC101928870,classical arabinogalactan protein 9-like,393
NP_055836.1,100603,87155591,87261801,1,6,Homo_sapiens,ZNF292,zinc finger protein 292,106210
NP_940970.1,100604,87284240,87284912,-1,6,Homo_sapiens,GJB7,gap junction beta-7 protein,672
NP_001035958.1,100605,87337031,87340274,1,6,Homo_sapiens,SMIM8,small integral membrane protein 8 isoform 1,3243
NP_001010868.2,100606,87345099,87365396,1,6,Homo_sapiens,C6orf163,uncharacterized protein C6orf163,20297
NP_001026913.1,100607,87409839,87464250,1,6,Homo_sapiens,C6orf165,UPF0704 protein C6orf165,54411
NP_006407.1,100608,87473003,87511526,1,6,Homo_sapiens,SLC35A1,CMP-sialic acid transporter isoform a,38523
NP_064716.2,100609,87514412,87589957,-1,6,Homo_sapiens,RARS2,"probable arginine--tRNA ligase, mitochondrial precursor",75545
NP_862820.1,100610,87590168,87667123,1,6,Homo_sapiens,ORC3,origin recognition complex subunit 3 isoform 1,76955
NP_060534.1,100611,87675596,87701684,-1,6,Homo_sapiens,AKIRIN2,akirin-2,26088
NP_112222.1,100612,88047905,88066335,1,6,Homo_sapiens,SPACA1,sperm acrosome membrane-associated protein 1 precursor,18430
NP_149421.2,100613,88143855,88145274,-1,6,Homo_sapiens,CNR1,cannabinoid receptor 1 isoform b,1419
NP_001273357.1,100614,88612718,88929261,-1,6,Homo_sapiens,RNGTT,mRNA-capping enzyme isoform c,316543
NP_006804.1,100615,89080894,89084196,1,6,Homo_sapiens,PNRC1,proline-rich nuclear receptor coactivator 1,3302
NP_542781.3,100616,89098577,89117887,-1,6,Homo_sapiens,SRSF12,serine/arginine-rich splicing factor 12,19310
NP_001010853.1,100617,89146144,89162263,1,6,Homo_sapiens,PM20D2,peptidase M20 domain-containing protein 2,16119
NP_001243633.1,100618,89178769,89201177,-1,6,Homo_sapiens,GABRR1,gamma-aminobutyric acid receptor subunit rho-1 isoform c,22408
NP_002034.3,100619,89257669,89315165,-1,6,Homo_sapiens,GABRR2,gamma-aminobutyric acid receptor subunit rho-2 precursor,57496
NP_057105.2,100620,89329678,89352569,-1,6,Homo_sapiens,UBE2J1,ubiquitin-conjugating enzyme E2 J1,22891
NP_067067.1,100621,89368055,89411993,-1,6,Homo_sapiens,RRAGD,ras-related GTP-binding protein D,43938
NP_001229738.1,100622,89566976,89631004,1,6,Homo_sapiens,ANKRD6,ankyrin repeat domain-containing protein 6 isoform a,64028
NP_065199.1,100623,89637272,89638716,-1,6,Homo_sapiens,LYRM2,LYR motif-containing protein 2,1444
NP_055426.1,100624,89644004,89819607,-1,6,Homo_sapiens,MDN1,midasin,175603
NP_001131140.1,100625,89846589,89873809,1,6,Homo_sapiens,CASP8AP2,CASP8-associated protein 2,27220
NP_115991.1,100626,89894468,89896100,1,6,Homo_sapiens,GJA10,gap junction alpha-10 protein,1632
NP_068585.1,100627,89932407,90008844,-1,6,Homo_sapiens,BACH2,transcription regulator protein BACH2,76437
NP_003179.1,100628,90516500,90586883,-1,6,Homo_sapiens,MAP3K7,mitogen-activated protein kinase kinase kinase 7 isoform A,70383
XP_006715688.1,100629,92644472,92644805,-1,6,Homo_sapiens,LOC102724665,putative protein PRCA2,333
NP_001275558.1,100630,93243425,93419341,-1,6,Homo_sapiens,EPHA7,ephrin type-A receptor 7 isoform 2 precursor,175916
NP_078917.2,100631,95586439,95606405,1,6,Homo_sapiens,MANEA,"glycoprotein endo-alpha-1,2-mannosidase",19966
NP_006572.2,100632,96203155,96204235,1,6,Homo_sapiens,FUT9,"alpha-(1,3)-fucosyltransferase 9",1080
NP_056138.1,100633,96521873,96553503,1,6,Homo_sapiens,UFL1,E3 UFM1-protein ligase 1,31630
NP_065228.4,100634,96603613,96615772,1,6,Homo_sapiens,FHL5,four and a half LIM domains protein 5,12159
NP_110411.1,100635,96798471,96799731,-1,6,Homo_sapiens,GPR63,probable G-protein coupled receptor 63,1260
NP_054884.1,100636,96891103,96897801,-1,6,Homo_sapiens,NDUFAF4,NADH dehydrogenase [ubiquinone] 1 alpha subcomplex assembly factor 4,6698
NP_001273181.1,100637,96967060,97114568,1,6,Homo_sapiens,KLHL32,kelch-like protein 32 isoform d,147508
NP_001273183.1,100638,97127441,97139282,1,6,Homo_sapiens,KLHL32,kelch-like protein 32 isoform e,11841
NP_940870.2,100639,97146805,97282477,-1,6,Homo_sapiens,MMS22L,protein MMS22-like,135672
NP_005595.2,100640,98834873,98836205,1,6,Homo_sapiens,POU3F2,"POU domain, class 3, transcription factor 2",1332
NP_036292.2,100641,98874277,98926988,-1,6,Homo_sapiens,FBXL4,F-box/LRR-repeat protein 4,52711
NP_115900.1,100642,99281163,99349372,-1,6,Homo_sapiens,FAXC,failed axon connections homolog,68209
NP_059117.3,100643,99369599,99394179,-1,6,Homo_sapiens,COQ3,"hexaprenyldihydroxybenzoate methyltransferase, mitochondrial",24580
NP_116259.2,100644,99400539,99414659,-1,6,Homo_sapiens,PNISR,arginine/serine-rich protein PNISR,14120
NP_001073950.1,100645,99435715,99510220,-1,6,Homo_sapiens,USP45,ubiquitin carboxyl-terminal hydrolase 45,74505
NP_001182060.1,100646,99526078,99531720,1,6,Homo_sapiens,TSTD3,thiosulfate sulfurtransferase/rhodanese-like domain-containing protein 3,5642
NP_001013417.1,100647,99543554,99561405,-1,6,Homo_sapiens,CCNC,cyclin-C isoform b,17851
NP_067633.2,100648,99607034,99614759,1,6,Homo_sapiens,PRDM13,PR domain zinc finger protein 13,7725
NP_115892.2,100649,99920939,99956147,-1,6,Homo_sapiens,MCHR2,melanin-concentrating hormone receptor 2,35208
NP_005059.2,100650,100390360,100463468,-1,6,Homo_sapiens,SIM1,single-minded homolog 1,73108
NP_006819.2,100651,100509385,100867997,-1,6,Homo_sapiens,ASCC3,activating signal cointegrator 1 complex subunit 3 isoform a,358612
NP_786944.1,100652,101399277,102064009,1,6,Homo_sapiens,GRIK2,"glutamate receptor ionotropic, kainate 2 isoform 2 precursor",664732
NP_065822.2,100653,104729661,104859642,-1,6,Homo_sapiens,HACE1,E3 ubiquitin-protein ligase HACE1,129981
NP_001004317.1,100654,104957250,105078783,1,6,Homo_sapiens,LIN28B,protein lin-28 homolog B,121533
NP_671488.1,100655,105101088,105133577,-1,6,Homo_sapiens,BVES,blood vessel epicardial substance,32489
NP_071756.2,100656,105158469,105161909,-1,6,Homo_sapiens,POPDC3,popeye domain-containing protein 3,3440
NP_002717.3,100657,105278143,105402891,-1,6,Homo_sapiens,PREP,prolyl endopeptidase,124748
NP_001189.2,100658,106086553,106107486,1,6,Homo_sapiens,PRDM1,PR domain zinc finger protein 1 isoform 1,20933
NP_001273036.1,100659,106186539,106316102,-1,6,Homo_sapiens,ATG5,autophagy protein 5 isoform b precursor,129563
NP_001615.2,100660,106512341,106568566,1,6,Homo_sapiens,AIM1,absent in melanoma 1 protein,56225
NP_116119.2,100661,106571995,106629021,-1,6,Homo_sapiens,RTN4IP1,"reticulon-4-interacting protein 1, mitochondrial precursor",57026
NP_060762.3,100662,106629681,106666002,1,6,Homo_sapiens,QRSL1,"glutamyl-tRNA(Gln) amidotransferase subunit A, mitochondrial",36321
NP_001278668.1,100663,106971660,106973885,-1,6,Homo_sapiens,CD24,signal transducer CD24 isoform b,2225
NP_001135942.1,100664,107030104,107051236,1,6,Homo_sapiens,C6orf203,uncharacterized protein C6orf203 isoform b,21132
NP_001073919.1,100665,107068703,107099285,-1,6,Homo_sapiens,BEND3,BEN domain-containing protein 3,30582
NP_065114.3,100666,107154618,107459285,-1,6,Homo_sapiens,PDSS2,decaprenyl-diphosphate synthase subunit 2,304667
NP_060483.3,100667,107490616,107635466,1,6,Homo_sapiens,SOBP,sine oculis-binding protein homolog,144850
NP_001273338.1,100668,107705199,107720949,-1,6,Homo_sapiens,SCML4,sex comb on midleg-like protein 4 isoform c,15750
NP_009145.1,100669,107871703,107958009,-1,6,Homo_sapiens,SEC63,translocation protein SEC63 homolog,86306
NP_054747.2,100670,108044784,108074651,-1,6,Homo_sapiens,OSTM1,osteopetrosis-associated transmembrane protein 1,29867
NP_003260.1,100671,108166765,108187463,1,6,Homo_sapiens,NR2E1,nuclear receptor subfamily 2 group E member 1 isoform b,20698
NP_001287858.1,100672,108212148,108260921,-1,6,Homo_sapiens,SNX3,sorting nexin-3 isoform d,48773
NP_660358.2,100673,108295079,108522425,1,6,Homo_sapiens,LACE1,lactation elevated protein 1,227346
NP_963853.1,100674,108561208,108664855,1,6,Homo_sapiens,FOXO3,forkhead box protein O3,103647
NP_115507.4,100675,108854267,108973514,1,6,Homo_sapiens,ARMC2,armadillo repeat-containing protein 2 isoform a,119247
NP_001186863.1,100676,108987543,109001458,-1,6,Homo_sapiens,SESN1,sestrin-1 isoform 3,13915
NP_001258782.1,100677,109145221,109162749,1,6,Homo_sapiens,CEP57L1,centrosomal protein CEP57L1 isoform 2,17528
NP_001264268.1,100678,109236660,109270371,1,6,Homo_sapiens,LOC100996634,transmembrane protein FLJ37396,33711
NP_001135876.1,100679,109368278,109382378,-1,6,Homo_sapiens,CD164,sialomucin core protein 24 isoform 5 precursor,14100
NP_001273289.1,100680,109392825,109440590,-1,6,Homo_sapiens,PPIL6,peptidyl-prolyl cis-trans isomerase-like 6 isoform 3,47765
NP_003071.2,100681,109441121,109443905,1,6,Homo_sapiens,SMPD2,sphingomyelin phosphodiesterase 2,2784
NP_001152763.1,100682,109444190,109454196,-1,6,Homo_sapiens,MICAL1,protein-methionine sulfoxide oxidase MICAL1 isoform 2,10006
NP_055612.2,100683,109465850,109482026,-1,6,Homo_sapiens,ZBTB24,zinc finger and BTB domain-containing protein 24 isoform 1,16176
NP_001138600.2,100684,109493368,109675745,-1,6,Homo_sapiens,AK9,adenylate kinase 9 isoform 1,182377
NP_055660.1,100685,109691435,109825265,1,6,Homo_sapiens,FIG4,polyphosphoinositide phosphatase,133830
NP_001273028.1,100686,109978775,109980201,1,6,Homo_sapiens,GPR6,G-protein coupled receptor 6 isoform a,1426
NP_003922.1,100687,110100521,110127601,-1,6,Homo_sapiens,WASF1,wiskott-Aldrich syndrome protein family member 1,27080
NP_056975.1,100688,110180444,110230131,1,6,Homo_sapiens,CDC40,pre-mRNA-processing factor 17,49687
NP_001116836.1,100689,110245945,110358272,-1,6,Homo_sapiens,METTL24,methyltransferase-like protein 24 precursor,112327
NP_004023.2,100690,110392774,110415546,-1,6,Homo_sapiens,DDO,D-aspartate oxidase isoform b,22772
NP_149116.2,100691,110424872,110476574,-1,6,Homo_sapiens,SLC22A16,solute carrier family 22 member 16,51702
NP_001287892.1,100692,110614534,110746149,-1,6,Homo_sapiens,CDK19,cyclin-dependent kinase 19 isoform 3,131615
NP_001625.2,100693,110875105,110893616,1,6,Homo_sapiens,AMD1,S-adenosylmethionine decarboxylase proenzyme isoform 1,18511
NP_612417.1,100694,110958769,110967790,1,6,Homo_sapiens,GTF3C6,general transcription factor 3C polypeptide 6,9021
NP_115570.1,100695,110982106,111025582,1,6,Homo_sapiens,RPF2,ribosome production factor 2 homolog isoform 1,43476
NP_061063.2,100696,111087752,111222235,1,6,Homo_sapiens,SLC16A10,monocarboxylate transporter 10,134483
NP_699200.2,100697,111259700,111267119,1,6,Homo_sapiens,KIAA1919,sodium-dependent glucose transporter 1,7419
NP_001273360.1,100698,111300015,111416377,-1,6,Homo_sapiens,REV3L,DNA polymerase zeta catalytic subunit isoform b,116362
NP_001157755.1,100699,111559404,111566551,-1,6,Homo_sapiens,TRAF3IP2,adapter protein CIKS isoform 5,7147
NP_694593.1,100700,111661738,111720051,-1,6,Homo_sapiens,FYN,tyrosine-protein kinase Fyn isoform c,58313
XP_011534606.1,100701,111872731,111873592,1,6,Homo_sapiens,LOC102724646,smoothelin-like,861
NP_937882.1,100702,112054303,112069620,1,6,Homo_sapiens,WISP3,WNT1-inducible-signaling pathway protein 3 isoform 3,15317
NP_057346.1,100703,112071411,112087434,-1,6,Homo_sapiens,TUBE1,tubulin epsilon chain,16023
NP_001028736.1,100704,112099283,112100787,1,6,Homo_sapiens,FAM229B,protein FAM229B,1504
NP_001098677.2,100705,112109436,112254150,-1,6,Homo_sapiens,LAMA4,laminin subunit alpha-4 isoform 2 precursor,144714
NP_001013756.2,100706,112349708,112350500,1,6,Homo_sapiens,RFPL4B,ret finger protein-like 4B,792
NP_002347.5,100707,113857745,113860579,1,6,Homo_sapiens,MARCKS,myristoylated alanine-rich C-kinase substrate,2834
NP_001518.3,100708,113941057,113970908,-1,6,Homo_sapiens,HDAC2,histone deacetylase 2,29851
NP_705840.2,100709,114057256,114062845,-1,6,Homo_sapiens,HS3ST5,heparan sulfate glucosamine 3-O-sulfotransferase 5,5589
NP_002022.1,100710,115942413,116060311,-1,6,Homo_sapiens,FRK,tyrosine-protein kinase FRK,117898
NP_689942.2,100711,116100930,116244024,1,6,Homo_sapiens,NT5DC1,5'-nucleotidase domain-containing protein 1,143094
NP_000484.2,100712,116120072,116125492,-1,6,Homo_sapiens,COL10A1,collagen alpha-1(X) chain precursor,5420
NP_067680.3,100713,116252763,116254008,-1,6,Homo_sapiens,TSPYL4,testis-specific Y-encoded-like protein 4,1245
NP_003300.1,100714,116278516,116279830,-1,6,Homo_sapiens,TSPYL1,testis-specific Y-encoded-like protein 1,1314
NP_001074445.1,100715,116399250,116437345,1,6,Homo_sapiens,DSE,dermatan-sulfate epimerase precursor,38095
NP_001263389.1,100716,116461420,116463705,1,6,Homo_sapiens,FAM26F,protein FAM26F isoform 2,2285
NP_001132916.1,100717,116496953,116545514,-1,6,Homo_sapiens,TRAPPC3L,trafficking protein particle complex subunit 3-like protein,48561
NP_714922.1,100718,116511696,116515989,1,6,Homo_sapiens,FAM26E,protein FAM26E,4293
NP_001243817.1,100719,116543813,116558211,1,6,Homo_sapiens,FAM26D,protein FAM26D isoform b,14398
NP_057036.2,100720,116571582,116593101,1,6,Homo_sapiens,RWDD1,RWD domain-containing protein 1 isoform a,21519
NP_001155136.1,100721,116616623,116632229,1,6,Homo_sapiens,RSPH4A,radial spoke head protein 4 homolog A isoform 2,15606
NP_659499.2,100722,116635831,116667192,-1,6,Homo_sapiens,ZUFSP,zinc finger with UFM1-specific peptidase domain protein,31361
NP_002260.2,100723,116681334,116732323,1,6,Homo_sapiens,KPNA5,importin subunit alpha-6,50989
NP_001078949.1,100724,116752596,116765576,-1,6,Homo_sapiens,FAM162B,protein FAM162B,12980
NP_001273283.1,100725,116792141,116829013,-1,6,Homo_sapiens,GPRC6A,G-protein coupled receptor family C group 6 member A isoform 2 precursor,36872
NP_775831.2,100726,116877275,116931506,1,6,Homo_sapiens,RFX6,DNA-binding protein RFX6,54231
NP_872586.1,100727,117265763,117272494,1,6,Homo_sapiens,VGLL2,transcription cofactor vestigial-like protein 2 isoform 1,6731
NP_002935.2,100728,117288491,117425656,-1,6,Homo_sapiens,ROS1,proto-oncogene tyrosine-protein kinase ROS precursor,137165
NP_775945.1,100729,117482781,117569624,1,6,Homo_sapiens,DCBLD1,"discoidin, CUB and LCCL domain-containing protein 1 precursor",86843
NP_001017408.1,100730,117563253,117602288,-1,6,Homo_sapiens,GOPC,Golgi-associated PDZ and coiled-coil motif-containing protein isoform b,39035
NP_612468.1,100731,117675670,117707015,1,6,Homo_sapiens,NUS1,nogo-B receptor,31345
NP_001025029.2,100732,117907726,118314252,1,6,Homo_sapiens,SLC35F1,solute carrier family 35 member F1,406526
NP_001035940.1,100733,118465404,118651269,-1,6,Homo_sapiens,CEP85L,centrosomal protein of 85 kDa-like isoform a,185865
NP_002658.1,100734,118558921,118559080,1,6,Homo_sapiens,PLN,cardiac phospholamban,159
NP_060166.2,100735,118814823,118931723,-1,6,Homo_sapiens,MCM9,DNA helicase MCM9 isoform 1,116900
NP_054753.1,100736,118894413,118907614,1,6,Homo_sapiens,ASF1A,histone chaperone ASF1A,13201
NP_694987.1,100737,118911623,118931723,-1,6,Homo_sapiens,MCM9,DNA helicase MCM9 isoform 2,20100
NP_001275505.1,100738,118960102,119024612,-1,6,Homo_sapiens,FAM184A,protein FAM184A isoform 3,64510
NP_005898.2,100739,119179818,119349065,-1,6,Homo_sapiens,MAN1A1,"mannosyl-oligosaccharide 1,2-alpha-mannosidase IA",169247
NP_689943.4,100740,121080770,121334430,-1,6,Homo_sapiens,TBC1D32,protein broad-minded,253660
NP_000156.1,100741,121446847,121447996,1,6,Homo_sapiens,GJA1,gap junction alpha-1 protein,1149
NP_001230023.1,100742,122399737,122420234,1,6,Homo_sapiens,HSF2,heat shock factor protein 2 isoform c,20497
NP_065806.1,100743,122445043,122471737,-1,6,Homo_sapiens,SERINC1,serine incorporator 1 precursor,26694
NP_001257323.1,100744,122701487,122725195,1,6,Homo_sapiens,PKIB,cAMP-dependent protein kinase inhibitor beta isoform 2,23708
NP_001437.1,100745,122779794,122783767,1,6,Homo_sapiens,FABP7,"fatty acid-binding protein, brain",3973
NP_006705.1,100746,122789346,122809408,1,6,Homo_sapiens,SMPDL3A,acid sphingomyelinase-like phosphodiesterase 3a isoform a precursor,20062
NP_001010852.2,100747,122997777,123063761,1,6,Homo_sapiens,CLVS2,clavesin-2,65984
NP_006064.2,100748,123218600,123636775,-1,6,Homo_sapiens,TRDN,triadin isoform 1,418175
NP_001035304.1,100749,123804200,124823229,1,6,Homo_sapiens,NKAIN2,sodium/potassium-transporting ATPase subunit beta-1-interacting protein 2 isoform 1,1019029
NP_001273327.1,100750,124962544,125082937,1,6,Homo_sapiens,RNF217,probable E3 ubiquitin-protein ligase RNF217 isoform a,120393
NP_001003396.1,100751,125153951,125262843,1,6,Homo_sapiens,TPD52L1,tumor protein D53 isoform 3,108892
NP_057147.2,100752,125276145,125301932,-1,6,Homo_sapiens,HDDC2,HD domain-containing protein 2,25787
NP_036391.1,100753,125749776,125759802,1,6,Homo_sapiens,HEY2,hairy/enhancer-of-split related with YRPW motif protein 2,10026
NP_861447.3,100754,125815354,125928771,1,6,Homo_sapiens,NCOA7,nuclear receptor coactivator 7 isoform 1,113417
NP_612638.3,100755,125956977,125977676,1,6,Homo_sapiens,HINT3,histidine triad nucleotide-binding protein 3,20699
NP_001026882.2,100756,125986550,126038836,1,6,Homo_sapiens,TRMT11,tRNA (guanine(10)-N2)-methyltransferase homolog,52286
NP_001273454.1,100757,126340273,126348469,1,6,Homo_sapiens,CENPW,centromere protein W isoform c,8196
NP_116173.2,100758,127119192,127196007,1,6,Homo_sapiens,RSPO3,R-spondin-3 precursor,76815
NP_001229778.1,100759,127280338,127287693,1,6,Homo_sapiens,RNF146,E3 ubiquitin-protein ligase RNF146 isoform b,7355
NP_001099014.1,100760,127289868,127327139,-1,6,Homo_sapiens,ECHDC1,ethylmalonyl-CoA decarboxylase isoform 3,37271
NP_055517.3,100761,127444108,127453981,-1,6,Homo_sapiens,KIAA0408,uncharacterized protein KIAA0408,9873
NP_001012279.1,100762,127473280,127516614,-1,6,Homo_sapiens,SOGA3,protein SOGA3 precursor,43334
NP_001010905.1,100763,127577185,127591622,1,6,Homo_sapiens,C6orf58,UPF0762 protein C6orf58 precursor,14437
NP_001158159.1,100764,127709984,127855174,-1,6,Homo_sapiens,THEMIS,protein THEMIS isoform 3,145190
NP_001278913.1,100765,127970226,128520358,-1,6,Homo_sapiens,PTPRK,receptor-type tyrosine-protein phosphatase kappa isoform f precursor,550132
NP_000417.2,100766,128883245,129516347,1,6,Homo_sapiens,LAMA2,laminin subunit alpha-2 isoform a precursor,633102
NP_277050.2,100767,129578512,129710136,-1,6,Homo_sapiens,ARHGAP18,rho GTPase-activating protein 18,131624
NP_001010876.1,100768,129831318,129861188,-1,6,Homo_sapiens,TMEM244,transmembrane protein 244,29870
NP_115814.1,100769,130042699,130139753,1,6,Homo_sapiens,L3MBTL3,lethal(3)malignant brain tumor-like protein 3 isoform a,97054
NP_001017373.2,100770,130144519,130215273,-1,6,Homo_sapiens,SAMD3,sterile alpha motif domain-containing protein 3 isoform 1,70754
XP_011534607.1,100771,130365205,130383090,-1,6,Homo_sapiens,LOC105378159,uncharacterized protein LOC105378159,17885
NP_443145.1,100772,130440422,130441898,1,6,Homo_sapiens,TMEM200A,transmembrane protein 200A,1476
NP_001182526.1,100773,130827413,130834955,1,6,Homo_sapiens,SMLR1,small leucine-rich protein 1,7542
NP_001129026.1,100774,130858135,130956485,-1,6,Homo_sapiens,EPB41L2,band 4.1-like protein 2 isoform b,98350
NP_057461.2,100775,131135763,131281726,1,6,Homo_sapiens,AKAP7,A-kinase anchor protein 7 isoform gamma isoform gamma,145963
NP_001231367.1,100776,131573282,131583908,1,6,Homo_sapiens,ARG1,arginase-1 isoform 1,10626
NP_001257450.1,100777,131574292,131628049,-1,6,Homo_sapiens,MED23,mediator of RNA polymerase II transcription subunit 23 isoform c,53757
NP_005012.2,100778,131637384,131746956,1,6,Homo_sapiens,ENPP3,ectonucleotide pyrophosphatase/phosphodiesterase family member 3,109572
NP_112170.1,100779,131700468,131701401,-1,6,Homo_sapiens,OR2A4,olfactory receptor 2A4,933
NP_001139131.1,100780,131708683,131711017,-1,6,Homo_sapiens,CTAGE9,cTAGE family member 9,2334
NP_006199.2,100781,131808035,131890511,1,6,Homo_sapiens,ENPP1,ectonucleotide pyrophosphatase/phosphodiesterase family member 1,82476
NP_001892.1,100782,131949263,131951172,-1,6,Homo_sapiens,CTGF,connective tissue growth factor precursor,1909
NP_056344.2,100783,132297152,132401426,-1,6,Homo_sapiens,MOXD1,DBH-like monooxygenase protein 1 precursor,104274
NP_003560.2,100784,132460757,132503530,-1,6,Homo_sapiens,STX7,syntaxin-7,42773
NP_778227.3,100785,132538289,132539336,1,6,Homo_sapiens,TAAR9,trace amine-associated receptor 9,1047
NP_444508.1,100786,132552692,132553721,1,6,Homo_sapiens,TAAR8,trace amine-associated receptor 8,1029
NP_778237.1,100787,132570321,132571359,1,6,Homo_sapiens,TAAR6,trace amine-associated receptor 6,1038
NP_003958.2,100788,132588672,132589686,-1,6,Homo_sapiens,TAAR5,trace amine-associated receptor 5,1014
NP_055441.2,100789,132617149,132618070,-1,6,Homo_sapiens,TAAR2,trace amine-associated receptor 2 isoform 2,921
NP_612200.1,100790,132644983,132646003,-1,6,Homo_sapiens,TAAR1,trace amine-associated receptor 1,1020
NP_004657.2,100791,132683139,132714035,-1,6,Homo_sapiens,VNN1,pantetheinase precursor,30896
NP_001278631.1,100792,132722925,132726776,-1,6,Homo_sapiens,VNN3,vascular non-inflammatory molecule 3,3851
NP_511043.1,100793,132744299,132757724,-1,6,Homo_sapiens,VNN2,vascular non-inflammatory molecule 2 isoform 2,13425
NP_439896.1,100794,132770269,132798456,-1,6,Homo_sapiens,SLC18B1,MFS-type transporter SLC18B1,28187
NP_001007.2,100795,132814768,132817542,1,6,Homo_sapiens,RPS12,40S ribosomal protein S12,2774
NP_001287942.1,100796,133274780,133528805,1,6,Homo_sapiens,EYA4,eyes absent homolog 4 isoform f,254025
NP_003197.2,100797,133889397,133891802,1,6,Homo_sapiens,TCF21,transcription factor 21,2405
NP_001240605.1,100798,133980125,133987040,1,6,Homo_sapiens,TBPL1,TATA box-binding protein-like protein 1,6915
NP_660159.1,100799,133991154,134052480,-1,6,Homo_sapiens,SLC2A12,"solute carrier family 2, facilitated glucose transporter member 12",61326
NP_001278924.1,100800,134170267,134174807,-1,6,Homo_sapiens,SGK1,serine/threonine-protein kinase Sgk1 isoform 5,4540
NP_001180409.1,100801,134918414,134950053,-1,6,Homo_sapiens,ALDH8A1,aldehyde dehydrogenase family 8 member A1 isoform 3,31639
NP_001138630.1,100802,134965278,135054691,-1,6,Homo_sapiens,HBS1L,HBS1-like protein isoform 2,89413
NP_001123645.1,100803,135181513,135217980,1,6,Homo_sapiens,MYB,transcriptional activator Myb isoform 1,36467
NP_001128302.1,100804,135285644,135492237,-1,6,Homo_sapiens,AHI1,jouberin isoform a,206593
NP_061818.1,100805,135851998,136191840,1,6,Homo_sapiens,PDE7B,"cAMP-specific 3',5'-cyclic phosphodiesterase 7B",339842
NP_001092756.1,100806,136231274,136249099,-1,6,Homo_sapiens,MTFR2,mitochondrial fission regulator 2,17825
NP_001070908.1,100807,136261109,136279866,-1,6,Homo_sapiens,BCLAF1,bcl-2-associated transcription factor 1 isoform 2,18757
NP_001185547.1,100808,136344227,136388480,-1,6,Homo_sapiens,MAP7,ensconsin isoform 8,44253
NP_005914.1,100809,136557757,136792157,-1,6,Homo_sapiens,MAP3K5,mitogen-activated protein kinase kinase kinase 5,234400
NP_000279.1,100810,136822665,136913526,1,6,Homo_sapiens,PEX7,peroxisomal biogenesis factor 7,90861
NP_001008783.1,100811,136922428,136924696,1,6,Homo_sapiens,SLC35D3,solute carrier family 35 member D3,2268
NP_001265653.1,100812,137001557,137017037,-1,6,Homo_sapiens,IL20RA,interleukin-20 receptor subunit alpha isoform 4,15480
NP_851826.1,100813,137145623,137161749,-1,6,Homo_sapiens,IL22RA2,interleukin-22 receptor subunit alpha-2 isoform 2 precursor,16126
NP_000407.1,100814,137198030,137219327,-1,6,Homo_sapiens,IFNGR1,interferon gamma receptor 1 precursor,21297
NP_786923.1,100815,137493351,137494170,-1,6,Homo_sapiens,OLIG3,oligodendrocyte transcription factor 3,819
NP_001257436.1,100816,137871227,137881319,1,6,Homo_sapiens,TNFAIP3,tumor necrosis factor alpha-induced protein 3,10092
NP_071404.2,100817,138092041,138107340,-1,6,Homo_sapiens,PERP,p53 apoptosis effector related to PMP-22,15299
NP_065073.3,100818,138162086,138336486,1,6,Homo_sapiens,ARFGEF3,brefeldin A-inhibited guanine nucleotide-exchange protein 3,174400
NP_067648.1,100819,138217987,138218395,-1,6,Homo_sapiens,PBOV1,prostate and breast cancer overexpressed gene 1 protein,408
NP_055135.1,100820,138404495,138413078,1,6,Homo_sapiens,HEBP2,heme-binding protein 2,8583
NP_001137532.1,100821,138424080,138499290,-1,6,Homo_sapiens,NHSL1,NHS-like protein 1 isoform 2,75210
NP_001229669.1,100822,138727466,138773550,-1,6,Homo_sapiens,LOC100507462,uncharacterized protein LOC100507462,46084
NP_056254.1,100823,138773674,138792803,1,6,Homo_sapiens,CCDC28A,coiled-coil domain-containing protein 28A,19129
NP_001071174.1,100824,138813274,138902627,1,6,Homo_sapiens,ECT2L,epithelial cell-transforming sequence 2 oncogene-like,89353
NP_001273541.1,100825,138905063,138987682,-1,6,Homo_sapiens,REPS1,ralBP1-associated Eps domain-containing protein 1 isoform d,82619
NP_067066.1,100826,139034160,139042903,1,6,Homo_sapiens,ABRACL,costars family protein ABRACL,8743
NP_057301.1,100827,139135396,139177105,1,6,Homo_sapiens,HECA,headcase protein homolog,41709
NP_694967.3,100828,139242525,139288899,-1,6,Homo_sapiens,TXLNB,beta-taxilin,46374
NP_006070.2,100829,139373131,139373944,-1,6,Homo_sapiens,CITED2,cbp/p300-interacting transactivator 2 isoform 1,813
NP_002502.2,100830,142075647,142088658,-1,6,Homo_sapiens,NMBR,neuromedin-B receptor,13011
NP_057569.2,100831,142147287,142218643,1,6,Homo_sapiens,VTA1,vacuolar protein sorting-associated protein VTA1 homolog isoform a,71356
NP_065188.4,100832,142302329,142443382,1,6,Homo_sapiens,ADGRG6,G-protein coupled receptor 126 isoform alpha 1 precursor,141053
NP_006725.3,100833,142753106,142774738,-1,6,Homo_sapiens,HIVEP2,transcription factor HIVEP2,21632
NP_001273517.1,100834,143060925,143187393,1,6,Homo_sapiens,AIG1,androgen-induced gene 1 protein isoform c,126468
NP_001273188.1,100835,143428462,143438649,-1,6,Homo_sapiens,ADAT2,tRNA-specific adenosine deaminase 2 isoform b,10187
NP_003621.1,100836,143451042,143489226,1,6,Homo_sapiens,PEX3,peroxisomal biogenesis factor 3,38184
NP_114409.2,100837,143495706,143511634,-1,6,Homo_sapiens,FUCA2,plasma alpha-L-fucosidase precursor,15928
NP_055536.2,100838,143608309,143823689,1,6,Homo_sapiens,PHACTR2,phosphatase and actin regulator 2 isoform 3,215380
NP_116249.2,100839,143843477,143863527,1,6,Homo_sapiens,LTV1,protein LTV1 homolog,20050
NP_001013645.1,100840,143864539,143937719,1,6,Homo_sapiens,ZC2HC1B,zinc finger C2HC domain-containing protein 1B,73180
NP_001074424.1,100841,143941423,143942659,-1,6,Homo_sapiens,PLAGL1,zinc finger protein PLAGL1 isoform 1,1236
NP_112577.1,100842,144095236,144095497,-1,6,Homo_sapiens,SF3B5,splicing factor 3B subunit 5,261
NP_003755.2,100843,144186627,144187491,1,6,Homo_sapiens,STX11,syntaxin-11,864
NP_009055.2,100844,144291828,144850997,1,6,Homo_sapiens,UTRN,utrophin,559169
NP_001018051.1,100845,145625694,145735498,-1,6,Homo_sapiens,EPM2A,laforin isoform b,109804
NP_115521.3,100846,145800105,145806405,-1,6,Homo_sapiens,FBXO30,F-box only protein 30,6300
NP_775105.1,100847,145886427,145955322,-1,6,Homo_sapiens,SHPRH,E3 ubiquitin-protein ligase SHPRH isoform b,68895
NP_001264994.1,100848,146029517,146426619,1,6,Homo_sapiens,GRM1,metabotropic glutamate receptor 1 isoform beta precursor,397102
NP_006825.1,100849,146543871,146554605,1,6,Homo_sapiens,RAB32,ras-related protein Rab-32,10734
NP_078970.3,100850,146599040,146815217,1,6,Homo_sapiens,ADGB,androglobin,216177
NP_001121187.1,100851,147204532,147384755,1,6,Homo_sapiens,STXBP5,syntaxin-binding protein 5 isoform b,180223
NP_001025231.1,100852,147508928,147564456,1,6,Homo_sapiens,SAMD5,sterile alpha motif domain-containing protein 5,55528
NP_056093.3,100853,148343067,148548558,1,6,Homo_sapiens,SASH1,SAM and SH3 domain-containing protein 1,205491
NP_005706.1,100854,148747430,149074116,1,6,Homo_sapiens,UST,uronyl 2-sulfotransferase,326686
NP_001278964.1,100855,149218770,149409719,1,6,Homo_sapiens,TAB2,TGF-beta-activated kinase 1 and MAP3K7-binding protein 2 isoform b,190949
NP_997243.2,100856,149450682,149474543,-1,6,Homo_sapiens,ZC3H12D,probable ribonuclease ZC3H12D,23861
NP_624311.1,100857,149505452,149546005,-1,6,Homo_sapiens,PPIL4,peptidyl-prolyl cis-trans isomerase-like 4,40553
NP_620140.1,100858,149566414,149590838,1,6,Homo_sapiens,GINM1,glycoprotein integral membrane protein 1 precursor,24424
NP_008975.1,100859,149595035,149638547,-1,6,Homo_sapiens,KATNA1,katanin p60 ATPase-containing subunit A1 isoform 1,43512
NP_004681.1,100860,149661728,149702126,-1,6,Homo_sapiens,LATS1,serine/threonine-protein kinase LATS1 isoform 1,40398
NP_942590.1,100861,149726968,149746495,-1,6,Homo_sapiens,NUP43,nucleoporin Nup43,19527
NP_005380.2,100862,149749727,149802379,1,6,Homo_sapiens,PCMT1,protein-L-isoaspartate(D-aspartate) O-methyltransferase isoform 1,52652
NP_116221.3,100863,149820548,149864020,-1,6,Homo_sapiens,LRP11,low-density lipoprotein receptor-related protein 11 precursor,43472
NP_001230257.1,100864,149884487,149890901,-1,6,Homo_sapiens,RAET1E,NKG2D ligand 4 isoform 4 precursor,6414
NP_001001788.2,100865,149916911,149923010,-1,6,Homo_sapiens,RAET1G,retinoic acid early transcript 1G protein preproprotein,6099
NP_079493.1,100866,149942072,149947429,1,6,Homo_sapiens,ULBP2,NKG2D ligand 2 preproprotein,5357
NP_079494.1,100867,149964049,149970125,1,6,Homo_sapiens,ULBP1,NKG2D ligand 1 precursor,6076
NP_570970.2,100868,150020129,150025471,-1,6,Homo_sapiens,RAET1L,retinoic acid early transcript 1L protein precursor,5342
NP_078794.1,100869,150064606,150069066,-1,6,Homo_sapiens,ULBP3,NKG2D ligand 3 precursor,4460
NP_112211.1,100870,150143192,150248820,1,6,Homo_sapiens,PPP1R14C,protein phosphatase 1 regulatory subunit 14C,105628
NP_001158167.1,100871,150369031,150395450,1,6,Homo_sapiens,IYD,iodotyrosine dehalogenase 1 isoform 3,26419
XP_011534588.1,100872,150600290,150600887,1,6,Homo_sapiens,LOC105378056,uncharacterized protein LOC105378056,597
NP_001025055.1,100873,150733681,150840896,1,6,Homo_sapiens,PLEKHG1,pleckstrin homology domain-containing family G member 1,107215
NP_001229698.1,100874,150865822,150898907,1,6,Homo_sapiens,MTHFD1L,"monofunctional C1-tetrahydrofolate synthase, mitochondrial isoform 4 precursor",33085
NP_005091.2,100875,151240562,151353740,1,6,Homo_sapiens,AKAP12,A-kinase anchor protein 12 isoform 1,113178
NP_065912.1,100876,151365520,151373637,-1,6,Homo_sapiens,ZBTB2,zinc finger and BTB domain-containing protein 2,8117
NP_001258866.1,100877,151405234,151436548,-1,6,Homo_sapiens,RMND1,required for meiotic nuclear division protein 1 homolog isoform 2,31314
NP_078849.1,100878,151452545,151469110,1,6,Homo_sapiens,ARMT1,UPF0364 protein C6orf211 isoform a,16565
NP_079335.2,100879,151494128,151618147,1,6,Homo_sapiens,CCDC170,coiled-coil domain-containing protein 170,124019
NP_001278159.1,100880,151807912,152098966,1,6,Homo_sapiens,ESR1,estrogen receptor isoform 2,291054
NP_892006.3,100881,152122435,152628331,-1,6,Homo_sapiens,SYNE1,nesprin-1 isoform 1,505896
NP_079383.2,100882,152697902,152722253,1,6,Homo_sapiens,MYCT1,myc target protein 1,24351
NP_003372.1,100883,152752177,152757141,1,6,Homo_sapiens,VIP,VIP peptides isoform 1 preproprotein,4964
NP_001135994.1,100884,152971162,152975586,-1,6,Homo_sapiens,FBXO5,F-box only protein 5 isoform b,4424
NP_001288800.1,100885,152989894,152995232,-1,6,Homo_sapiens,MTRF1L,"peptide chain release factor 1-like, mitochondrial isoform 4",5338
NP_036551.3,100886,153011573,153044018,-1,6,Homo_sapiens,RGS17,regulator of G-protein signaling 17,32445
NP_001138753.1,100887,154010512,154118721,1,6,Homo_sapiens,OPRM1,mu-type opioid receptor isoform MOR-1G2,108209
NP_056368.1,100888,154159827,154265947,-1,6,Homo_sapiens,IPCEF1,interactor protein for cytohesin exchange factors 1 isoform 2,106120
NP_775786.2,100889,154406353,154510114,-1,6,Homo_sapiens,CNKSR3,connector enhancer of kinase suppressor of ras 3,103761
NP_001273117.1,100890,154733422,154833395,1,6,Homo_sapiens,SCAF8,protein SCAF8 isoform a,99973
NP_036586.2,100891,155129223,155257121,1,6,Homo_sapiens,TIAM2,T-lymphoma invasion and metastasis-inducing protein 2 isoform a,127898
NP_057104.2,100892,155257835,155314428,-1,6,Homo_sapiens,TFB1M,"dimethyladenosine transferase 1, mitochondrial",56593
NP_001001346.1,100893,155275719,155276379,1,6,Homo_sapiens,CLDN20,claudin-20 precursor,660
NP_056533.1,100894,155396835,155455800,-1,6,Homo_sapiens,NOX3,NADPH oxidase 3,58965
NP_065783.3,100895,156777929,157207891,1,6,Homo_sapiens,ARID1B,AT-rich interactive domain-containing protein 1B isoform 2,429962
NP_060922.2,100896,157292900,157323499,-1,6,Homo_sapiens,TMEM242,transmembrane protein 242,30599
NP_078906.2,100897,157382021,157673122,1,6,Homo_sapiens,ZDHHC14,probable palmitoyltransferase ZDHHC14 isoform 1,291101
NP_057308.1,100898,157823434,157942838,1,6,Homo_sapiens,SNX9,sorting nexin-9,119404
NP_003889.1,100899,157981961,158096364,1,6,Homo_sapiens,SYNJ2,synaptojanin-2 isoform 1,114403
NP_116250.3,100900,158111365,158158363,-1,6,Homo_sapiens,SERAC1,protein SERAC1,46998
NP_997001.1,100901,158170503,158192157,1,6,Homo_sapiens,GTF2H5,general transcription factor IIH subunit 5,21654
NP_001007467.1,100902,158314016,158506600,1,6,Homo_sapiens,TULP4,tubby-related protein 4 isoform 2,192584
NP_065874.1,100903,158536446,158631888,1,6,Homo_sapiens,TMEM181,transmembrane protein 181,95442
NP_001278531.1,100904,158636826,158644708,-1,6,Homo_sapiens,DYNLT1,dynein light chain Tctex-type 1 isoform 2,7882
NP_001229313.1,100905,158663268,158764604,1,6,Homo_sapiens,SYTL3,synaptotagmin-like protein 3 isoform 1,101336
NP_001104547.1,100906,158766913,158818093,-1,6,Homo_sapiens,EZR,ezrin,51180
NP_001181961.1,100907,158895235,158910213,1,6,Homo_sapiens,C6orf99,putative uncharacterized protein C6orf99,14978
NP_114130.3,100908,158977537,158999976,-1,6,Homo_sapiens,RSPH3,radial spoke head protein 3 homolog,22439
NP_687034.1,100909,159035826,159040775,-1,6,Homo_sapiens,TAGAP,T-cell activation Rho GTPase-activating protein isoform a,4949
NP_115921.2,100910,159169596,159271442,1,6,Homo_sapiens,FNDC1,fibronectin type III domain-containing protein 1 precursor,101846
NP_001019637.1,100911,159682492,159693167,-1,6,Homo_sapiens,SOD2,"superoxide dismutase [Mn], mitochondrial isoform B precursor",10675
NP_690596.1,100912,159736265,159748373,1,6,Homo_sapiens,WTAP,pre-mRNA-splicing regulator WTAP isoform 2,12108
NP_005882.2,100913,159762087,159778829,1,6,Homo_sapiens,ACAT2,"acetyl-CoA acetyltransferase, cytosolic isoform 1",16742
NP_001008897.1,100914,159779044,159785408,-1,6,Homo_sapiens,TCP1,T-complex protein 1 subunit alpha isoform b,6364
NP_054880.2,100915,159790587,159798123,1,6,Homo_sapiens,MRPL18,"39S ribosomal protein L18, mitochondrial",7536
NP_001258791.1,100916,159800307,159820517,1,6,Homo_sapiens,PNLDC1,poly(A)-specific ribonuclease PARN-like domain-containing protein 1 isoform 1,20210
NP_002368.1,100917,159906955,159907933,1,6,Homo_sapiens,MAS1,proto-oncogene Mas,978
NP_000867.2,100918,159969246,160105084,1,6,Homo_sapiens,IGF2R,cation-independent mannose-6-phosphate receptor precursor,135838
NP_694857.1,100919,160121935,160158551,1,6,Homo_sapiens,SLC22A1,solute carrier family 22 member 1 isoform b,36616
NP_003049.2,100920,160217431,160258757,-1,6,Homo_sapiens,SLC22A2,solute carrier family 22 member 2,41326
NP_068812.1,100921,160348419,160451056,1,6,Homo_sapiens,SLC22A3,solute carrier family 22 member 3,102637
NP_005568.2,100922,160531728,160664214,-1,6,Homo_sapiens,LPA,apolipoprotein(a) precursor,132486
NP_001161810.1,100923,160702304,160711195,1,6,Homo_sapiens,PLG,plasminogen isoform 2 precursor,8891
NP_005913.2,100924,160991931,161116870,1,6,Homo_sapiens,MAP3K4,mitogen-activated protein kinase kinase kinase 4 isoform a,124939
NP_064518.1,100925,161136539,161232213,-1,6,Homo_sapiens,AGPAT4,1-acyl-sn-glycerol-3-phosphate acyltransferase delta,95674
NP_054643.2,100926,161350098,162727668,-1,6,Homo_sapiens,PARK2,E3 ubiquitin-protein ligase parkin isoform 3,1377570
NP_689623.2,100927,162728235,163314987,1,6,Homo_sapiens,PACRG,parkin coregulated gene protein isoform 1,586752
XP_011534592.1,100928,163413205,163414114,1,6,Homo_sapiens,LOC105378101,basic proline-rich protein-like,909
NP_996737.1,100929,163415193,163563745,1,6,Homo_sapiens,QKI,protein quaking isoform 4,148552
XP_011534596.1,100930,164336993,164337788,1,6,Homo_sapiens,LOC105378107,uncharacterized protein LOC105378107,795
NP_659417.2,100931,165280056,165309586,-1,6,Homo_sapiens,C6orf118,uncharacterized protein C6orf118,29530
NP_001124162.1,100932,165333024,165662013,-1,6,Homo_sapiens,PDE10A,"cAMP and cAMP-inhibited cGMP 3',5'-cyclic phosphodiesterase 10A",328989
NP_001257413.1,100933,166158314,166167591,-1,6,Homo_sapiens,T,brachyury protein isoform 2,9277
NP_787118.2,100934,166307254,166308142,-1,6,Homo_sapiens,PRR18,proline-rich protein 18,888
NP_660152.1,100935,166320216,166342481,-1,6,Homo_sapiens,SFT2D1,vesicle transport protein SFT2A,22265
NP_001257808.1,100936,166365428,166366837,-1,6,Homo_sapiens,MPC1,mitochondrial pyruvate carrier 1 isoform 2,1409
NP_066958.2,100937,166412761,166627019,-1,6,Homo_sapiens,RPS6KA2,ribosomal protein S6 kinase alpha-2 isoform a,214258
NP_003721.2,100938,166929587,166956182,-1,6,Homo_sapiens,RNASET2,ribonuclease T2 precursor,26595
NP_008976.1,100939,166999412,167039978,1,6,Homo_sapiens,FGFR1OP,FGFR1 oncogene partner isoform a,40566
NP_004358.2,100940,167136134,167137355,1,6,Homo_sapiens,CCR6,C-C chemokine receptor type 6,1221
NP_005290.2,100941,167156871,167157831,-1,6,Homo_sapiens,GPR31,"12-(S)-hydroxy-5,8,10,14-eicosatetraenoic acid receptor",960
NP_001138593.1,100942,167172144,167181916,1,6,Homo_sapiens,TCP10L2,putative t-complex protein 10A homolog 2,9772
NP_061847.2,100943,167291489,167315452,1,6,Homo_sapiens,UNC93A,protein unc-93 homolog A isoform 1,23963
NP_114155.4,100944,167325173,167341679,1,6,Homo_sapiens,TTLL2,probable tubulin polyglutamylase TTLL2,16506
NP_004601.3,100945,167373168,167382873,-1,6,Homo_sapiens,TCP10,T-complex protein 10A homolog,9705
NP_001035089.1,100946,167827132,167962582,1,6,Homo_sapiens,MLLT4,afadin isoform 2,135450
NP_001123367.1,100947,167976136,167976652,-1,6,Homo_sapiens,HGC6.3,uncharacterized protein LOC100128124,516
NP_085118.2,100948,168029585,168044996,1,6,Homo_sapiens,KIF25,kinesin-like protein KIF25 isoform 1,15411
NP_001116313.1,100949,168057096,168075747,-1,6,Homo_sapiens,FRMD1,FERM domain-containing protein 1 isoform 2,18651
NP_001273280.1,100950,168293893,168319633,-1,6,Homo_sapiens,DACT2,dapper homolog 2 isoform c,25740
NP_071421.1,100951,168441370,168666438,1,6,Homo_sapiens,SMOC2,SPARC-related modular calcium-binding protein 2 isoform 1 precursor,225068
NP_003238.2,100952,169217821,169250784,-1,6,Homo_sapiens,THBS2,thrombospondin-2 precursor,32963
XP_011534602.1,100953,169330727,169340221,-1,6,Homo_sapiens,LOC105378148,uncharacterized protein LOC105378148,9494
NP_001189479.1,100954,169457583,169689005,-1,6,Homo_sapiens,WDR27,WD repeat-containing protein 27 isoform 2,231422
NP_001025034.1,100955,169702459,169703035,1,6,Homo_sapiens,C6orf120,UPF0669 protein C6orf120 precursor,576
NP_579866.2,100956,169704002,169723931,-1,6,Homo_sapiens,PHF10,PHD finger protein 10 isoform b,19929
NP_777570.1,100957,169740184,169751458,-1,6,Homo_sapiens,TCTE3,tctex1 domain-containing protein 3,11274
NP_001265460.1,100958,169751657,169781513,1,6,Homo_sapiens,ERMARD,endoplasmic reticulum membrane-associated RNA degradation protein isoform 2,29856
NP_005609.3,100959,170282873,170290139,-1,6,Homo_sapiens,DLL1,delta-like protein 1 precursor,7266
NP_001273308.1,100960,170291057,170404590,1,6,Homo_sapiens,FAM120B,constitutive coactivator of peroxisome proliferator-activated receptor gamma isoform a,113533
XP_011534610.1,100961,170461482,170463114,-1,6,Homo_sapiens,LOC105378161,uncharacterized protein LOC105378161,1632
NP_002784.1,100962,170535219,170553242,-1,6,Homo_sapiens,PSMB1,proteasome subunit beta type-1,18023
NP_003185.1,100963,170557029,170572265,1,6,Homo_sapiens,TBP,TATA-box-binding protein isoform 1,15236
NP_001186391.1,100964,170577558,170584581,-1,6,Homo_sapiens,PDCD2,programmed cell death protein 2 isoform 4,7023
NP_001073062.1,237364,2476202,2809093,-1,23,Bos_taurus,PRIM2,DNA primase large subunit,332891
NP_001193835.1,237365,2936080,2953601,1,23,Bos_taurus,RAB23,ras-related protein Rab-23,17521
NP_001029436.1,237366,2957953,2966813,-1,23,Bos_taurus,BAG2,BAG family molecular chaperone regulator 2,8860
NP_001179613.1,237367,2971788,3058877,-1,23,Bos_taurus,ZNF451,zinc finger protein 451,87089
XP_010816413.1,237368,3089798,3101566,-1,23,Bos_taurus,LOC104975635,uncharacterized protein LOC104975635,11768
NP_001192483.1,237369,3125703,3149209,-1,23,Bos_taurus,BEND6,BEN domain-containing protein 6,23506
XP_010816383.1,237370,3598757,3600695,1,23,Bos_taurus,LOC104975620,uncharacterized protein LOC104975620,1938
NP_001178122.1,237371,4709422,4906605,1,23,Bos_taurus,HMGCLL1,probable 3-hydroxymethyl-3-methylglutaryl-CoA lyase 2,197183
XP_002697218.1,237372,4937119,5011035,-1,23,Bos_taurus,GFRAL,GDNF family receptor alpha-like,73916
NP_001179606.1,237373,5043871,5175679,-1,23,Bos_taurus,HCRTR2,orexin receptor type 2,131808
NP_001192724.1,237374,5382147,5456386,-1,23,Bos_taurus,FAM83B,protein FAM83B,74239
NP_001030279.1,237375,5954017,6059880,-1,23,Bos_taurus,TINAG,tubulointerstitial nephritis antigen,105863
XP_010816401.1,237376,6516350,6528395,-1,23,Bos_taurus,LOC101904622,uncharacterized protein LOC101904622,12045
NP_001192398.1,237377,6530426,6666336,-1,23,Bos_taurus,LRRC1,leucine-rich repeat-containing protein 1,135910
NP_001095425.1,237378,6783411,6784602,1,23,Bos_taurus,KLHL31,kelch-like protein 31,1191
NP_001077143.1,237379,6922379,6965163,1,23,Bos_taurus,GCLC,glutamate--cysteine ligase catalytic subunit,42784
NP_001077254.1,237380,6975319,6990901,1,23,Bos_taurus,DSB,MHC class II antigen DS beta,15582
NP_001012696.1,237381,7011969,7016704,1,23,Bos_taurus,BOLA-DYA,"major histocompatibility complex, class II, DY alpha precursor",4735
NP_001012697.1,237382,7037656,7045301,-1,23,Bos_taurus,BOLA-DYB,"major histocompatibility complex, class II, DY beta precursor",7645
NP_001013618.1,237383,7054418,7063641,-1,23,Bos_taurus,BOLA-DOB,"HLA class II histocompatibility antigen, DO beta chain precursor",9223
NP_776647.1,237384,7079942,7086289,-1,23,Bos_taurus,TAP2,"transporter 2, ATP-binding cassette, sub-family B",6347
NP_001040087.1,237385,7102159,7108985,-1,23,Bos_taurus,LOC618733,"transporter 2, ATP-binding cassette, sub-family B",6826
NP_001035570.1,237386,7113530,7116653,-1,23,Bos_taurus,PSMB8,proteasome subunit beta type-8,3123
NP_001091527.1,237387,7118280,7126521,-1,23,Bos_taurus,TAP1,antigen peptide transporter 1,8241
NP_001029560.1,237388,7127111,7133556,1,23,Bos_taurus,PSMB9,proteasome subunit beta type-9 precursor,6445
NP_001108326.1,237389,7150820,7151201,1,23,Bos_taurus,H2B,histone H2B type 2-E,381
NP_001035571.1,237390,7187385,7193432,-1,23,Bos_taurus,BOLA-DMB,"major histocompatibility complex, class II, DM beta precursor",6047
NP_001012692.2,237391,7204349,7207030,1,23,Bos_taurus,BOLA-DMA,"HLA class II histocompatibility antigen, DM alpha chain precursor",2681
NP_001192849.1,237392,7218988,7264202,-1,23,Bos_taurus,BOLA-DOA,"HLA class II histocompatibility antigen, DO alpha chain precursor",45214
NP_001039331.1,237393,7240059,7247225,1,23,Bos_taurus,BRD2,bromodomain-containing protein 2,7166
NP_001039664.1,237394,7290454,7318840,-1,23,Bos_taurus,COL11A2,collagen alpha-2(XI) chain precursor,28386
NP_001077109.1,237395,7321253,7326765,-1,23,Bos_taurus,RXRB,retinoic acid receptor RXR-beta,5512
NP_001069705.2,237396,7327540,7331098,1,23,Bos_taurus,SLC39A7,zinc transporter SLC39A7 precursor,3558
NP_001039789.1,237397,7331904,7333829,1,23,Bos_taurus,HSD17B8,estradiol 17-beta-dehydrogenase 8,1925
NP_001098521.1,237398,7338398,7341191,1,23,Bos_taurus,RING1,E3 ubiquitin-protein ligase RING1,2793
NP_001179989.1,237399,7371501,7388338,-1,23,Bos_taurus,VPS52,vacuolar protein sorting-associated protein 52 homolog,16837
NP_001028786.1,237400,7388745,7393324,1,23,Bos_taurus,RPS18,40S ribosomal protein S18,4579
NP_001070565.1,237401,7394421,7395558,1,23,Bos_taurus,B3GALT4,"beta-1,3-galactosyltransferase 4 precursor",1137
NP_001015564.1,237402,7396283,7405420,-1,23,Bos_taurus,WDR46,WD repeat-containing protein 46,9137
NP_001068889.1,237403,7406076,7407024,1,23,Bos_taurus,PFDN6,prefoldin subunit 6,948
NP_001068622.1,237404,7408357,7414640,-1,23,Bos_taurus,RGL2,ral guanine nucleotide dissociation stimulator-like 2,6283
NP_001039350.1,237405,7416811,7425484,-1,23,Bos_taurus,TAPBP,tapasin precursor,8673
XP_005223345.1,237406,7426486,7428391,-1,23,Bos_taurus,ZBTB22,zinc finger and BTB domain-containing protein 22,1905
NP_001068623.1,237407,7430007,7433175,-1,23,Bos_taurus,DAXX,death domain-associated protein 6,3168
NP_001095406.1,237408,7512905,7527481,1,23,Bos_taurus,KIFC1,kinesin-like protein KIFC1,14576
NP_001092384.2,237409,7529643,7533769,1,23,Bos_taurus,PHF1,PHD finger protein 1,4126
NP_001068847.1,237410,7534316,7535286,-1,23,Bos_taurus,CUTA,protein CutA precursor,970
NP_001192395.1,237411,7537951,7566234,1,23,Bos_taurus,SYNGAP1,ras GTPase-activating protein SynGAP,28283
NP_001178391.1,237412,7569199,7570585,1,23,Bos_taurus,ZBTB9,zinc finger and BTB domain-containing protein 9,1386
NP_001071386.1,237413,7655891,7658885,-1,23,Bos_taurus,BAK1,bcl-2 homologous antagonist/killer,2994
NP_001092463.1,237414,7662116,7666998,1,23,Bos_taurus,LOC516410,gametogenetin-binding protein 1,4882
XP_003587712.2,237415,7675174,7679416,1,23,Bos_taurus,LOC100847319,uncharacterized protein LOC100847319,4242
NP_776795.1,237416,7687273,7756518,1,23,Bos_taurus,ITPR3,"inositol 1,4,5-trisphosphate receptor type 3",69245
NP_001193543.1,237417,7758195,7783928,-1,23,Bos_taurus,MNF1,uncharacterized protein C6orf125 homolog,25733
NP_001035632.2,237418,7797291,7810505,-1,23,Bos_taurus,IP6K3,ubiquinol-cytochrome-c reductase complex assembly factor 2,13214
NP_001179408.1,237419,7843194,7858338,-1,23,Bos_taurus,LEMD2,LEM domain-containing protein 2,15144
NP_776363.1,237420,7865269,7870112,-1,23,Bos_taurus,MLN,promotilin precursor,4843
NP_001069991.1,237421,8263647,8267618,1,23,Bos_taurus,HMGA1,high mobility group protein HMG-I/HMG-Y,3971
NP_001103917.1,237422,8269435,8270377,-1,23,Bos_taurus,LOC100126544,uncharacterized protein LOC100126544,942
NP_001075935.1,237423,8299345,8414435,-1,23,Bos_taurus,NUDT3,diphosphoinositol polyphosphate phosphohydrolase 1,115090
NP_001029888.1,237424,8434615,8440388,-1,23,Bos_taurus,RPS10,40S ribosomal protein S10,5773
NP_001094571.1,237425,8525929,8531878,1,23,Bos_taurus,PACSIN1,protein kinase C and casein kinase substrate in neurons protein 1,5949
NP_001075047.1,237426,8537857,8544735,-1,23,Bos_taurus,SPDEF,SAM pointed domain-containing Ets transcription factor,6878
NP_001069939.1,237427,8592159,8688735,-1,23,Bos_taurus,C23H6orf106,uncharacterized protein C6orf106 homolog,96576
NP_001069802.1,237428,8726741,8737181,-1,23,Bos_taurus,SNRPC,U1 small nuclear ribonucleoprotein C,10440
XP_002697244.2,237429,8756296,8824286,1,23,Bos_taurus,UHRF1BP1,UHRF1-binding protein 1,67990
NP_001029448.1,237430,8829704,8836752,-1,23,Bos_taurus,TAF11,transcription initiation factor TFIID subunit 11,7048
NP_001103549.1,237431,9023111,9051908,-1,23,Bos_taurus,TCP11,T-complex protein 11 homolog,28797
NP_001092464.1,237432,9237803,9263491,1,23,Bos_taurus,DEF6,differentially expressed in FDCP 6 homolog,25688
NP_001077105.1,237433,9340997,9353750,1,23,Bos_taurus,PPARD,peroxisome proliferator-activated receptor delta,12753
XP_010816439.1,237434,9370134,9379163,1,23,Bos_taurus,LOC104975636,probable E3 ubiquitin-protein ligase makorin-1,9029
NP_001179278.1,237435,9381625,9390135,1,23,Bos_taurus,FANCE,Fanconi anemia group E protein,8510
NP_001015647.1,237436,9391550,9393982,1,23,Bos_taurus,RPL10A,60S ribosomal protein L10a,2432
NP_001193657.1,237437,9422867,9437261,-1,23,Bos_taurus,TULP1,Tubby-related protein 1,14394
NP_001179791.1,237438,9523457,9593213,-1,23,Bos_taurus,FKBP5,peptidyl-prolyl cis-trans isomerase FKBP5,69756
XP_005223414.1,237439,9683972,9694015,1,23,Bos_taurus,ARMC12,armadillo repeat-containing protein 12,10043
XP_002697259.1,237440,9711821,9714190,1,23,Bos_taurus,CLPSL2,colipase-like protein 2,2369
XP_005228614.1,237441,9714878,9722001,1,23,Bos_taurus,CLPSL1,LOW QUALITY PROTEIN: colipase-like protein 1,7123
NP_001071435.1,237442,9723924,9726190,-1,23,Bos_taurus,CLPS,colipase precursor,2266
NP_001192875.1,237443,9733330,9742158,1,23,Bos_taurus,LHFPL5,tetraspan membrane protein of hair cell stereocilia,8828
XP_002697249.2,237444,9753394,9824588,-1,23,Bos_taurus,SRPK1,LOW QUALITY PROTEIN: SRSF protein kinase 1,71194
NP_001095600.1,237445,9853525,9935037,-1,23,Bos_taurus,SLC26A8,testis anion transporter 1,81512
NP_001095644.1,237446,9945204,10020848,1,23,Bos_taurus,MAPK14,mitogen-activated protein kinase 14,75644
NP_001014947.1,237447,10036740,10044800,1,23,Bos_taurus,MAPK13,mitogen-activated protein kinase 13,8060
NP_001192556.1,237448,10099946,10130192,1,23,Bos_taurus,BRPF3,bromodomain and PHD finger-containing protein 3,30246
NP_001092670.1,237449,10167496,10222306,1,23,Bos_taurus,PNPLA1,patatin-like phospholipase domain-containing protein 1,54810
XP_005223422.1,237450,10267716,10310552,1,23,Bos_taurus,LOC101902220,uncharacterized protein LOC101902220,42836
NP_001094563.1,237451,10376706,10388224,1,23,Bos_taurus,KCTD20,BTB/POZ domain-containing protein KCTD20,11518
NP_001075071.1,237452,10397543,10431778,-1,23,Bos_taurus,STK38,serine/threonine-protein kinase 38,34235
NP_001029872.1,237453,10483016,10487325,1,23,Bos_taurus,SRSF3,serine/arginine-rich splicing factor 3,4309
NP_001075891.1,237454,10528535,10529327,-1,23,Bos_taurus,RPS4Y1,40S ribosomal protein S4,792
NP_001092428.1,237455,10565064,10567022,1,23,Bos_taurus,CDKN1A,cyclin-dependent kinase inhibitor 1,1958
XP_003587720.1,237456,10627252,10628281,1,23,Bos_taurus,LOC520334,galanin receptor type 3-like,1029
NP_001192568.1,237457,10632881,10734548,-1,23,Bos_taurus,CPNE5,copine-5,101667
NP_001014869.1,237458,10749915,10769294,-1,23,Bos_taurus,PPIL1,peptidyl-prolyl cis-trans isomerase-like 1,19379
XP_005223417.1,237459,10785266,10808457,1,23,Bos_taurus,C23H6orf89,bombesin receptor-activated protein C6orf89 homolog,23191
NP_001019658.1,237460,10836849,10847835,1,23,Bos_taurus,PI16,peptidase inhibitor 16 precursor,10986
NP_001096775.1,237461,10854951,10873743,-1,23,Bos_taurus,MTCH1,mitochondrial carrier homolog 1,18792
NP_001069038.1,237462,10892239,10917998,1,23,Bos_taurus,FGD2,"FYVE, RhoGEF and PH domain-containing protein 2",25759
NP_776569.1,237463,11051838,11055416,-1,23,Bos_taurus,PIM1,serine/threonine-protein kinase pim-1,3578
NP_001073096.1,237464,11109986,11110565,-1,23,Bos_taurus,TMEM217,transmembrane protein 217,579
NP_001092618.1,237465,11133141,11205614,1,23,Bos_taurus,TBC1D22B,TBC1 domain family member 22B,72473
NP_001039681.1,237466,11229849,11266714,1,23,Bos_taurus,RNF8,E3 ubiquitin-protein ligase RNF8,36865
NP_001075899.1,237467,11305605,11355819,1,23,Bos_taurus,CMTR1,cap-specific mRNA (nucleoside-2'-O-)-methyltransferase 1,50214
NP_001073705.1,237468,11358397,11373667,-1,23,Bos_taurus,CCDC167,coiled-coil domain-containing protein 167,15270
NP_001179811.1,237469,11531142,11594184,-1,23,Bos_taurus,MDGA1,MAM domain-containing glycosylphosphatidylinositol anchor protein 1 precursor,63042
NP_001095615.1,237470,11712948,12038930,1,23,Bos_taurus,ZFAND3,AN1-type zinc finger protein 3,325982
NP_001121970.1,237471,12047050,12066121,-1,23,Bos_taurus,BTBD9,BTB/POZ domain-containing protein 9,19071
NP_001076965.1,237472,12484841,12509188,-1,23,Bos_taurus,GLO1,lactoylglutathione lyase,24347
XP_010816463.1,237473,12756146,12756620,1,23,Bos_taurus,LOC101904084,40S ribosomal protein S14-like,474
XP_010816464.1,237474,12908470,12940627,1,23,Bos_taurus,GLP1R,glucagon-like peptide 1 receptor,32157
NP_001033314.1,237475,12964618,12970995,-1,23,Bos_taurus,SAYSD1,SAYSvFN domain-containing protein 1,6377
NP_001178073.1,237476,13057052,13095305,-1,23,Bos_taurus,KCNK5,potassium channel subfamily K member 5,38253
NP_776983.1,237477,13160630,13172855,-1,23,Bos_taurus,KCNK17,potassium channel subfamily K member 17,12225
XP_003587722.1,237478,13175050,13181345,-1,23,Bos_taurus,KCNK16,potassium channel subfamily K member 16,6295
NP_001159769.1,237479,13833190,13866914,-1,23,Bos_taurus,MOCS1,molybdenum cofactor biosynthesis protein 1 isoform a,33724
NP_001179524.1,237480,14309127,14351087,-1,23,Bos_taurus,LRFN2,leucine-rich repeat and fibronectin type-III domain-containing protein 2 precursor,41960
XP_010816584.1,237481,14974417,14975436,1,23,Bos_taurus,TSPO2,translocator protein 2,1019
NP_001029527.1,237482,14985546,14994946,1,23,Bos_taurus,APOBEC2,probable C->U-editing enzyme APOBEC-2,9400
NP_001070581.1,237483,15000774,15005102,-1,23,Bos_taurus,OARD1,O-acetyl-ADP-ribose deacetylase 1,4328
NP_001014956.1,237484,15013685,15029907,1,23,Bos_taurus,NFYA,nuclear transcription factor Y subunit alpha,16222
NP_001073048.1,237485,15090366,15094707,-1,23,Bos_taurus,TREM2,triggering receptor expressed on myeloid cells 2 precursor,4341
NP_996853.1,237486,15148526,15163157,-1,23,Bos_taurus,TREM1,triggering receptor expressed on myeloid cells 1 precursor,14631
XP_010816585.1,237487,15192573,15196211,1,23,Bos_taurus,NCR2,LOW QUALITY PROTEIN: natural cytotoxicity triggering receptor 2,3638
XP_002697279.1,237488,15225632,15226337,-1,23,Bos_taurus,LOC783024,uncharacterized protein LOC783024,705
NP_001192453.1,237489,15391989,15423646,1,23,Bos_taurus,FOXP4,forkhead box protein P4,31657
NP_001192466.1,237490,15467449,15482104,1,23,Bos_taurus,MDFI,myoD family inhibitor,14655
NP_001192595.1,237491,15507709,15514007,-1,23,Bos_taurus,TFEB,transcription factor EB,6298
NP_001192720.1,237492,15544731,15568677,-1,23,Bos_taurus,PGC,gastricsin precursor,23946
NP_001092388.1,237493,15592630,15598158,-1,23,Bos_taurus,FRS3,fibroblast growth factor receptor substrate 3,5528
NP_001107190.1,237494,15609410,15610160,1,23,Bos_taurus,TOMM6,mitochondrial import receptor subunit TOM6 homolog,750
NP_001096763.1,237495,15687640,15696662,-1,23,Bos_taurus,MED20,mediator of RNA polymerase II transcription subunit 20,9022
NP_001014924.1,237496,15697194,15705885,1,23,Bos_taurus,BYSL,bystin,8691
NP_001029881.1,237497,15708570,15714284,-1,23,Bos_taurus,CCND3,G1/S-specific cyclin-D3,5714
NP_001094670.1,237498,15803563,15820671,1,23,Bos_taurus,TAF8,transcription initiation factor TFIID subunit 8,17108
XP_010816586.1,237499,15834899,15838651,-1,23,Bos_taurus,LOC104969745,uncharacterized protein LOC104969745,3752
NP_001070551.1,237500,15887225,15893213,1,23,Bos_taurus,MGC137036,uncharacterized protein LOC768024,5988
NP_776971.1,237501,15901354,15908049,1,23,Bos_taurus,GUCA1A,guanylyl cyclase-activating protein 1,6695
NP_777211.1,237502,15910681,15920974,-1,23,Bos_taurus,GUCA1B,guanylyl cyclase-activating protein 2,10293
NP_001030391.1,237503,15930317,15941557,-1,23,Bos_taurus,MRPS10,"28S ribosomal protein S10, mitochondrial",11240
NP_001179567.1,237504,16264296,16369924,1,23,Bos_taurus,UBR2,E3 ubiquitin-protein ligase UBR2,105628
NP_001159959.1,237505,16376477,16390351,-1,23,Bos_taurus,PRPH2,peripherin-2,13874
NP_001069177.1,237506,16406537,16407575,-1,23,Bos_taurus,TBCC,tubulin-specific chaperone C,1038
NP_001192709.1,237507,16478579,16509798,1,23,Bos_taurus,GLTSCR1L,GLTSCR1-like,31219
NP_001193230.1,237508,16520011,16524508,1,23,Bos_taurus,RPL7L1,60S ribosomal protein L7-like 1,4497
XP_002697289.1,237509,16541218,16541560,-1,23,Bos_taurus,C23H6orf226,uncharacterized protein C6orf226 homolog,342
NP_001069101.1,237510,16554188,16559231,1,23,Bos_taurus,PTCRA,pre T-cell antigen receptor alpha precursor,5043
NP_001068907.1,237511,16562967,16571110,1,23,Bos_taurus,CNPY3,protein canopy homolog 3 precursor,8143
NP_001193045.1,237512,16579608,16582852,1,23,Bos_taurus,GNMT,glycine N-methyltransferase,3244
NP_001179876.1,237513,16583614,16597347,-1,23,Bos_taurus,PEX6,peroxisome assembly factor 2,13733
NP_001193287.1,237514,16602270,16624415,1,23,Bos_taurus,PPP2R5D,serine/threonine-protein phosphatase 2A 56 kDa regulatory subunit delta isoform,22145
NP_777073.1,237515,16625595,16626515,-1,23,Bos_taurus,MEA1,male-enhanced antigen 1,920
NP_001014966.1,237516,16629725,16633148,1,23,Bos_taurus,KLHDC3,kelch domain-containing protein 3,3423
NP_001098949.1,237517,16634042,16637619,1,23,Bos_taurus,RRP36,ribosomal RNA processing protein 36 homolog,3577
XP_005223608.1,237518,16640985,16654717,-1,23,Bos_taurus,CUL7,cullin-7,13732
NP_001035617.2,237519,16656329,16660414,-1,23,Bos_taurus,MRPL2,"39S ribosomal protein L2, mitochondrial",4085
NP_001179894.1,237520,16677998,16739973,1,23,Bos_taurus,PTK7,inactive tyrosine-protein kinase 7 precursor,61975
NP_001192945.1,237521,16747957,16754379,1,23,Bos_taurus,SRF,serum response factor,6422
XP_010816567.1,237522,16795449,16797797,-1,23,Bos_taurus,DNPH1,LOW QUALITY PROTEIN: 2'-deoxynucleoside 5'-phosphate N-hydrolase 1,2348
NP_001094517.1,237523,16865903,16871554,1,23,Bos_taurus,SLC22A7,solute carrier family 22 member 7,5651
NP_001179618.1,237524,16872591,16875110,-1,23,Bos_taurus,CRIP3,cysteine-rich protein 3,2519
NP_001076963.1,237525,16981991,16985997,-1,23,Bos_taurus,DLK2,protein delta homolog 2 precursor,4006
NP_001179348.1,237526,17018937,17024703,1,23,Bos_taurus,TJAP1,tight junction-associated protein 1,5766
NP_001069687.1,237527,17031400,17035246,-1,23,Bos_taurus,YIPF3,protein YIPF3,3846
NP_001033213.1,237528,17035558,17042137,1,23,Bos_taurus,POLR1C,DNA-directed RNA polymerases I and III subunit RPAC1,6579
XP_002697347.2,237529,17044425,17085615,-1,23,Bos_taurus,XPO5,exportin-5,41190
NP_001029622.1,237530,17092571,17115947,1,23,Bos_taurus,POLH,DNA polymerase eta,23376
NP_001076890.1,237531,17119814,17126853,-1,23,Bos_taurus,GTPBP2,GTP-binding protein 2,7039
NP_001069849.1,237532,17131608,17135248,1,23,Bos_taurus,MAD2L1BP,MAD2L1-binding protein,3640
NP_001039732.1,237533,17138234,17151388,1,23,Bos_taurus,RSPH9,radial spoke head protein 9 homolog,13154
NP_001094699.1,237534,17152109,17168144,-1,23,Bos_taurus,MRPS18A,"28S ribosomal protein S18a, mitochondrial precursor",16035
NP_776641.1,237535,17260415,17269399,1,23,Bos_taurus,VEGFA,vascular endothelial growth factor A precursor,8984
XP_010816570.1,237536,17512651,17513651,1,23,Bos_taurus,C23H6orf223,LOW QUALITY PROTEIN: uncharacterized protein C6orf223 homolog,1000
NP_001178140.1,237537,17609852,17676785,-1,23,Bos_taurus,AARS2,"alanyl-tRNA synthetase, mitochondrial",66933
NP_001157411.1,237538,17663878,17797642,1,23,Bos_taurus,TMEM63B,transmembrane protein 63B,133764
NP_001029570.2,237539,17846050,17855653,1,23,Bos_taurus,SLC29A1,equilibrative nucleoside transporter 1,9603
NP_001073105.1,237540,17868994,17873174,1,23,Bos_taurus,HSP90AB1,heat shock protein HSP 90-beta,4180
NP_001070433.1,237541,17875755,17878469,-1,23,Bos_taurus,SLC35B2,adenosine 3'-phospho 5'-phosphosulfate transporter 1 precursor,2714
NP_001124218.1,237542,17880438,17886997,-1,23,Bos_taurus,NFKBIE,NF-kappa-B inhibitor epsilon,6559
NP_001192792.1,237543,17891618,17895776,1,23,Bos_taurus,TMEM151B,transmembrane protein 151B,4158
NP_001098478.1,237544,18223259,18611124,-1,23,Bos_taurus,SUPT3H,transcription initiation protein SPT3 homolog,387865
NP_776701.1,237545,19167448,19333118,-1,23,Bos_taurus,CLIC5,chloride intracellular channel protein 5,165670
NP_001075004.1,237546,19375919,19380975,1,23,Bos_taurus,ENPP4,bis(5'-adenosyl)-triphosphatase ENPP4 precursor,5056
NP_001193653.1,237547,19388632,19395174,-1,23,Bos_taurus,ENPP5,ectonucleotide pyrophosphatase/phosphodiesterase family member 5 precursor,6542
NP_001092408.1,237548,19777772,19860182,-1,23,Bos_taurus,CYP39A1,24-hydroxycholesterol 7-alpha-hydroxylase,82410
NP_001193123.1,237549,19860794,19882600,1,23,Bos_taurus,SLC25A27,mitochondrial uncoupling protein 4,21806
NP_001179259.1,237550,19892714,19903575,1,23,Bos_taurus,TDRD6,tudor domain-containing protein 6,10861
NP_777003.2,237551,19907187,19928621,-1,23,Bos_taurus,PLA2G7,platelet-activating factor acetylhydrolase precursor,21434
XP_010816580.1,237552,20014169,20040232,1,23,Bos_taurus,MEP1A,LOW QUALITY PROTEIN: meprin A subunit alpha,26063
NP_001180172.1,237553,20053545,20110595,-1,23,Bos_taurus,GPR116,probable G-protein coupled receptor 116,57050
NP_001179256.1,237554,20206492,20236403,-1,23,Bos_taurus,GPR110,probable G-protein coupled receptor 110,29911
XP_002697352.4,237555,20383917,20384229,1,23,Bos_taurus,LOC100296156,peptidyl-prolyl cis-trans isomerase A,312
NP_001070379.1,237556,20412019,20474574,-1,23,Bos_taurus,TNFRSF21,tumor necrosis factor receptor superfamily member 21,62555
NP_001193468.1,237557,20597063,20680179,1,23,Bos_taurus,CD2AP,CD2-associated protein,83116
NP_001178191.1,237558,20708928,20731119,1,23,Bos_taurus,GPR111,probable G-protein coupled receptor 111 precursor,22191
NP_001137347.1,237559,20745535,20758331,1,23,Bos_taurus,GPR115,probable G-protein coupled receptor 115 precursor,12796
NP_001193009.1,237560,20801931,20834318,1,23,Bos_taurus,OPN5,opsin-5,32387
NP_001095613.1,237561,21090639,21091248,-1,23,Bos_taurus,PTCHD4,patched domain-containing protein C6orf138 homolog,609
NP_776364.2,237562,21938807,21972915,-1,23,Bos_taurus,MUT,"methylmalonyl-CoA mutase, mitochondrial precursor",34108
NP_001071533.1,237563,21985013,21997135,1,23,Bos_taurus,CENPQ,centromere protein Q,12122
NP_001138533.1,237564,22011841,22024395,1,23,Bos_taurus,GLYATL3,glycine N-acyltransferase-like protein 3,12554
NP_001139125.1,237565,22040538,22041105,1,23,Bos_taurus,C23H6orf141,uncharacterized protein LOC100271839,567
NP_776596.1,237566,22088890,22109630,-1,23,Bos_taurus,RHAG,ammonium transporter Rh type A,20740
NP_001033178.1,237567,22131367,22146648,-1,23,Bos_taurus,CRISP2,cysteine-rich secretory protein 2 precursor,15281
NP_001073103.1,237568,22164420,22178460,-1,23,Bos_taurus,CRISP3,cysteine-rich secretory protein 3 precursor,14040
NP_001116507.1,237569,22221076,22222330,-1,23,Bos_taurus,PGK2,phosphoglycerate kinase 2,1254
NP_001193188.1,237570,22245232,22261583,-1,23,Bos_taurus,CRISP1,cysteine-rich secretory protein 1 precursor,16351
XP_010816582.1,237571,22351775,22353313,-1,23,Bos_taurus,DEFB113,beta-defensin 113,1538
XP_002697354.1,237572,22369893,22374864,-1,23,Bos_taurus,DEFB110,beta-defensin 110,4971
XP_010816583.1,237573,22381952,22389609,-1,23,Bos_taurus,DEFB112,beta-defensin 112,7657
NP_001179258.1,237574,22998427,23057489,1,23,Bos_taurus,TFAP2D,transcription factor AP-2-delta,59062
NP_001069715.1,237575,23097807,23122686,1,23,Bos_taurus,TFAP2B,transcription factor AP-2-beta,24879
NP_001008412.1,237576,24347044,24350010,1,23,Bos_taurus,IL17A,interleukin-17A precursor,2966
NP_001179011.1,237577,24391184,24397891,-1,23,Bos_taurus,IL17F,interleukin-17F precursor,6707
NP_001013604.2,237578,24439485,24456276,-1,23,Bos_taurus,MCM3,DNA replication licensing factor MCM3,16791
NP_001094605.1,237579,24567893,24568958,1,23,Bos_taurus,PAQR8,membrane progestin receptor beta,1065
NP_001179173.1,237580,24588128,24627606,1,23,Bos_taurus,EFHC1,EF-hand domain-containing protein 1,39478
NP_001180079.1,237581,24638149,24702830,-1,23,Bos_taurus,TRAM2,translocating chain-associated membrane protein 2,64681
NP_001029551.1,237582,24807975,24813528,1,23,Bos_taurus,TMEM14A,transmembrane protein 14A,5553
NP_803481.1,237583,24823887,24831484,-1,23,Bos_taurus,GSTA2,glutathione S-transferase A2,7597
NP_001071617.1,237584,24875680,24883511,-1,23,Bos_taurus,GSTA3,glutathione S-transferase A1,7831
NP_001092486.1,237585,24895015,24909300,-1,23,Bos_taurus,GSTA5,glutathione S-transferase A5,14285
NP_001070580.1,237586,24935716,24948163,-1,23,Bos_taurus,GSTA3,glutathione S-transferase A4,12447
NP_001015651.1,237587,24963701,24976300,-1,23,Bos_taurus,GSTA4,glutathione S-transferase A4,12599
NP_001092357.1,237588,24984469,25012392,-1,23,Bos_taurus,ICK,serine/threonine-protein kinase ICK,27923
NP_001029584.1,237589,25030689,25051289,1,23,Bos_taurus,FBXO9,F-box only protein 9,20600
NP_001179034.1,237590,25067220,25084501,-1,23,Bos_taurus,GCM1,chorion-specific transcription factor GCMa,17281
NP_001040062.1,237591,25157473,25186845,-1,23,Bos_taurus,ELOVL5,elongation of very long chain fatty acids protein 5,29372
XP_005223624.1,237592,25351285,25356908,-1,23,Bos_taurus,BOLA-DQA2,"major histocompatibility complex, class II, DQ alpha 2",5623
NP_001012694.2,237593,25375347,25388103,1,23,Bos_taurus,BOLA-DQB,"major histocompatibility complex, class II, DQ beta precursor",12756
NP_001012693.2,237594,25405112,25411578,-1,23,Bos_taurus,BOLA-DQA5,"major histocompatibility complex, class II, DQ alpha 5 precursor",6466
XP_003587740.1,237595,25426572,25430097,-1,23,Bos_taurus,LOC100848815,"LOW QUALITY PROTEIN: SLA class II histocompatibility antigen, DQ haplotype D alpha chain-like",3525
NP_001012698.2,237596,25472160,25476537,1,23,Bos_taurus,BOLA-DRB3,"major histocompatibility complex, class II, DRB3 precursor",4377
NP_001013619.3,237597,25489989,25490245,-1,23,Bos_taurus,BOLA-DQA1,"major histocompatibility complex, class II, DQ alpha, type 1 precursor",256
NP_001012695.1,237598,25588639,25592144,-1,23,Bos_taurus,BOLA-DRA,"major histocompatibility complex, class II, DR alpha precursor",3505
NP_001095821.1,237599,25618595,25631944,1,23,Bos_taurus,BTNL2,butyrophilin-like protein 2,13349
NP_001075192.1,237600,25634966,25642597,-1,23,Bos_taurus,LOC525599,butyrophilin family member precursor,7631
NP_001029379.1,237601,25649539,25656197,1,23,Bos_taurus,LOC504295,butyrophilin-like protein 1 precursor,6658
NP_001029840.2,237602,25855492,25862994,-1,23,Bos_taurus,BLA-DQB,"boLa class II histocompatibility antigen, DQB*0101 beta chain precursor",7502
XP_010799068.1,237603,26354038,26355880,-1,23,Bos_taurus,LOC790332,butyrophilin subfamily 1 member A1,1842
XP_010816604.1,237604,26518729,26528723,1,23,Bos_taurus,LOC104975659,butyrophilin subfamily 1 member A1-like,9994
NP_001193877.1,237605,26973190,26998620,1,23,Bos_taurus,NOTCH4,neurogenic locus notch homolog protein 4 precursor,25430
XP_002697418.2,237606,27000655,27001800,1,23,Bos_taurus,GPSM3,G-protein-signaling modulator 3,1145
NP_001243812.1,237607,27003268,27006729,1,23,Bos_taurus,PBX2,pre-B-cell leukemia transcription factor 2,3461
NP_776407.1,237608,27008849,27011781,1,23,Bos_taurus,AGER,advanced glycosylation end product-specific receptor precursor,2932
NP_001098915.1,237609,27012545,27014357,-1,23,Bos_taurus,RNF5,E3 ubiquitin-protein ligase RNF5,1812
NP_803484.1,237610,27021362,27023483,1,23,Bos_taurus,AGPAT1,1-acyl-sn-glycerol-3-phosphate acyltransferase alpha precursor,2121
NP_001092657.1,237611,27024789,27026621,-1,23,Bos_taurus,EGFL8,epidermal growth factor-like protein 8 precursor,1832
NP_001030395.2,237612,27028828,27035444,-1,23,Bos_taurus,PPT2,lysosomal thioesterase PPT2 precursor,6616
NP_001070415.1,237613,27038297,27040649,1,23,Bos_taurus,PRRT1,proline-rich transmembrane protein 1,2352
NP_001095452.1,237614,27056298,27057274,1,23,Bos_taurus,FKBPL,FK506-binding protein-like,976
NP_001077152.1,237615,27057896,27067313,1,23,Bos_taurus,ATF6B,cyclic AMP-dependent transcription factor ATF-6 beta,9417
NP_001013614.1,237616,27083668,27085376,1,23,Bos_taurus,CYP21,steroid 21-hydroxylase,1708
NP_001159957.1,237617,27136685,27147395,-1,23,Bos_taurus,C4A,complement C4 precursor,10710
NP_001091466.1,237618,27199777,27206513,-1,23,Bos_taurus,STK19,serine/threonine-protein kinase 19,6736
NP_001014872.2,237619,27207267,27209706,1,23,Bos_taurus,DXO,decapping and exoribonuclease protein,2439
NP_001069672.1,237620,27219882,27225046,1,23,Bos_taurus,NELFE,negative elongation factor E,5164
NP_001035616.1,237621,27225317,27231182,-1,23,Bos_taurus,CFB,complement factor B precursor,5865
NP_001029664.1,237622,27232001,27243331,-1,23,Bos_taurus,C2,complement C2 precursor,11330
XP_005223753.1,237623,27274033,27275413,1,23,Bos_taurus,ZBTB12,zinc finger and BTB domain-containing protein 12,1380
NP_001193192.1,237624,27277595,27291159,1,23,Bos_taurus,EHMT2,histone-lysine N-methyltransferase EHMT2,13564
NP_001076911.1,237625,27291972,27305226,1,23,Bos_taurus,SLC44A4,choline transporter-like protein 4,13254
NP_001077111.1,237626,27305749,27309102,1,23,Bos_taurus,NEU1,sialidase-1 precursor,3353
NP_976067.2,237627,27331772,27333698,-1,23,Bos_taurus,HSPA1A,heat shock 70 kDa protein 1B,1926
NP_001161367.1,237628,27336058,27337984,1,23,Bos_taurus,HSPA1L,heat shock 70 kDa protein 1-like,1926
NP_001094647.1,237629,27339721,27344137,1,23,Bos_taurus,LSM2,U6 snRNA-associated Sm-like protein LSm2,4416
NP_001068674.1,237630,27356280,27364477,-1,23,Bos_taurus,VWA7,von Willebrand factor A domain-containing protein 7 precursor,8197
NP_001075936.1,237631,27374662,27375211,-1,23,Bos_taurus,SAPCD1,protein G7d,549
NP_001192428.1,237632,27376010,27389175,-1,23,Bos_taurus,MSH5,mutS protein homolog 5,13165
NP_001015608.1,237633,27393514,27398704,1,23,Bos_taurus,CLIC1,chloride intracellular channel protein 1,5190
NP_001029876.1,237634,27400387,27402628,1,23,Bos_taurus,DDAH2,"N(G),N(G)-dimethylarginine dimethylaminohydrolase 2",2241
NP_001071549.1,237635,27404677,27406348,-1,23,Bos_taurus,C23H6orf25,protein G6b precursor,1671
NP_001071324.1,237636,27407664,27409835,1,23,Bos_taurus,LY6G6C,lymphocyte antigen 6 complex locus protein G6c precursor,2171
NP_001074989.1,237637,27414664,27415981,1,23,Bos_taurus,LY6G6E,"lymphocyte antigen 6 complex, locus G6E precursor",1317
NP_001069662.1,237638,27417917,27420583,-1,23,Bos_taurus,LY6G6F,lymphocyte antigen 6 complex locus protein G6f precursor,2666
NP_001069073.1,237639,27423467,27435476,1,23,Bos_taurus,ABHD16A,abhydrolase domain-containing protein 16A,12009
XP_010816698.1,237640,27440559,27442830,1,23,Bos_taurus,LY6G5C,lymphocyte antigen 6 complex locus protein G5c,2271
NP_001179131.1,237641,27445629,27446642,-1,23,Bos_taurus,LY6G5B,lymphocyte antigen 6 complex locus protein G5b precursor,1013
NP_001039919.1,237642,27447650,27450752,-1,23,Bos_taurus,CSNK2B,casein kinase II subunit beta,3102
NP_001069936.1,237643,27453294,27454932,1,23,Bos_taurus,GPANK1,G patch domain and ankyrin repeat-containing protein 1,1638
NP_001094737.1,237644,27457507,27458401,1,23,Bos_taurus,C23H6orf47,uncharacterized protein C6orf47 homolog,894
NP_001029429.2,237645,27459385,27461297,-1,23,Bos_taurus,APOM,apolipoprotein M precursor,1912
NP_001068834.2,237646,27464366,27474569,1,23,Bos_taurus,BAG6,large proline-rich protein BAG6,10203
NP_001192486.1,237647,27475780,27488714,-1,23,Bos_taurus,PRRC2A,protein PRRC2A,12934
NP_776410.1,237648,27503302,27505358,-1,23,Bos_taurus,AIF1,allograft inflammatory factor 1,2056
NP_001035614.1,237649,27521487,27523736,1,23,Bos_taurus,NCR3,natural cytotoxicity triggering receptor 3 precursor,2249
NP_776391.2,237650,27534701,27536481,-1,23,Bos_taurus,TNF,tumor necrosis factor,1780
NP_001013419.1,237651,27538543,27539457,-1,23,Bos_taurus,LTA,lymphotoxin-alpha precursor,914
NP_001015597.1,237652,27550805,27560565,-1,23,Bos_taurus,NFKBIL1,NF-kappa-B inhibitor-like protein 1,9760
NP_001069132.1,237653,27561650,27562821,1,23,Bos_taurus,ATP6V1G2,V-type proton ATPase subunit G 2,1171
NP_001028801.1,237654,27567309,27576518,1,23,Bos_taurus,DDX39B,spliceosome RNA helicase DDX39B,9209
XP_002697394.1,237655,27576912,27578064,-1,23,Bos_taurus,MCCD1,mitochondrial coiled-coil domain protein 1,1152
XP_010816685.1,237656,27600072,27602201,1,23,Bos_taurus,MGC126945,LOW QUALITY PROTEIN: uncharacterized protein LOC767904,2129
NP_001035644.1,237657,27647098,27692393,1,23,Bos_taurus,BOLA-A,"major histocompatibility complex, class I, A precursor",45295
NP_001120789.1,237658,27659408,27729696,-1,23,Bos_taurus,MIC1,major histocompatibility class I related protein precursor,70288
NP_777005.1,237659,27769892,27774392,1,23,Bos_taurus,POU5F1,"POU domain, class 5, transcription factor 1",4500
NP_001077153.1,237660,27776232,27778556,-1,23,Bos_taurus,TCF19,transcription factor 19,2324
NP_001019707.1,237661,27780957,27791106,1,23,Bos_taurus,CCHCR1,coiled-coil alpha-helical rod protein 1,10149
NP_001073843.1,237662,27793301,27794338,1,23,Bos_taurus,PSORS1C2,psoriasis susceptibility 1 candidate gene 2 protein precursor,1037
NP_001071418.1,237663,27808500,27812246,1,23,Bos_taurus,CDSN,corneodesmosin precursor,3746
NP_001193388.1,237664,27842301,27845887,1,23,Bos_taurus,LOC616942,"major histocompatibility complex, class I, A-like precursor",3586
XP_002697398.4,237665,27908223,27912268,-1,23,Bos_taurus,MUC21,mucin-21,4045
NP_001107995.1,237666,27945614,27946212,1,23,Bos_taurus,SFTA2,surfactant-associated protein 2 precursor,598
NP_001243473.1,237667,27949848,27961390,-1,23,Bos_taurus,VARS2,"valine--tRNA ligase, mitochondrial",11542
NP_001094527.1,237668,27962286,27967930,-1,23,Bos_taurus,GTF2H4,general transcription factor IIH subunit 4,5644
NP_001069480.2,237669,27976470,27986825,-1,23,Bos_taurus,DDR1,epithelial discoidin domain-containing receptor 1 precursor,10355
NP_001068670.1,237670,28088485,28089056,1,23,Bos_taurus,IER3,radiation-inducible immediate-early gene IEX-1,571
NP_001070355.1,237671,28090672,28099794,1,23,Bos_taurus,FLOT1,flotillin-1,9122
NP_001040014.1,237672,28101901,28105152,-1,23,Bos_taurus,TUBB,tubulin beta-5 chain,3251
XP_010816699.1,237673,28109833,28111616,1,23,Bos_taurus,LOC100336520,uncharacterized protein LOC100336520,1783
NP_001032685.1,237674,28112227,28114509,-1,23,Bos_taurus,NRM,nurim,2282
NP_001070387.1,237675,28128502,28136174,1,23,Bos_taurus,PPP1R18,phostensin,7672
NP_001193139.1,237676,28140392,28152392,1,23,Bos_taurus,DHX16,putative pre-mRNA-splicing factor ATP-dependent RNA helicase DHX16,12000
NP_001033267.1,237677,28152846,28156283,-1,23,Bos_taurus,C23H6orf136,uncharacterized protein C6orf136 homolog,3437
NP_001263252.1,237678,28156840,28169399,-1,23,Bos_taurus,ATAT1,alpha-tubulin N-acetyltransferase 1,12559
NP_001033613.1,237679,28170189,28176461,-1,23,Bos_taurus,MRPS18B,"28S ribosomal protein S18b, mitochondrial",6272
NP_001137335.1,237680,28183953,28192535,1,23,Bos_taurus,PPP1R10,serine/threonine-protein phosphatase 1 regulatory subunit 10,8582
NP_001193838.1,237681,28199128,28211313,-1,23,Bos_taurus,ABCF1,ATP-binding cassette sub-family F member 1,12185
NP_001029726.1,237682,28219794,28223657,-1,23,Bos_taurus,PRR3,proline-rich protein 3,3863
NP_001096742.1,237683,28224817,28231252,1,23,Bos_taurus,GNL1,guanine nucleotide-binding protein-like 1,6435
XP_003587749.2,237684,28262694,28271496,-1,23,Bos_taurus,LOC615278,E3 ubiquitin-protein ligase TRIM39,8802
NP_001070309.1,237685,28299512,28307097,1,23,Bos_taurus,LOC512672,"major histocompatibility complex, class I precursor",7585
NP_001099086.1,237686,28355357,28358325,-1,23,Bos_taurus,BOLA-NC1,non-classical MHC class I antigen precursor,2968
NP_001035588.1,237687,28470055,28473371,-1,23,Bos_taurus,JSP.1,MHC Class I JSP.1 precursor,3316
NP_001033607.1,237688,28502825,28506291,-1,23,Bos_taurus,BOLA,MHC class I heavy chain isoform 1 precursor,3466
XP_002697385.1,237689,28570977,28579480,1,23,Bos_taurus,LOC785873,tripartite motif-containing protein 26,8503
NP_001192693.1,237690,28600574,28610886,-1,23,Bos_taurus,TRIM15,tripartite motif-containing protein 15,10312
NP_001015607.1,237691,28614283,28622043,1,23,Bos_taurus,TRIM10,tripartite motif-containing protein 10,7760
NP_001096776.1,237692,28626338,28638013,-1,23,Bos_taurus,TRIM40,tripartite motif-containing protein 40,11675
XP_003587753.3,237693,28702051,28706450,1,23,Bos_taurus,RNF39,LOW QUALITY PROTEIN: RING finger protein 39,4399
NP_001093765.1,237694,28708301,28710184,-1,23,Bos_taurus,PPP1R11,protein phosphatase 1 regulatory subunit 11,1883
NP_001039865.1,237695,28714663,28717599,-1,23,Bos_taurus,ZNRD1,DNA-directed RNA polymerase I subunit RPA12,2936
XP_005223769.1,237696,28721454,28723608,1,23,Bos_taurus,LOC101907137,putative uncharacterized protein ZNRD1-AS1,2154
NP_001013602.1,237697,28740641,28750890,-1,23,Bos_taurus,MOG,myelin-oligodendrocyte glycoprotein precursor,10249
NP_001156747.1,237698,28775568,28802663,1,23,Bos_taurus,GABBR1,gamma-aminobutyric acid type B receptor subunit 1 isoform 1 precursor,27095
XP_010816715.1,237699,28855478,28855826,-1,23,Bos_taurus,LOC104975671,ubiquitin D-like,348
XP_002697423.1,237700,28873685,28875436,-1,23,Bos_taurus,LOC504548,ubiquitin D,1751
XP_010816709.1,237701,28889173,28890127,-1,23,Bos_taurus,LOC506486,olfactory receptor 2H1,954
NP_001193402.1,237702,28918458,28920198,1,23,Bos_taurus,UBD,ubiquitin D,1740
XP_002697446.1,237703,28955605,28956565,-1,23,Bos_taurus,LOC523768,olfactory receptor 6Q1,960
XP_002697447.1,237704,28967932,28968892,1,23,Bos_taurus,LOC523769,olfactory receptor 11A1,960
XP_002697449.2,237705,28992087,28993017,-1,23,Bos_taurus,LOC786846,olfactory receptor 1361,930
XP_002697450.1,237706,29004624,29005551,-1,23,Bos_taurus,LOC785910,olfactory receptor 12D2,927
XP_002697427.1,237707,29032405,29033332,-1,23,Bos_taurus,LOC785811,olfactory receptor 12D2,927
XP_002697454.1,237708,29038752,29039682,-1,23,Bos_taurus,LOC785779,olfactory receptor 1361,930
XP_003587759.1,237709,29071804,29072731,-1,23,Bos_taurus,LOC616306,olfactory receptor 12D2-like,927
XP_002707831.2,237710,29078909,29079824,-1,23,Bos_taurus,LOC785712,olfactory receptor 12D2,915
XP_002697432.1,237711,29092561,29093488,-1,23,Bos_taurus,LOC785639,olfactory receptor 12D2,927
NP_001091852.1,237712,29107825,29108752,-1,23,Bos_taurus,OR12D2,"olfactory receptor, family 12, subfamily D, member 2",927
XP_003587755.2,237713,29122353,29123280,-1,23,Bos_taurus,LOC785582,olfactory receptor 12D2-like,927
XP_002697457.1,237714,29143550,29144498,1,23,Bos_taurus,LOC514434,olfactory receptor 5V1,948
XP_002697434.1,237715,29149973,29150924,1,23,Bos_taurus,OR12D3,olfactory receptor 12D3,951
XP_002697458.2,237716,29157653,29158610,1,23,Bos_taurus,LOC512579,olfactory receptor 12D3,957
XP_002697435.1,237717,29176695,29177619,1,23,Bos_taurus,LOC785431,olfactory receptor 5V1,924
XP_002697436.1,237718,29186919,29187873,1,23,Bos_taurus,OR5V1,olfactory receptor 5V1,954
XP_002697437.2,237719,29206926,29207889,-1,23,Bos_taurus,OR14J1,olfactory receptor 14J1,963
XP_005223773.1,237720,29212490,29213456,-1,23,Bos_taurus,LOC510530,olfactory receptor 14J1,966
XP_002697438.1,237721,29223811,29224756,-1,23,Bos_taurus,LOC618052,olfactory receptor 2B2,945
XP_002697461.3,237722,29241748,29242690,-1,23,Bos_taurus,LOC785277,olfactory receptor 2G3,942
XP_002697463.3,237723,29280760,29281693,1,23,Bos_taurus,LOC618064,olfactory receptor 2G3,933
XP_002697464.1,237724,29290562,29291495,1,23,Bos_taurus,LOC785162,olfactory receptor 2G3,933
XP_010816714.1,237725,29299941,29300874,1,23,Bos_taurus,LOC516273,olfactory receptor 2G6-like,933
XP_002697466.1,237726,29314809,29315760,1,23,Bos_taurus,LOC516274,olfactory receptor 2G3,951
XP_002697467.1,237727,29327102,29328065,-1,23,Bos_taurus,LOC618070,putative olfactory receptor 2B8,963
XP_002697468.1,237728,29349631,29350570,1,23,Bos_taurus,LOC782341,olfactory receptor 2W1,939
XP_002697469.1,237729,29360767,29361715,1,23,Bos_taurus,LOC782301,olfactory receptor 2W1,948
XP_002697471.1,237730,29387308,29388250,1,23,Bos_taurus,LOC515704,putative olfactory receptor 2B3,942
XP_002697440.1,237731,29403152,29403978,1,23,Bos_taurus,LOC785479,non-histone chromosomal protein HMG-14,826
XP_002697474.2,237732,29411405,29412041,-1,23,Bos_taurus,LOC509155,protein FAM177A1,636
XP_002697484.1,237733,29451996,29452938,1,23,Bos_taurus,LOC784652,putative olfactory receptor 2B3,942
XP_002697485.1,237734,29462781,29463723,1,23,Bos_taurus,LOC784681,olfactory receptor 2B11,942
XP_002697486.1,237735,29480529,29481468,1,23,Bos_taurus,LOC528343,olfactory receptor 2B6,939
XP_002697487.1,237736,29503334,29504264,-1,23,Bos_taurus,OR2J3,olfactory receptor 2J3,930
XP_010816718.1,237737,29540766,29541693,-1,23,Bos_taurus,LOC511103,olfactory receptor 2J3,927
XP_002697490.1,237738,29552974,29553937,1,23,Bos_taurus,LOC784858,olfactory receptor 10C1,963
XP_002697478.3,237739,29581501,29582479,1,23,Bos_taurus,LOC789367,olfactory receptor 10C1,978
XP_002697479.3,237740,29593367,29594291,-1,23,Bos_taurus,LOC789358,olfactory receptor 2J3,924
XP_003587760.1,237741,29622275,29623226,1,23,Bos_taurus,LOC788675,olfactory receptor 10C1-like,951
XP_010816722.1,237742,29632637,29633571,1,23,Bos_taurus,LOC788663,LOW QUALITY PROTEIN: olfactory receptor 2B11-like,934
XP_010816719.1,237743,29636610,29637537,-1,23,Bos_taurus,LOC618140,olfactory receptor 2J3-like,927
XP_010816721.1,237744,29678972,29679926,1,23,Bos_taurus,LOC509280,olfactory receptor 2W1,954
XP_002697483.1,237745,29698015,29698978,1,23,Bos_taurus,OR2W1,olfactory receptor 2W1,963
XP_010816738.1,237746,29764538,29765510,1,23,Bos_taurus,LOC782475,putative olfactory receptor 2W6,972
XP_002697522.1,237747,29784663,29785587,1,23,Bos_taurus,LOC782554,putative olfactory receptor 2W6,924
NP_001069267.1,237748,29906705,29920283,1,23,Bos_taurus,TRIM27,zinc finger protein RFP,13578
NP_001070606.1,237749,30080783,30090123,1,23,Bos_taurus,ZSCAN12,zinc finger and SCAN domain-containing protein 12,9340
NP_001039702.1,237750,30121195,30123823,1,23,Bos_taurus,ZSCAN31,zinc finger protein 323,2628
NP_001069642.1,237751,30154311,30154773,-1,23,Bos_taurus,PGBD1,piggyBac transposable element-derived protein 1,462
NP_001095427.1,237752,30161122,30166332,-1,23,Bos_taurus,ZSCAN26,zinc finger and SCAN domain-containing protein 26,5210
NP_001095968.1,237753,30178136,30178959,-1,23,Bos_taurus,NKAPL,NKAP-like protein,823
XP_002697494.2,237754,30186450,30193866,-1,23,Bos_taurus,LOC539620,zinc finger protein with KRAB and SCAN domains 4,7416
XP_010816743.1,237755,30206788,30211745,-1,23,Bos_taurus,ZSCAN9,LOW QUALITY PROTEIN: zinc finger and SCAN domain-containing protein 9,4957
XP_010816744.1,237756,30237436,30241949,-1,23,Bos_taurus,LOC104975673,LOW QUALITY PROTEIN: pre-mRNA-splicing regulator WTAP-like,4513
NP_001138603.1,237757,30265551,30266367,-1,23,Bos_taurus,ZNF389,zinc finger protein 389,816
NP_001093814.1,237758,30279018,30287143,-1,23,Bos_taurus,ZKSCAN8,zinc finger protein 192,8125
NP_001029583.1,237759,30305198,30311510,-1,23,Bos_taurus,ZSCAN16,zinc finger and SCAN domain-containing protein 16,6312
NP_001178305.1,237760,30332604,30336576,-1,23,Bos_taurus,ZNF165,zinc finger protein 165,3972
XP_002697531.3,237761,30349198,30350140,-1,23,Bos_taurus,LOC528914,olfactory receptor 1F12,942
XP_002697534.1,237762,30375361,30376300,1,23,Bos_taurus,LOC532291,putative olfactory receptor 2B8,939
XP_010816745.1,237763,30396497,30397436,1,23,Bos_taurus,LOC529518,putative olfactory receptor 2B8,939
XP_003587763.1,237764,30464776,30465715,1,23,Bos_taurus,LOC100849008,putative olfactory receptor 2B8,939
XP_005223788.1,237765,30474842,30475787,-1,23,Bos_taurus,LOC101904987,olfactory receptor 2G6-like,945
XP_002697537.1,237766,30487471,30488416,-1,23,Bos_taurus,LOC619021,olfactory receptor 2G6,945
XP_002697499.1,237767,30504537,30505476,1,23,Bos_taurus,LOC616658,putative olfactory receptor 2B8,939
XP_002697539.1,237768,30528180,30529125,-1,23,Bos_taurus,LOC783311,olfactory receptor 2G6,945
XP_002697540.1,237769,30585742,30586705,-1,23,Bos_taurus,LOC783203,olfactory receptor 2B2,963
XP_002697541.2,237770,30607389,30608346,1,23,Bos_taurus,LOC528373,putative olfactory receptor 2W6,957
XP_010816746.1,237771,30620726,30621668,1,23,Bos_taurus,OR2B6,olfactory receptor 2B6,942
XP_010816747.1,237772,30695955,30696900,1,23,Bos_taurus,LOC783002,olfactory receptor 2B2,945
XP_002697507.1,237773,30713381,30713762,-1,23,Bos_taurus,HIST1H2BI,histone H2B type 1,381
XP_010816763.1,237774,30714063,30714456,1,23,Bos_taurus,LOC104968446,histone H2A type 1,393
XP_002697506.1,237775,30715879,30716290,1,23,Bos_taurus,HIST1H3C,histone H3.1,411
XP_010816762.1,237776,30724825,30748119,1,23,Bos_taurus,LOC528329,uncharacterized protein LOC528329,23294
XP_005223785.1,237777,30730259,30730652,-1,23,Bos_taurus,LOC529277,histone H2A type 1,393
XP_010816759.1,237778,30730957,30731338,1,23,Bos_taurus,LOC104975676,histone H2B type 1,381
NP_001075211.1,237779,30741267,30741648,-1,23,Bos_taurus,HIST1H2BB,histone H2B type 1-N,381
XP_003587761.1,237780,30741967,30742360,1,23,Bos_taurus,LOC614970,histone H2A type 1-D,393
XP_002697516.1,237781,30757274,30757586,-1,23,Bos_taurus,LOC527645,histone H4,312
XP_010816754.1,237782,30760428,30760809,-1,23,Bos_taurus,LOC616868,histone H2B type 1,381
NP_001092190.1,237783,30761115,30761508,1,23,Bos_taurus,HIST1H2AG,"histone cluster 1, H2ag",393
XP_010816767.1,237784,30764309,30764720,1,23,Bos_taurus,LOC616819,histone H3.1,411
XP_010816748.1,237785,30766956,30767343,-1,23,Bos_taurus,HIST1H2AJ,histone H2A type 1-J,387
XP_010816749.1,237786,30767649,30768030,1,23,Bos_taurus,LOC100295221,histone H2B type 1,381
NP_001093842.1,237787,30960834,30979663,1,23,Bos_taurus,ZNF184,zinc finger protein 184,18829
NP_001093822.1,237788,30995073,30996150,-1,23,Bos_taurus,ZNF391,zinc finger protein 391,1077
NP_001156399.1,237789,31040856,31043949,1,23,Bos_taurus,POM121L2,POM121-like protein 2,3093
NP_001069798.2,237790,31067237,31073523,-1,23,Bos_taurus,PRSS16,thymus-specific serine protease precursor,6286
XP_010816805.1,237791,31111940,31112327,-1,23,Bos_taurus,HIST1H2AH,histone H2A type 1-H,387
NP_001071531.1,237792,31112650,31113031,1,23,Bos_taurus,HIST1H2BN,histone H2B type 1-K,381
XP_002697546.1,237793,31121373,31121754,1,23,Bos_taurus,HIST1H2BJ,histone H2B type 1-J,381
NP_001091624.1,237794,31214786,31215995,1,23,Bos_taurus,ZNF322,zinc finger protein 322A,1209
XP_010816806.1,237795,31235373,31236321,1,23,Bos_taurus,LOC515414,olfactory receptor 2M3,948
XP_010816807.1,237796,31250288,31251215,1,23,Bos_taurus,LOC514235,olfactory receptor 2M2,927
XP_002697600.1,237797,31260280,31261204,1,23,Bos_taurus,LOC521167,olfactory receptor 2M2,924
NP_001069620.1,237798,31279671,31281319,-1,23,Bos_taurus,ABT1,activator of basal transcription 1,1648
NP_001040012.1,237799,31324374,31324647,-1,23,Bos_taurus,HMGN4,high mobility group nucleosome-binding domain-containing protein 4,273
NP_776933.1,237800,31362492,31366608,1,23,Bos_taurus,BTN1A1,butyrophilin subfamily 1 member A1 precursor,4116
XP_010816808.1,237801,31405309,31427332,-1,23,Bos_taurus,LOC786706,butyrophilin subfamily 1 member A1,22023
XP_005223853.1,237802,31456885,31457197,1,23,Bos_taurus,LOC529647,histone H4,312
XP_010816810.1,237803,31460913,31461294,-1,23,Bos_taurus,HIST1H2BM,histone H2B type 2-F,381
XP_002697551.1,237804,31461685,31462078,1,23,Bos_taurus,HIST1H2AM,histone H2A type 1,393
XP_010816878.1,237805,31463931,31474440,1,23,Bos_taurus,HIST1H3J,uncharacterized protein HIST1H3J,10509
XP_002697553.1,237806,31472338,31472719,-1,23,Bos_taurus,LOC104968456,histone H2B type 1,381
XP_010816809.1,237807,31479374,31479686,1,23,Bos_taurus,LOC527388,histone H4,312
XP_010816812.1,237808,31485394,31485706,-1,23,Bos_taurus,LOC518961,histone H4,312
NP_001094536.1,237809,31490519,31491185,1,23,Bos_taurus,HIST1H1D,histone H1.3,666
XP_010816811.1,237810,31497479,31497890,-1,23,Bos_taurus,HIST1H3E,histone H3.1,411
XP_010816814.1,237811,31517739,31518917,-1,23,Bos_taurus,HIST1H2AC,histone H2A type 1-H,1178
NP_001099113.1,237812,31519420,31519624,1,23,Bos_taurus,H2B,histone H2B,204
XP_002697561.1,237813,31525878,31526259,-1,23,Bos_taurus,LOC505183,histone H2B type 1,381
XP_010816815.1,237814,31526581,31526974,1,23,Bos_taurus,LOC104975683,histone H2A type 1,393
NP_001092459.1,237815,31531156,31531789,-1,23,Bos_taurus,HIST1H1E,"histone cluster 1, H1e",633
NP_001093194.1,237816,31534758,31535070,1,23,Bos_taurus,LOC617875,histone H4-like,312
XP_010816816.1,237817,31539668,31540049,-1,23,Bos_taurus,LOC787465,histone H2B type 1,381
NP_001039711.1,237818,31554875,31555256,-1,23,Bos_taurus,HIST1H2BD,histone H2B type 1-D,381
XP_002697564.1,237819,31556332,31556992,-1,23,Bos_taurus,HIST1H1E,histone H1.4,660
NP_001192525.1,237820,31588780,31589173,-1,23,Bos_taurus,HIST1H2AC,histone H2A type 1-C,393
XP_003587771.1,237821,31589503,31589884,1,23,Bos_taurus,LOC787269,histone H2B type 1,381
XP_010816820.1,237822,31604876,31605513,1,23,Bos_taurus,LOC104975686,LOW QUALITY PROTEIN: histone H1t,637
XP_010816819.1,237823,31607478,31607790,-1,23,Bos_taurus,LOC617905,histone H4,312
NP_001012399.1,237824,31614300,31621316,1,23,Bos_taurus,HFE,hereditary hemochromatosis protein precursor,7016
NP_001076894.1,237825,31636946,31637588,1,23,Bos_taurus,HIST1H1C,histone H1.2,642
XP_010816818.1,237826,31644097,31644508,-1,23,Bos_taurus,HIST1H3D,histone H3.1,411
XP_002697571.1,237827,31646216,31646597,1,23,Bos_taurus,HIST1H2BB,histone H2B type 1-B,381
XP_010816817.1,237828,31652713,31653106,1,23,Bos_taurus,LOC104975684,histone H2A type 1,393
XP_005223855.1,237829,31654043,31654454,1,23,Bos_taurus,HIST1H3G,histone H3.1,411
NP_776305.1,237830,31665599,31665911,1,23,Bos_taurus,H4,histone H4,312
XP_010816821.1,237831,31674089,31674746,1,23,Bos_taurus,HIST1H1A,histone H1.1,657
NP_001029746.1,237832,31693877,31706914,-1,23,Bos_taurus,TRIM38,tripartite motif-containing protein 38,13037
NP_001033207.1,237833,31727728,31738931,1,23,Bos_taurus,SLC17A2,sodium-dependent phosphate transport protein 3,11203
NP_001069255.1,237834,31761096,31778340,1,23,Bos_taurus,SLC17A3,sodium-dependent phosphate transport protein 4,17244
XP_010816823.1,237835,31914983,31915367,1,23,Bos_taurus,HIST1H2BA,histone H2B type 1-A,384
XP_005223866.2,237836,31915886,31918508,-1,23,Bos_taurus,HIST1H2BA,histone H2B type 1-A,2622
XP_010816822.1,237837,31918886,31919276,1,23,Bos_taurus,HIST1H2AA,histone H2A type 1-A,390
NP_001092643.1,237838,31952426,32004255,-1,23,Bos_taurus,SCGN,secretagogin,51829
NP_001179832.1,237839,32030008,32339087,-1,23,Bos_taurus,LRRC16A,leucine-rich repeat-containing protein 16A,309079
NP_001030502.1,237840,32713473,32763479,1,23,Bos_taurus,FAM65B,protein FAM65B,50006
XP_005223873.1,237841,32769204,32772075,1,23,Bos_taurus,C23H6orf229,uncharacterized protein C6orf229 homolog,2871
NP_001020508.1,237842,32775886,32784223,-1,23,Bos_taurus,GMNN,geminin,8337
NP_001071467.1,237843,32823091,32833540,1,23,Bos_taurus,C23H6orf62,uncharacterized protein C6orf62 homolog,10449
NP_001095315.1,237844,32836780,32848919,-1,23,Bos_taurus,ACOT13,acyl-coenzyme A thioesterase 13,12139
NP_001098811.1,237845,32849365,32859925,1,23,Bos_taurus,TDP2,tyrosyl-DNA phosphodiesterase 2,10560
XP_002697584.1,237846,32901067,32942266,1,23,Bos_taurus,KIAA0319,dyslexia-associated protein KIAA0319 homolog,41199
NP_001179664.1,237847,32952153,32976657,-1,23,Bos_taurus,ALDH5A1,"succinate-semialdehyde dehydrogenase, mitochondrial",24504
NP_777241.1,237848,32984494,33036019,1,23,Bos_taurus,GPLD1,phosphatidylinositol-glycan-specific phospholipase D precursor,51525
NP_001095373.1,237849,33040800,33077125,-1,23,Bos_taurus,MRS2,"magnesium transporter MRS2 homolog, mitochondrial",36325
NP_001068937.1,237850,33269564,33281467,-1,23,Bos_taurus,NRSN1,neurensin-1,11903
XP_003587783.2,237851,34219297,34219825,-1,23,Bos_taurus,LOC788801,ferritin light chain,528
NP_997613.2,237852,34357860,34368707,-1,23,Bos_taurus,PRP4,placental prolactin-related protein 4 precursor,10847
NP_001033289.1,237853,34431221,34440564,-1,23,Bos_taurus,PRP8,uncharacterized protein LOC613971 precursor,9343
NP_991347.1,237854,34479818,34491927,-1,23,Bos_taurus,PRP6,prolactin-related protein VI precursor,12109
NP_776584.1,237855,34531553,34543417,-1,23,Bos_taurus,PRP1,placental prolactin-related protein 1 precursor,11864
NP_001073846.2,237856,34634194,34647033,-1,23,Bos_taurus,PRP2,placental prolactin-related protein 2 precursor,12839
NP_001091031.1,237857,34693484,34705968,-1,23,Bos_taurus,PRP14,prolactin-related protein 14 precursor,12484
NP_001033221.1,237858,34719463,34731112,-1,23,Bos_taurus,PRP9,uncharacterized protein LOC519859 precursor,11649
NP_001012286.1,237859,34806750,34818831,-1,23,Bos_taurus,PRP-VII,prolactin-related protein VII precursor,12081
NP_776585.1,237860,34861329,34866557,-1,23,Bos_taurus,PRP3,placental prolactin-related protein 3 precursor,5228
NP_851350.2,237861,35059473,35072020,1,23,Bos_taurus,CSH2,chorionic somatomammotropin hormone 2 isoform 1,12547
NP_776378.2,237862,35105283,35113696,-1,23,Bos_taurus,PRL,prolactin precursor,8413
NP_001001136.2,237863,35438513,35439221,-1,23,Bos_taurus,HDGFL1,hepatoma-derived growth factor-like protein 1,708
XP_010816846.1,237864,35789778,36174436,-1,23,Bos_taurus,LOC100847951,uncharacterized protein LOC100847951,384658
NP_001071596.1,237865,36292361,36293944,-1,23,Bos_taurus,SOX4,transcription factor SOX-4,1583
NP_001179620.1,237866,36602047,37210133,-1,23,Bos_taurus,CDKAL1,CDK5 regulatory subunit-associated protein 1-like 1,608086
NP_001179767.1,237867,37262071,37343552,-1,23,Bos_taurus,E2F3,transcription factor E2F3,81481
NP_001179786.1,237868,37498772,37608122,1,23,Bos_taurus,MBOAT1,lysophospholipid acyltransferase 1,109350
NP_001092498.1,237869,38955598,39030849,-1,23,Bos_taurus,RNF144B,E3 ubiquitin-protein ligase RNF144B,75251
NP_001093187.1,237870,39134122,39163796,1,23,Bos_taurus,DEK,protein DEK,29674
NP_001068999.1,237871,39215601,39231827,1,23,Bos_taurus,TPMT,thiopurine S-methyltransferase,16226
XP_002697596.1,237872,39239197,39240382,1,23,Bos_taurus,NHLRC1,E3 ubiquitin-protein ligase NHLRC1,1185
XP_003587777.2,237873,39311370,39312101,-1,23,Bos_taurus,LOC100848101,kinesin-like protein KIF13A,731
NP_001192683.1,237874,39534811,39605312,1,23,Bos_taurus,NUP153,nuclear pore complex protein Nup153,70501
NP_001075187.1,237875,39612050,39619566,-1,23,Bos_taurus,FAM8A1,protein FAM8A1,7516
NP_001092449.1,237876,39646901,39758309,-1,23,Bos_taurus,CAP2,adenylyl cyclase-associated protein 2,111408
NP_001098455.1,237877,39836076,39846177,-1,23,Bos_taurus,RBM24,RNA-binding protein 24,10101
NP_001020518.1,237878,40610631,40610988,1,23,Bos_taurus,LOC574091,nucleoside-diphosphate kinase NBR-A,357
NP_001069445.1,237879,40616625,40676937,-1,23,Bos_taurus,GMPR,GMP reductase 1,60312
NP_001095723.1,237880,40771805,40789604,-1,23,Bos_taurus,MYLIP,E3 ubiquitin-protein ligase MYLIP,17799
NP_001039412.1,237881,41076274,41165191,1,23,Bos_taurus,DTNBP1,dysbindin,88917
NP_001040055.1,237882,42336229,42354809,-1,23,Bos_taurus,CD83,CD83 antigen precursor,18580
NP_001071406.1,237883,42467106,42467856,-1,23,Bos_taurus,RNF182,E3 ubiquitin-protein ligase RNF182,750
NP_001095779.1,237884,42547987,42567084,1,23,Bos_taurus,MCUR1,"coiled-coil domain-containing protein 90A, mitochondrial",19097
XP_010816870.1,237885,42736668,42794220,1,23,Bos_taurus,RANBP9,ran-binding protein 9,57552
NP_001029556.1,237886,42795874,42799980,-1,23,Bos_taurus,NOL7,nucleolar protein 7,4106
NP_001029467.1,237887,42804422,42820539,-1,23,Bos_taurus,SIRT5,"NAD-dependent protein deacylase sirtuin-5, mitochondrial",16117
NP_001015643.1,237888,43002796,43023933,1,23,Bos_taurus,TBC1D7,TBC1 domain family member 7,21137
NP_001179840.1,237889,43054177,43249577,-1,23,Bos_taurus,PHACTR1,phosphatase and actin regulator 1,195400
NP_851353.1,237890,44011560,44017131,-1,23,Bos_taurus,EDN1,endothelin-1 precursor,5571
NP_001032710.1,237891,44469120,44536106,1,23,Bos_taurus,ADTRP,androgen-dependent TPF1-regulating protein,66986
NP_001095317.2,237892,44955888,44986928,1,23,Bos_taurus,NEDD9,enhancer of filamentation 1,31040
NP_001129050.1,237893,45024691,45041722,-1,23,Bos_taurus,SMIM13,uncharacterized protein LOC100140337,17031
NP_001076986.1,237894,45093668,45111322,1,23,Bos_taurus,ELOVL2,elongation of very long chain fatty acids protein 2,17654
XP_002697663.3,237895,45183078,45191309,1,23,Bos_taurus,GCM2,chorion-specific transcription factor GCMb,8231
NP_001039880.2,237896,45215424,45258157,1,23,Bos_taurus,MAK,serine/threonine-protein kinase MAK,42733
NP_001030514.1,237897,45266131,45271264,-1,23,Bos_taurus,TMEM14C,transmembrane protein 14C,5133
NP_001014852.1,237898,45276647,45287337,-1,23,Bos_taurus,PAK1IP1,p21-activated protein kinase-interacting protein 1,10690
XP_005223944.1,237899,45347953,45404713,-1,23,Bos_taurus,LOC100848875,"N-acetyllactosaminide beta-1,6-N-acetylglucosaminyl-transferase, isoform A-like",56760
NP_001073697.1,237900,45480585,45497627,1,23,Bos_taurus,TFAP2A,transcription factor AP-2-alpha,17042
XP_010816915.1,237901,45861270,46099308,1,23,Bos_taurus,OFCC1,orofacial cleft 1 candidate gene 1 protein,238038
NP_001035689.1,237902,47219521,47234197,1,23,Bos_taurus,EEF1E1,eukaryotic translation elongation factor 1 epsilon-1,14676
NP_001092345.1,237903,47244999,47268188,1,23,Bos_taurus,BLOC1S5,protein Muted homolog,23189
XP_005223948.1,237904,47328270,47331779,1,23,Bos_taurus,LOC101907314,thioredoxin domain-containing protein 5-like,3509
NP_001193661.1,237905,47333405,47349788,-1,23,Bos_taurus,TXNDC5,thioredoxin domain-containing protein 5 precursor,16383
XP_002697643.1,237906,47647916,47663909,-1,23,Bos_taurus,SNRNP48,U11/U12 small nuclear ribonucleoprotein 48 kDa protein,15993
NP_001179297.1,237907,47671218,47714288,-1,23,Bos_taurus,DSP,desmoplakin,43070
NP_001095592.1,237908,47853878,47869743,1,23,Bos_taurus,SSR1,translocon-associated protein subunit alpha precursor,15865
XP_010816946.1,237909,47881998,47883412,-1,23,Bos_taurus,LOC101902251,protein transport protein sec31-like,1414
XP_010816924.1,237910,47888528,47889161,1,23,Bos_taurus,LOC104969878,WAS/WASL-interacting protein family member 3-like,633
NP_001077230.1,237911,48385735,48430517,-1,23,Bos_taurus,LY86,lymphocyte antigen 86 precursor,44782
NP_001161366.1,237912,48635989,48775083,1,23,Bos_taurus,F13A1,coagulation factor XIII A chain,139094
NP_001039903.1,237913,48868378,48876549,1,23,Bos_taurus,NRN1,neuritin precursor,8171
NP_001070273.1,237914,48974819,49233786,-1,23,Bos_taurus,FARS2,"phenylalanyl-tRNA synthetase, mitochondrial",258967
NP_001069774.1,237915,49283282,49373963,1,23,Bos_taurus,LYRM4,LYR motif-containing protein 4,90681
NP_001098872.1,237916,49410733,49420147,1,23,Bos_taurus,RPP40,ribonuclease P protein subunit p40,9414
NP_001095693.1,237917,49452872,49548143,-1,23,Bos_taurus,CDYL,chromodomain Y-like protein,95271
XP_010816927.1,237918,49837949,49845387,1,23,Bos_taurus,LOC104969916,uncharacterized protein LOC104969916,7438
NP_001029414.2,237919,49909572,49923551,1,23,Bos_taurus,ECI2,"enoyl-CoA delta isomerase 2, mitochondrial",13979
XP_010816928.1,237920,49924672,49930704,-1,23,Bos_taurus,C23H6orf201,uncharacterized protein C6orf201 homolog,6032
NP_001069025.1,237921,49954743,49977786,-1,23,Bos_taurus,PRPF4B,serine/threonine-protein kinase PRP4 homolog,23043
NP_001070400.1,237922,50077730,50094900,1,23,Bos_taurus,PXDC1,PX domain-containing protein 1,17170
NP_001069809.1,237923,50234200,50323372,1,23,Bos_taurus,SLC22A23,solute carrier family 22 member 23,89172
XP_002697651.1,237924,50327519,50331670,-1,23,Bos_taurus,PSMG4,proteasome assembly chaperone 4,4151
NP_001003900.1,237925,50354937,50357631,1,23,Bos_taurus,TUBB2B,tubulin beta-2B chain,2694
XP_010816931.1,237926,50377724,50378817,1,23,Bos_taurus,LOC104969934,tubulin beta-4B chain-like,1093
XP_002697652.1,237927,50390225,50394087,1,23,Bos_taurus,LOC100295973,tubulin beta-2A chain,3862
NP_001039383.1,237928,50395183,50417050,-1,23,Bos_taurus,BPHL,valacyclovir hydrolase,21867
NP_001030184.1,237929,50421320,50446671,-1,23,Bos_taurus,RIPK1,receptor-interacting serine/threonine-protein kinase 1,25351
NP_001029495.1,237930,50487524,50496961,-1,23,Bos_taurus,NQO2,ribosyldihydronicotinamide dehydrogenase [quinone],9437
NP_001069327.1,237931,50638189,50644250,1,23,Bos_taurus,SERPINB9,serpin B9,6061
NP_001193539.1,237932,50673609,50678834,-1,23,Bos_taurus,SERPINB1,leukocyte elastase inhibitor,5225
NP_001096576.1,237933,50703901,50742372,-1,23,Bos_taurus,WRNIP1,ATPase WRNIP1,38471
NP_001073800.1,237934,51115435,51453348,1,23,Bos_taurus,GMDS,"GDP-mannose 4,6 dehydratase",337913
XP_010816941.1,237935,51576081,51596478,1,23,Bos_taurus,LOC101904396,uncharacterized protein LOC101904396,20397
XP_005223980.1,237936,51607382,51608838,1,23,Bos_taurus,LOC101905755,uncharacterized protein LOC101905755,1456
XP_010816948.1,237937,51609001,51610916,1,23,Bos_taurus,LOC101905813,uncharacterized protein LOC101905813,1915
XP_010816950.1,237938,51622496,51650353,1,23,Bos_taurus,LOC104969983,uncharacterized protein LOC104969983,27857
NP_001193088.1,237939,51917536,52014590,1,23,Bos_taurus,EXOC2,exocyst complex component 2,97054
NP_001193091.1,237940,52050984,52063652,-1,23,Bos_taurus,IRF4,interferon regulatory factor 4,12668
XP_010799069.1,237941,52397482,52398420,-1,23,Bos_taurus,LOC613394,LOW QUALITY PROTEIN: olfactory receptor 1030-like,938
XP_010799070.1,237942,52415208,52416152,-1,23,Bos_taurus,LOC532311,LOW QUALITY PROTEIN: olfactory receptor 1030-like,944
XP_002683845.1,237943,52444475,52445489,-1,23,Bos_taurus,OR5M10,olfactory receptor 5M10,1014
XP_005201036.2,237944,52459808,52477741,1,23,Bos_taurus,LOC101903662,liprin-alpha-1-like,17933
XP_010799072.1,237945,52504147,52505054,-1,23,Bos_taurus,LOC101909723,LOW QUALITY PROTEIN: olfactory receptor 4P4-like,907
NP_032138.3,306255,3538298,3565142,1,13,Mus_musculus,Gdi2,rab GDP dissociation inhibitor beta,26844
NP_598824.3,306256,3566663,3599964,-1,13,Mus_musculus,Fam208b,protein FAM208B,33301
NP_001254653.1,306257,3634132,3650215,1,13,Mus_musculus,Asb13,ankyrin repeat and SOCS box protein 13 isoform 3,16083
NP_081692.1,306258,3803753,3804203,-1,13,Mus_musculus,Calml3,calmodulin-like protein 3,450
NP_064420.2,306259,3837895,3838342,1,13,Mus_musculus,Calm4,calmodulin-4,447
NP_001008706.1,306260,3854267,3854730,1,13,Mus_musculus,Calm5,calmodulin 5,463
NP_001040624.1,306261,3884069,3893385,-1,13,Mus_musculus,Net1,neuroepithelial cell-transforming gene 1 protein isoform 2,9316
NP_001029051.2,306262,3924734,3933562,1,13,Mus_musculus,Tubal3,tubulin alpha chain-like 3,8828
NP_112540.2,306263,3941155,3941650,-1,13,Mus_musculus,Ucn3,urocortin-3 precursor,495
NP_598833.1,306264,4059631,4088990,1,13,Mus_musculus,Akr1c14,3-alpha-hydroxysteroid dehydrogenase,29359
NP_598827.1,306265,4132793,4150598,-1,13,Mus_musculus,Akr1c18,aldo-keto reductase family 1 member C18,17805
NP_038806.2,306266,4191226,4205383,1,13,Mus_musculus,Akr1c13,aldo-keto reductase family 1 member C13,14157
NP_001013807.2,306267,4233770,4248120,1,13,Mus_musculus,Akr1c19,"aldo-keto reductase family 1, member C19",14350
NP_038805.2,306268,4268387,4279356,-1,13,Mus_musculus,Akr1c12,"aldo-keto reductase family 1, member C12",10969
NP_085114.1,306269,4434390,4457191,1,13,Mus_musculus,Akr1c6,estradiol 17 beta-dehydrogenase 5,22801
NP_473421.1,306270,4507656,4523314,-1,13,Mus_musculus,Akr1c20,"aldo-keto reductase family 1, member C20",15658
NP_084177.2,306271,4574148,4586380,1,13,Mus_musculus,Akr1c21,aldo-keto reductase family 1 member C21,12232
NP_061347.2,306272,4593255,4609123,-1,13,Mus_musculus,Akr1e1,"1,5-anhydro-D-fructose reductase",15868
NP_035933.2,306273,5861638,5867283,1,13,Mus_musculus,Klf6,Krueppel-like factor 6,5645
NP_660113.1,306274,6548173,6579743,1,13,Mus_musculus,Pitrm1,"presequence protease, mitochondrial precursor",31570
NP_001278000.1,306275,6581459,6648679,-1,13,Mus_musculus,Pfkp,"ATP-dependent 6-phosphofructokinase, platelet type isoform 2",67220
NP_001276459.1,306276,8203220,8757275,1,13,Mus_musculus,Adarb2,double-stranded RNA-specific editase B2 isoform 2,554055
NP_766033.1,306277,8805814,8861225,-1,13,Mus_musculus,Wdr37,WD repeat-containing protein 37 isoform a,55411
NP_663335.2,306278,8885859,8890635,1,13,Mus_musculus,Idi1,isopentenyl-diphosphate Delta-isomerase 1,4776
NP_796171.1,306279,8956810,8959432,1,13,Mus_musculus,Idi2,isopentenyl-diphosphate delta-isomerase 2,2622
NP_081276.2,306280,8973121,8995996,-1,13,Mus_musculus,Gtpbp4,nucleolar GTP-binding protein 1,22875
NP_766173.1,306281,9122145,9170942,1,13,Mus_musculus,Larp4b,la-related protein 4B,48797
NP_001074895.2,306282,9276981,9666030,1,13,Mus_musculus,Dip2c,disco-interacting protein 2 homolog C,389049
NP_653099.2,306283,9686861,9735447,-1,13,Mus_musculus,Zmynd11,zinc finger MYND domain-containing protein 11 isoform alpha,48586
NP_150372.1,306284,9877228,9878998,-1,13,Mus_musculus,Chrm3,muscarinic acetylcholine receptor M3,1770
NP_076357.2,306285,11554515,12106446,-1,13,Mus_musculus,Ryr2,ryanodine receptor 2,551931
NP_001074597.1,306286,12187004,12253973,-1,13,Mus_musculus,Mtr,methionine synthase,66969
NP_150371.4,306287,12269493,12340500,-1,13,Mus_musculus,Actn2,alpha-actinin-2,71007
NP_659084.3,306288,12395771,12438677,1,13,Mus_musculus,Heatr1,BAP28 protein,42906
NP_001277986.1,306289,12440844,12454797,-1,13,Mus_musculus,Lgals8,galectin-8 isoform 3,13953
NP_598398.3,306290,12478182,12519948,-1,13,Mus_musculus,Edaradd,ectodysplasin-A receptor-associated adapter protein isoform 1,41766
NP_080460.2,306291,12566076,12606887,1,13,Mus_musculus,Ero1lb,ERO1-like protein beta precursor,40811
NP_035248.2,306292,12790930,12800012,-1,13,Mus_musculus,Prl2c3,prolactin-2C3 precursor,9082
NP_112468.1,306293,12996234,13005326,-1,13,Mus_musculus,Prl2c2,prolactin-2C2 precursor,9092
NP_862900.1,306294,13182781,13191815,1,13,Mus_musculus,Prl2c5,"prolactin family 2, subfamily c, member 5 precursor",9034
XP_006516887.1,306295,13320937,13322532,-1,13,Mus_musculus,Gm7040,prolactin-2C3-like,1595
NP_114388.2,306296,13359311,13393493,-1,13,Mus_musculus,Gpr137b,integral membrane protein GPR137B,34182
NP_035047.2,306297,13437701,13510067,1,13,Mus_musculus,Nid1,nidogen-1 precursor,72366
NP_034878.2,306298,13616553,13777179,1,13,Mus_musculus,Lyst,lysosomal-trafficking regulator,160626
NP_034447.1,306299,13806071,13825375,1,13,Mus_musculus,Gng4,guanine nucleotide-binding protein G(I)/G(S)/G(O) subunit gamma-4 precursor,19304
NP_848755.1,306300,13954804,13997033,1,13,Mus_musculus,B3galnt2,"UDP-GalNAc:beta-1, 3-N-acetylgalactosaminyltransferase 2 precursor",42229
NP_848027.1,306301,13998088,14029375,-1,13,Mus_musculus,Tbce,tubulin-specific chaperone E,31287
NP_034412.1,306302,14053693,14057865,-1,13,Mus_musculus,Ggps1,geranylgeranyl pyrophosphate synthase,4172
NP_919238.1,306303,14064873,14197733,1,13,Mus_musculus,Arid4b,AT-rich interactive domain-containing protein 4B isoform 1,132860
NP_001074817.3,306304,14230648,14434460,-1,13,Mus_musculus,Hecw1,E3 ubiquitin-protein ligase HECW1,203812
NP_083547.1,306305,14610485,14613018,-1,13,Mus_musculus,Mrpl32,"39S ribosomal protein L32, mitochondrial",2533
NP_032970.2,306306,14613274,14625465,1,13,Mus_musculus,Psma2,proteasome subunit alpha type-2,12191
NP_598828.3,306307,14636563,14637829,1,13,Mus_musculus,AW209491,UPF0415 protein C7orf25 homolog,1266
NP_032156.2,306308,15478040,15726781,1,13,Mus_musculus,Gli3,transcriptional activator GLI3,248741
NP_032406.1,306309,16017295,16027129,1,13,Mus_musculus,Inhba,inhibin beta A chain precursor,9834
NP_619595.3,306310,16857854,17694732,-1,13,Mus_musculus,Sugct,succinate--hydroxymethylglutarate CoA-transferase,836878
NP_079755.1,306311,17695484,17697042,1,13,Mus_musculus,Mplkip,M-phase-specific PLK1-interacting protein,1558
NP_081394.1,306312,17718060,17804651,-1,13,Mus_musculus,Cdk13,cyclin-dependent kinase 13 isoform 2,86591
NP_062364.3,306313,17882378,17897066,-1,13,Mus_musculus,Rala,ras-related protein Ral-A precursor,14688
XP_006516888.1,306314,17941432,17944525,1,13,Mus_musculus,Gm32699,class E basic helix-loop-helix protein 22,3093
NP_080180.1,306315,17989379,17993306,-1,13,Mus_musculus,Yae1d1,uncharacterized protein LOC67008,3927
NP_778171.2,306316,18125161,18382044,-1,13,Mus_musculus,Pou6f2,"POU domain, class 6, transcription factor 2",256883
NP_742118.3,306317,18717315,18866200,1,13,Mus_musculus,Vps41,vacuolar protein sorting-associated protein 41 homolog,148885
NP_001276475.1,306318,18948432,19149843,1,13,Mus_musculus,Amph,amphiphysin isoform 2,201411
NP_077232.2,306319,19358992,19376603,-1,13,Mus_musculus,Stard3nl,MLN64 N-terminal domain homolog,17611
NP_598826.3,306320,19593151,19619562,-1,13,Mus_musculus,Epdr1,mammalian ependymin-related protein 1 precursor,26411
NP_057896.1,306321,19623432,19632379,1,13,Mus_musculus,Sfrp4,secreted frizzled-related sequence protein 4 precursor,8947
NP_001161381.1,306322,19645219,19697036,-1,13,Mus_musculus,Nme8,thioredoxin domain-containing protein 3 isoform 2,51817
NP_783619.2,306323,19728980,19729880,-1,13,Mus_musculus,A530099J19Rik,G protein-coupled receptor-like,900
NP_861419.3,306324,19751685,19752603,-1,13,Mus_musculus,Gpr141,probable G-protein coupled receptor 141,918
XP_011242664.1,306325,19995020,19995813,-1,13,Mus_musculus,Gm5446,LOW QUALITY PROTEIN: serine/arginine-rich splicing factor 10-like,793
NP_525027.1,306326,20185426,20605299,1,13,Mus_musculus,Elmo1,engulfment and cell motility protein 1 isoform 3,419873
NP_001268783.1,306327,20794393,20851690,1,13,Mus_musculus,Aoah,acyloxyacyl hydrolase isoform 2 preproprotein,57297
NP_666746.1,306328,21072348,21073299,-1,13,Mus_musculus,Olfr1370,olfactory receptor 1370,951
NP_035114.1,306329,21132776,21133730,1,13,Mus_musculus,Olfr263,olfactory receptor 263,954
NP_666745.1,306330,21142110,21143055,-1,13,Mus_musculus,Olfr1368,olfactory receptor 1368,945
NP_033080.2,306331,21180494,21192625,1,13,Mus_musculus,Trim27,zinc finger protein RFP,12131
NP_034473.2,306332,21287365,21292660,-1,13,Mus_musculus,Gpx5,epididymal secretory glutathione peroxidase precursor,5295
NP_663426.2,306333,21312257,21319083,1,13,Mus_musculus,Gpx6,glutathione peroxidase 6 precursor,6826
NP_666744.1,306334,21346929,21347880,1,13,Mus_musculus,Olfr1367,olfactory receptor 1367,951
NP_057893.2,306335,21363649,21369513,1,13,Mus_musculus,Zscan12,zinc finger and SCAN domain-containing protein 12,5864
NP_076174.3,306336,21387798,21396516,-1,13,Mus_musculus,Zkscan3,zinc finger protein with KRAB and SCAN domains 3,8718
NP_001012311.2,306337,21422774,21434485,-1,13,Mus_musculus,Pgbd1,piggyBac transposable element derived 1 isoform b,11711
NP_001013808.2,306338,21444930,21449455,-1,13,Mus_musculus,Zscan26,zinc finger and SCAN domain-containing protein 26,4525
NP_079995.2,306339,21467253,21468441,-1,13,Mus_musculus,Nkapl,NFKB activating protein-like,1188
NP_001034204.1,306340,21479092,21484736,1,13,Mus_musculus,Zkscan4,zinc finger protein with KRAB and SCAN domains 4,5644
NP_001238762.1,306341,21520000,21526938,-1,13,Mus_musculus,Zkscan8,zinc finger protein 192 isoform 2,6938
NP_666395.2,306342,21537016,21538003,-1,13,Mus_musculus,Olfr1366,olfactory receptor 1366,987
NP_997455.1,306343,21555039,21556020,-1,13,Mus_musculus,Olfr1535,olfactory receptor 1535,981
NP_666751.2,306344,21573509,21574454,-1,13,Mus_musculus,Olfr1364,olfactory receptor 1364,945
NP_666955.2,306345,21611040,21611967,-1,13,Mus_musculus,Olfr1362,olfactory receptor 1362,927
NP_666753.2,306346,21638579,21639521,-1,13,Mus_musculus,Olfr11,olfactory receptor 11,942
NP_666752.1,306347,21658367,21659321,-1,13,Mus_musculus,Olfr1361,olfactory receptor 1361,954
NP_666754.2,306348,21674000,21674942,-1,13,Mus_musculus,Olfr1360,olfactory receptor 1360,942
NP_001011820.1,306349,21703002,21703944,1,13,Mus_musculus,Olfr1359,olfactory receptor 1359,942
NP_835506.1,306350,21715762,21716143,-1,13,Mus_musculus,Hist1h2bl,histone H2B type 1-F/J/L,381
NP_835489.1,306351,21716421,21716814,1,13,Mus_musculus,Hist1h2ai,histone H2A type 1,393
NP_835513.1,306352,21717658,21718069,1,13,Mus_musculus,Hist1h3h,histone H3.1,411
NP_835507.1,306353,21722097,21722478,1,13,Mus_musculus,Hist1h2bm,histone H2B type 1-M,381
NP_835582.1,306354,21735095,21735407,1,13,Mus_musculus,Hist1h4j,histone H4,312
NP_835583.1,306355,21750193,21750505,-1,13,Mus_musculus,Hist1h4k,histone H4,312
NP_835490.1,306356,21753434,21753827,-1,13,Mus_musculus,Hist1h2ak,histone H2A type 1-K,393
NP_835508.1,306357,21754122,21754503,1,13,Mus_musculus,Hist1h2bn,histone H2B type 1-F/J/L,381
NP_064418.1,306358,21779882,21780554,-1,13,Mus_musculus,Hist1h1b,histone H1.5,672
NP_835514.1,306359,21782959,21783370,-1,13,Mus_musculus,Hist1h3i,histone H3.1,411
NP_835491.1,306360,21786825,21787218,-1,13,Mus_musculus,Hist1h2an,histone H2A type 1,393
NP_001277395.1,306361,21787514,21787895,1,13,Mus_musculus,Hist1h2bp,histone H2B type 1-P isoform 2,381
NP_001091448.2,306362,21808099,21810171,-1,13,Mus_musculus,Hist1h2bq,"H2b histone family, member A",2072
NP_001171015.1,306363,21810466,21810859,1,13,Mus_musculus,Hist1h2ao,histone H2A type 1,393
NP_001182350.1,306364,21811783,21812095,1,13,Mus_musculus,Hist1h4m,histone H4,312
NP_783588.1,306365,21831846,21832158,-1,13,Mus_musculus,Hist1h4n,histone H4,312
NP_835492.1,306366,21833082,21833475,-1,13,Mus_musculus,Hist1h2ap,histone H2A type 1,393
NP_001104025.1,306367,21833770,21835842,1,13,Mus_musculus,Hist1h2br,histone cluster 1 H2br,2072
NP_898835.1,306368,21945792,21960339,1,13,Mus_musculus,Zfp184,zinc finger protein 184,14547
NP_001156400.1,306369,21981560,21984479,1,13,Mus_musculus,Pom121l2,POM121-like protein 2 isoform 1,2919
NP_062302.1,306370,22002753,22009697,-1,13,Mus_musculus,Prss16,thymus-specific serine protease precursor,6944
NP_783590.1,306371,22035165,22035552,-1,13,Mus_musculus,Hist1h2ah,histone H2A type 1-H,387
NP_783596.1,306372,22035886,22036267,1,13,Mus_musculus,Hist1h2bk,histone H2B type 1-K,381
NP_783587.1,306373,22041011,22041323,-1,13,Mus_musculus,Hist1h4i,histone H4,312
NP_835493.1,306374,22042534,22042927,-1,13,Mus_musculus,Hist1h2ag,histone H2A type 1,393
NP_835505.1,306375,22043229,22043610,1,13,Mus_musculus,Hist1h2bj,histone H2B type 1-F/J/L,381
NP_665849.1,306376,22087877,22088804,1,13,Mus_musculus,Vmn1r188,vomeronasal 1 receptor 188,927
NP_665843.1,306377,22101726,22102665,-1,13,Mus_musculus,Vmn1r189,vomeronasal 1 receptor 189,939
NP_665848.1,306378,22178685,22179582,-1,13,Mus_musculus,Vmn1r191,vomeronasal 1 receptor 191,897
NP_665844.1,306379,22187145,22188048,-1,13,Mus_musculus,Vmn1r192,vomeronasal 1 receptor 192,903
NP_598986.1,306380,22218860,22219820,-1,13,Mus_musculus,Vmn1r193,vomeronasal 1 receptor 193,960
NP_001074441.1,306381,22244214,22245105,1,13,Mus_musculus,Vmn1r194,vomeronasal 1 receptor 194,891
NP_598984.2,306382,22278361,22279312,1,13,Mus_musculus,Vmn1r195,"vomeronasal 1 receptor, I6",951
NP_001161013.1,306383,22293192,22294098,1,13,Mus_musculus,Vmn1r196,vomeronasal 1 receptor 196,906
NP_599005.1,306384,22327910,22328807,1,13,Mus_musculus,Vmn1r197,vomeronasal 1 receptor 197,897
NP_598981.1,306385,22354345,22355248,1,13,Mus_musculus,Vmn1r198,vomeronasal 1 receptor 198,903
NP_598974.1,306386,22382537,22383641,1,13,Mus_musculus,Vmn1r199,vomeronasal 1 receptor 199,1104
NP_598973.1,306387,22395028,22395967,1,13,Mus_musculus,Vmn1r200,vomeronasal 1 receptor 200,939
NP_598972.2,306388,22441271,22442243,1,13,Mus_musculus,Vmn1r-ps103,"vomeronasal 1 receptor, H1",972
NP_598982.1,306389,22474617,22475520,1,13,Mus_musculus,Vmn1r201,vomeronasal 1 receptor 201,903
NP_598985.1,306390,22501336,22502245,-1,13,Mus_musculus,Vmn1r202,vomeronasal 1 receptor 202,909
NP_598997.1,306391,22524050,22524986,1,13,Mus_musculus,Vmn1r203,vomeronasal 1 receptor 203,936
NP_001039009.1,306392,22556200,22557109,1,13,Mus_musculus,Vmn1r204,vomeronasal 1 receptor 204,909
NP_598978.1,306393,22591979,22592930,-1,13,Mus_musculus,Vmn1r205,vomeronasal 1 receptor 205,951
NP_598977.1,306394,22620096,22621035,-1,13,Mus_musculus,Vmn1r206,vomeronasal 1 receptor 206,939
NP_001160181.1,306395,22725683,22726622,-1,13,Mus_musculus,Vmn1r207-ps,"vomeronasal 1 receptor 207, pseudogene",939
NP_598979.1,306396,22772398,22773325,-1,13,Mus_musculus,Vmn1r208,vomeronasal 1 receptor 208,927
NP_001013809.1,306397,22805579,22806518,-1,13,Mus_musculus,Vmn1r209,vomeronasal 1 receptor 209,939
NP_598996.1,306398,22827193,22828114,-1,13,Mus_musculus,Vmn1r210,vomeronasal 1 receptor 210,921
NP_599004.1,306399,22851598,22852495,-1,13,Mus_musculus,Vmn1r211,vomeronasal 1 receptor 211,897
NP_599002.1,306400,22883087,22884161,-1,13,Mus_musculus,Vmn1r212,vomeronasal 1 receptor 212,1074
NP_598976.1,306401,23011248,23012403,1,13,Mus_musculus,Vmn1r213,vomeronasal 1 receptor 213,1155
NP_598975.1,306402,23034337,23035441,1,13,Mus_musculus,Vmn1r214,vomeronasal 1 receptor 214,1104
NP_598980.1,306403,23075791,23076694,1,13,Mus_musculus,Vmn1r215,vomeronasal 1 receptor 215,903
NP_599006.1,306404,23099148,23100045,1,13,Mus_musculus,Vmn1r216,vomeronasal 1 receptor 216,897
NP_599000.1,306405,23113833,23114730,-1,13,Mus_musculus,Vmn1r217,vomeronasal 1 receptor 217,897
NP_598983.1,306406,23136484,23137381,1,13,Mus_musculus,Vmn1r218,vomeronasal 1 receptor 218,897
NP_598999.1,306407,23162642,23163581,1,13,Mus_musculus,Vmn1r219,vomeronasal 1 receptor 219,939
NP_598998.1,306408,23183627,23184524,-1,13,Mus_musculus,Vmn1r220,vomeronasal 1 receptor 220,897
NP_001161014.1,306409,23217372,23218311,1,13,Mus_musculus,Vmn1r221,vomeronasal 1 receptor 221,939
NP_599001.1,306410,23232114,23233041,-1,13,Mus_musculus,Vmn1r222,vomeronasal 1 receptor 222,927
NP_001076780.1,306411,23249237,23250323,1,13,Mus_musculus,Vmn1r223,vomeronasal 1 receptor 223,1086
NP_001104577.1,306412,23356337,23357570,-1,13,Mus_musculus,Zfp322a,zinc finger protein 322,1233
NP_038952.1,306413,23421972,23423832,-1,13,Mus_musculus,Abt1,activator of basal transcription 1,1860
NP_038511.1,306414,23458702,23465180,-1,13,Mus_musculus,Btn1a1,butyrophilin subfamily 1 member A1 precursor,6478
NP_001276543.1,306415,23478233,23487917,-1,13,Mus_musculus,Btn2a2,butyrophilin subfamily 2 member A2 isoform 2 precursor,9684
NP_694813.1,306416,23531114,23531426,1,13,Mus_musculus,Hist1h4h,histone H4,312
NP_783592.1,306417,23533910,23534303,1,13,Mus_musculus,Hist1h2af,histone H2A type 1-F,393
NP_659539.1,306418,23535445,23535856,1,13,Mus_musculus,Hist1h3g,histone H3.1,411
NP_835504.1,306419,23542971,23543352,-1,13,Mus_musculus,Hist1h2bh,histone H2B type 1-H,381
NP_038576.1,306420,23544484,23544895,1,13,Mus_musculus,Hist1h3f,histone H3.2,411
NP_783586.1,306421,23551331,23551643,-1,13,Mus_musculus,Hist1h4f,histone H4,312
NP_663759.3,306422,23555089,23555755,1,13,Mus_musculus,Hist1h1d,histone H1.3,666
NP_835512.1,306423,23561954,23562365,-1,13,Mus_musculus,Hist1h3e,histone H3.2,411
NP_835494.1,306424,23570715,23571108,-1,13,Mus_musculus,Hist1h2ae,histone H2A type 1,393
NP_835503.1,306425,23571432,23571813,1,13,Mus_musculus,Hist1h2bg,histone H2B type 1-C/E/G,381
NP_835502.1,306426,23573809,23574190,-1,13,Mus_musculus,Hist1h2bf,histone H2B type 1-F/J/L,381
NP_835495.1,306427,23574470,23574863,1,13,Mus_musculus,Hist1h2ad,histone H2A type 1,393
NP_835511.1,306428,23575801,23576212,1,13,Mus_musculus,Hist1h3d,histone H3.2,411
NP_783585.1,306429,23581601,23581913,1,13,Mus_musculus,Hist1h4d,histone H4,312
NP_001171124.1,306430,23585575,23585956,-1,13,Mus_musculus,Hist1h2be,histone H2B type 1-C/E/G,381
NP_056602.1,306431,23621837,23622497,-1,13,Mus_musculus,Hist1h1e,histone H1.4,660
NP_835496.1,306432,23683524,23683917,-1,13,Mus_musculus,Hist1h2ac,histone H2A type 1,393
NP_001277309.1,306433,23684231,23684612,1,13,Mus_musculus,Hist1h2bc,histone H2B type 1-C/E/G,381
NP_034507.2,306434,23695865,23696495,1,13,Mus_musculus,Hist1h1t,histone H1t,630
NP_835515.1,306435,23698137,23698449,-1,13,Mus_musculus,Hist1h4c,histone H4,312
NP_034554.2,306436,23704385,23710714,-1,13,Mus_musculus,Hfe,hereditary hemochromatosis protein homolog precursor,6329
NP_056601.1,306437,23738848,23739487,1,13,Mus_musculus,Hist1h1c,histone H1.2,639
NP_783584.1,306438,23745086,23745497,-1,13,Mus_musculus,Hist1h3c,histone H3.2,411
XP_006516883.2,306439,23746119,23746553,-1,13,Mus_musculus,Gm11336,histone H2A type 1-C-like,434
NP_783595.1,306440,23746794,23747175,1,13,Mus_musculus,Hist1h2bb,histone H2B type 1-B,381
NP_783591.2,306441,23751132,23751525,1,13,Mus_musculus,Hist1h2ab,histone H2A type 1,393
NP_835510.1,306442,23752379,23752790,1,13,Mus_musculus,Hist1h3b,histone H3.2,411
NP_835500.1,306443,23757020,23757332,1,13,Mus_musculus,Hist1h4b,histone H4,312
NP_835499.1,306444,23760845,23761157,-1,13,Mus_musculus,Hist1h4a,histone H4,312
NP_038578.2,306445,23761942,23762353,-1,13,Mus_musculus,Hist1h3a,histone H3.1,411
NP_085112.1,306446,23763716,23764358,1,13,Mus_musculus,Hist1h1a,histone H1.1,642
NP_001025106.1,306447,23782571,23791495,1,13,Mus_musculus,Trim38,tripartite motif-containing protein 38,8924
NP_659085.1,306448,23810799,23822302,1,13,Mus_musculus,Slc17a2,sodium-dependent phosphate transport protein 3,11503
NP_598830.2,306449,23842449,23858113,1,13,Mus_musculus,Slc17a3,"solute carrier family 17 (sodium phosphate), member 3 isoform 1",15664
NP_001164109.1,306450,23872599,23892669,1,13,Mus_musculus,Slc17a1,sodium-dependent phosphate transport protein 1,20070
NP_795990.2,306451,23898774,23908847,-1,13,Mus_musculus,Slc17a4,probable small intestine urate exporter,10073
NP_783594.1,306452,23933772,23934156,-1,13,Mus_musculus,Hist1h2ba,histone H2B type 1-A,384
NP_783589.1,306453,23934461,23934851,1,13,Mus_musculus,Hist1h2aa,"histone cluster 1, H2aa",390
NP_663374.1,306454,23953855,23991033,-1,13,Mus_musculus,Scgn,secretagogin,37178
NP_081101.3,306455,24013326,24280600,-1,13,Mus_musculus,Lrrc16a,leucine-rich repeat-containing protein 16A,267274
NP_031743.3,306456,24416999,24468622,1,13,Mus_musculus,Cmah,cytidine monophosphate-N-acetylneuraminic acid hydroxylase isoform a,51623
NP_848773.3,306457,24614689,24704841,1,13,Mus_musculus,Fam65b,protein FAM65B isoform 3,90152
XP_011242665.1,306458,24741274,24746489,1,13,Mus_musculus,1700016G14Rik,uncharacterized protein C6orf229 homolog,5215
NP_065592.1,306459,24752068,24760210,-1,13,Mus_musculus,Gmnn,geminin,8142
NP_077793.1,306460,24803380,24812762,1,13,Mus_musculus,BC005537,uncharacterized protein C6orf62 homolog,9382
NP_080066.1,306461,24818034,24831306,-1,13,Mus_musculus,Acot13,acyl-coenzyme A thioesterase 13,13272
NP_062424.1,306462,24831731,24841362,1,13,Mus_musculus,Tdp2,tyrosyl-DNA phosphodiesterase 2,9631
NP_001074520.1,306463,24854500,24899799,1,13,Mus_musculus,D130043K22Rik,dyslexia-associated protein KIAA0319 homolog precursor,45299
NP_766120.1,306464,24911560,24937568,-1,13,Mus_musculus,Aldh5a1,"succinate-semialdehyde dehydrogenase, mitochondrial precursor",26008
NP_032182.2,306465,24943616,24990122,1,13,Mus_musculus,Gpld1,phosphatidylinositol-glycan-specific phospholipase D precursor,46506
NP_001013407.2,306466,24993077,25020244,-1,13,Mus_musculus,Mrs2,"magnesium transporter MRS2 homolog, mitochondrial precursor",27167
NP_001182546.1,306467,25056270,25120552,1,13,Mus_musculus,Dcdc2a,doublecortin domain-containing protein 2 isoform 2,64282
NP_033539.1,306468,25253352,25262391,-1,13,Mus_musculus,Nrsn1,neurensin-1,9039
NP_032258.2,306469,26769236,26770088,-1,13,Mus_musculus,Hdgfl1,hepatoma derived growth factor-like 1,852
NP_035294.2,306470,27057623,27065050,1,13,Mus_musculus,Prl,prolactin isoform 1 precursor,7427
NP_001192251.1,306471,27094252,27100121,1,13,Mus_musculus,Prl3d1,prolactin-3D1 isoform 1 precursor,5869
NP_742167.1,306472,27121741,27127418,1,13,Mus_musculus,Prl3d2,"prolactin family 3, subfamily d, member 1 precursor",5677
NP_742168.1,306473,27156836,27162456,1,13,Mus_musculus,Prl3d3,"prolactin family 3, subfamily d, member 3 precursor",5620
NP_038794.1,306474,27196705,27203612,1,13,Mus_musculus,Prl3c1,prolactin-3C1 isoform 1 precursor,6907
NP_032891.1,306475,27242488,27249532,1,13,Mus_musculus,Prl3b1,prolactin-3B1 precursor,7044
NP_080172.1,306476,27259644,27276218,1,13,Mus_musculus,Prl3a1,"prolactin family 3, subfamily a, member 1 precursor",16574
NP_035296.1,306477,27312664,27319115,1,13,Mus_musculus,Prl6a1,prolactin-6A1 precursor,6451
NP_034218.1,306478,27345736,27354064,1,13,Mus_musculus,Prl8a2,"prolactin family 8, subfamily a, member 2 isoform 1 precursor",8328
NP_079808.1,306479,27383451,27390776,-1,13,Mus_musculus,Prl2b1,prolactin-2B1 precursor,7325
NP_035297.1,306480,27432982,27438588,-1,13,Mus_musculus,Prl8a6,prolactin-8A6 isoform b precursor,5606
NP_076230.1,306481,27507181,27513154,-1,13,Mus_musculus,Prl8a8,prolactin-8A8 precursor,5973
NP_075821.1,306482,27558150,27564546,-1,13,Mus_musculus,Prl8a9,prolactin-8A9 precursor,6396
NP_082753.1,306483,27574001,27582110,-1,13,Mus_musculus,Prl8a1,"prolactin family 8, subfamily a, member 1 precursor",8109
NP_083631.1,306484,27601927,27610522,-1,13,Mus_musculus,Prl7b1,prolactin-7B1 precursor,8595
NP_032956.1,306485,27633478,27642450,-1,13,Mus_musculus,Prl7a1,prolactin-7A1 isoform 2 precursor,8972
NP_035298.1,306486,27659056,27667994,-1,13,Mus_musculus,Prl7a2,prolactin-7A2 precursor,8938
NP_035250.1,306487,27709191,27716669,-1,13,Mus_musculus,Prl7d1,prolactin-7D1 precursor,7478
NP_080482.1,306488,27773699,27780749,-1,13,Mus_musculus,Prl7c1,prolactin-7C1 precursor,7050
NP_064375.1,306489,27801702,27808581,1,13,Mus_musculus,Prl2a1,prolactin-2A1 precursor,6879
NP_001038997.1,306490,27849401,27857683,1,13,Mus_musculus,Prl2c1,"Prolactin family 2, subfamily c, member 1 precursor",8282
NP_035295.1,306491,28016272,28023428,1,13,Mus_musculus,Prl4a1,prolactin-4A1 precursor,7156
NP_076235.1,306492,28142542,28151302,1,13,Mus_musculus,Prl5a1,prolactin-5A1 precursor,8760
XP_011242668.1,306493,28356621,28364256,-1,13,Mus_musculus,Gm3821,LOW QUALITY PROTEIN: prolactin-2A1-like,7635
XP_011242666.1,306494,28836870,28837724,1,13,Mus_musculus,LOC105245385,60S ribosomal protein L7a-like,854
NP_033264.2,306495,28951698,28953021,-1,13,Mus_musculus,Sox4,transcription factor SOX-4,1323
XP_006516886.1,306496,28959568,29008838,1,13,Mus_musculus,Gm34747,uncharacterized protein Gm34747,49270
NP_653119.1,306497,29326036,29850108,-1,13,Mus_musculus,Cdkal1,threonylcarbamoyladenosine tRNA methylthiotransferase,524072
NP_001276849.1,306498,29909902,29984145,-1,13,Mus_musculus,E2f3,transcription factor E2F3 isoform E2f3b,74243
NP_705774.1,306499,30136666,30245469,1,13,Mus_musculus,Mboat1,lysophospholipid acyltransferase 1,108803
NP_796296.1,306500,30380953,30382033,1,13,Mus_musculus,Agtr1a,type-1A angiotensin II receptor,1080
NP_079986.1,306501,30540730,30545247,-1,13,Mus_musculus,Uqcrfs1,"cytochrome b-c1 complex subunit Rieske, mitochondrial",4517
NP_001033044.1,306502,30660125,30708859,1,13,Mus_musculus,Dusp22,dual specificity protein phosphatase 22 isoform a,48734
NP_038702.1,306503,30750579,30763667,1,13,Mus_musculus,Irf4,interferon regulatory factor 4,13088
NP_079864.1,306504,30815297,30940727,-1,13,Mus_musculus,Exoc2,exocyst complex component 2,125430
NP_694712.1,306505,30946843,30947674,-1,13,Mus_musculus,Hus1b,checkpoint protein HUS1B,831
NP_032265.3,306506,31558916,31560119,1,13,Mus_musculus,Foxq1,forkhead box protein Q1,1203
NP_034355.2,306507,31626079,31630645,1,13,Mus_musculus,Foxf2,forkhead box protein F2,4566
NP_032618.2,306508,31807207,31808869,1,13,Mus_musculus,Foxc1,forkhead box protein C1,1662
NP_666153.1,306509,31819915,32338483,-1,13,Mus_musculus,Gmds,"GDP-mannose 4,6 dehydratase",518568
NP_001159502.1,306510,32708904,32781716,-1,13,Mus_musculus,Mylk4,myosin light chain kinase family member 4,72812
NP_084491.3,306511,32802237,32822159,1,13,Mus_musculus,Wrnip1,ATPase WRNIP1,19922
NP_079705.2,306512,32842817,32850406,-1,13,Mus_musculus,Serpinb1a,leukocyte elastase inhibitor A,7589
NP_766639.2,306513,32881832,32897098,-1,13,Mus_musculus,Serpinb1c,leukocyte elastase inhibitor C,15266
NP_035584.1,306514,32968509,32978353,1,13,Mus_musculus,Serpinb6b,"serine (or cysteine) proteinase inhibitor, clade B, member 6b",9844
NP_033282.1,306515,33006542,33015848,1,13,Mus_musculus,Serpinb9,"serine (or cysteine) proteinase inhibitor, clade B, member 9",9306
NP_035582.1,306516,33029461,33039960,1,13,Mus_musculus,Serpinb9b,"serine (or cysteine) proteinase inhibitor, clade B, member 9b",10499
NP_766640.1,306517,33085285,33093934,1,13,Mus_musculus,Serpinb1b,leukocyte elastase inhibitor B,8649
NP_035583.1,306518,33149977,33157824,-1,13,Mus_musculus,Serpinb9c,"serine (or cysteine) proteinase inhibitor, clade B, member 9c isoform 2",7847
NP_035590.1,306519,33194572,33203084,1,13,Mus_musculus,Serpinb9d,"serine (or cysteine) proteinase inhibitor, clade B, member 9d",8512
NP_035586.1,306520,33251585,33260132,1,13,Mus_musculus,Serpinb9e,"serine (or cysteine) proteinase inhibitor, clade B, member 9e",8547
NP_899020.1,306521,33325826,33334652,1,13,Mus_musculus,Serpinb9f,"serine (or cysteine) proteinase inhibitor, clade B, member 9f",8826
XP_619089.4,306522,33395770,33404567,1,13,Mus_musculus,Gm11397,serpin B9,8797
NP_035585.2,306523,33486530,33495282,1,13,Mus_musculus,Serpinb9g,"serine (or cysteine) proteinase inhibitor, clade B, member 9g",8752
NP_001070258.1,306524,33664054,33671472,1,13,Mus_musculus,Serpinb6d,"serine (or cysteine) peptidase inhibitor, clade B, member 6d",7418
NP_001039000.2,306525,33832458,33841306,-1,13,Mus_musculus,Serpinb6e,"serine (or cysteine) peptidase inhibitor, clade B, member 6e",8848
NP_683744.2,306526,33879930,33899429,-1,13,Mus_musculus,Serpinb6c,serine proteinase inhibitor member 6C,19499
NP_001157590.1,306527,33918040,33931636,-1,13,Mus_musculus,Serpinb6a,serpin B6 isoform b,13596
NP_001156713.1,306528,33968270,33985492,1,13,Mus_musculus,Nqo2,ribosyldihydronicotinamide dehydrogenase [quinone] isoform 1,17222
NP_033094.3,306529,34009656,34032782,1,13,Mus_musculus,Ripk1,receptor-interacting serine/threonine-protein kinase 1,23126
NP_080788.1,306530,34037662,34073763,1,13,Mus_musculus,Bphl,valacyclovir hydrolase precursor,36101
NP_033476.1,306531,34074467,34077929,-1,13,Mus_musculus,Tubb2a,tubulin beta-2A chain,3462
NP_076205.1,306532,34127470,34130233,-1,13,Mus_musculus,Tubb2b,tubulin beta-2B chain,2763
NP_001103985.1,306533,34163075,34178055,1,13,Mus_musculus,Psmg4,proteasome assembly chaperone 4 isoform a,14980
NP_001028339.1,306534,34182953,34344797,-1,13,Mus_musculus,Slc22a23,solute carrier family 22 member 23,161844
NP_080107.3,306535,34628770,34652435,-1,13,Mus_musculus,Pxdc1,PX domain-containing protein 1,23665
NP_620085.2,306536,34746542,34747547,1,13,Mus_musculus,Fam50b,protein FAM50B,1005
NP_038858.2,306537,34875653,34901596,1,13,Mus_musculus,Prpf4b,serine/threonine-protein kinase PRP4 homolog,25943
NP_082243.1,306538,34910241,34915716,-1,13,Mus_musculus,Fam217a,protein FAM217A,5475
NP_080026.2,306539,34924536,34952964,1,13,Mus_musculus,4933417A18Rik,uncharacterized protein C6orf201 homolog,28428
NP_081223.1,306540,34946928,34960478,-1,13,Mus_musculus,Eci3,enoyl-Coenzyme A delta isomerase 3,13550
NP_035998.2,306541,34977910,34993175,-1,13,Mus_musculus,Eci2,"enoyl-CoA delta isomerase 2, mitochondrial isoform b",15265
NP_034011.1,306542,35669945,35872670,1,13,Mus_musculus,Cdyl,chromodomain Y-like protein isoform 1,202725
NP_666050.3,306543,35896726,35906326,-1,13,Mus_musculus,Rpp40,ribonuclease P protein subunit p40,9600
NP_083904.1,306544,35968598,35969642,1,13,Mus_musculus,Ppp1r3g,protein phosphatase 1 regulatory subunit 3G,1044
NP_958746.1,306545,35979838,36117160,-1,13,Mus_musculus,Lyrm4,LYR motif-containing protein 4,137322
NP_077236.1,306546,36204529,36537439,1,13,Mus_musculus,Fars2,"phenylalanine--tRNA ligase, mitochondrial isoform 1",332910
NP_705757.1,306547,36726627,36734290,-1,13,Mus_musculus,Nrn1,neuritin precursor,7663
NP_001159863.1,306548,36868764,37047486,-1,13,Mus_musculus,F13a1,coagulation factor XIII A chain precursor,178722
NP_034875.1,306549,37345438,37418622,1,13,Mus_musculus,Ly86,lymphocyte antigen 86 precursor,73184
NP_001171339.1,306550,37893813,37932542,1,13,Mus_musculus,Rreb1,ras-responsive element-binding protein 1 isoform 1,38729
NP_080241.3,306551,37979738,37994083,-1,13,Mus_musculus,Ssr1,translocon-associated protein subunit alpha precursor,14345
NP_082000.2,306552,38006088,38032472,-1,13,Mus_musculus,Cage1,cancer-associated gene 1 protein homolog,26384
NP_077204.2,306553,38037460,38060865,1,13,Mus_musculus,Riok1,serine/threonine-protein kinase RIO1,23405
NP_076331.2,306554,38151588,38197932,1,13,Mus_musculus,Dsp,desmoplakin,46344
NP_080658.2,306555,38204972,38226922,1,13,Mus_musculus,Snrnp48,U11/U12 small nuclear ribonucleoprotein 48 kDa protein,21950
NP_031582.1,306556,38345932,38499068,1,13,Mus_musculus,Bmp6,bone morphogenetic protein 6 precursor,153136
NP_001276527.1,306557,38501585,38523417,-1,13,Mus_musculus,Txndc5,thioredoxin domain-containing protein 5 isoform 2,21832
NP_620702.1,306558,38603848,38635041,-1,13,Mus_musculus,Bloc1s5,biogenesis of lysosome-related organelles complex 1 subunit 5,31193
NP_079656.1,306559,38646169,38658993,-1,13,Mus_musculus,Eef1e1,eukaryotic translation elongation factor 1 epsilon-1,12824
NP_598821.1,306560,38932765,38955849,-1,13,Mus_musculus,Slc35b3,adenosine 3'-phospho 5'-phosphosulfate transporter 2 isoform 2,23084
NP_742155.2,306561,40001888,40287983,-1,13,Mus_musculus,Ofcc1,orofacial cleft 1 candidate gene 1 protein homolog,286095
NP_001116420.1,306562,40717114,40730065,-1,13,Mus_musculus,Tfap2a,transcription factor AP-2-alpha isoform 3,12951
NP_076376.3,306563,40860354,40958342,1,13,Mus_musculus,Gcnt2,"N-acetyllactosaminide beta-1,6-N-acetylglucosaminyl-transferase isoform B",97988
NP_080826.2,306564,41001329,41012749,1,13,Mus_musculus,Pak1ip1,p21-activated protein kinase-interacting protein 1,11420
NP_079663.1,306565,41017150,41022160,1,13,Mus_musculus,Tmem14c,transmembrane protein 14C,5010
NP_001139274.1,306566,41026407,41070237,-1,13,Mus_musculus,Mak,serine/threonine-protein kinase MAK isoform 3,43830
NP_032130.2,306567,41102756,41109954,-1,13,Mus_musculus,Gcm2,chorion-specific transcription factor GCMb,7198
XP_011242735.1,306568,41114418,41121379,1,13,Mus_musculus,LOC105245509,synaptonemal complex protein 2-like,6961
NP_062296.1,306569,41185293,41220357,-1,13,Mus_musculus,Elovl2,elongation of very long chain fatty acids protein 2,35064
NP_001129049.1,306570,41250238,41272756,1,13,Mus_musculus,Smim13,small integral membrane protein 13,22518
NP_059492.3,306571,41311660,41358864,-1,13,Mus_musculus,Nedd9,enhancer of filamentation 1 isoform 2,47204
NP_001157044.1,306572,41606215,41634586,1,13,Mus_musculus,Tmem170b,transmembrane protein 170B,28371
NP_808476.2,306573,41656011,41656428,1,13,Mus_musculus,Gm5082,uncharacterized protein LOC328231,417
NP_001139347.1,306574,41764757,41828295,-1,13,Mus_musculus,Adtrp,androgen-dependent TFPI-regulating protein isoform 2,63538
NP_031798.2,306575,42055502,42184513,1,13,Mus_musculus,Hivep1,zinc finger protein 40,129011
NP_034234.1,306576,42301894,42306879,1,13,Mus_musculus,Edn1,endothelin-1 precursor,4985
NP_001289564.1,306577,42682697,43135189,1,13,Mus_musculus,Phactr1,phosphatase and actin regulator 1 isoform 4,452492
NP_001239569.1,306578,43151893,43169913,-1,13,Mus_musculus,Tbc1d7,TBC1 domain family member 7 isoform 2,18020
NP_001028571.1,306579,43200324,43303497,-1,13,Mus_musculus,Gfod1,glucose-fructose oxidoreductase domain-containing protein 1 precursor,103173
NP_849179.1,306580,43370753,43394812,1,13,Mus_musculus,Sirt5,"NAD-dependent protein deacylase sirtuin-5, mitochondrial",24059
NP_076043.2,306581,43398404,43401841,1,13,Mus_musculus,Nol7,nucleolar protein 7,3437
NP_064314.2,306582,43403558,43480928,-1,13,Mus_musculus,Ranbp9,ran-binding protein 9,77370
NP_001074528.1,306583,43541673,43560126,-1,13,Mus_musculus,Mcur1,mitochondrial calcium uniporter regulator 1,18453
NP_899027.1,306584,43667974,43668718,1,13,Mus_musculus,Rnf182,E3 ubiquitin-protein ligase RNF182,744
NP_001276844.1,306585,43785213,43799688,1,13,Mus_musculus,Cd83,CD83 antigen isoform 2 precursor,14475
NP_068678.1,306586,44731871,44919952,1,13,Mus_musculus,Jarid2,protein Jumonji,188081
NP_080048.2,306587,44922206,45001972,-1,13,Mus_musculus,Dtnbp1,dysbindin,79766
NP_722484.2,306588,45389956,45410510,1,13,Mus_musculus,Mylip,E3 ubiquitin-protein ligase MYLIP,20554
NP_079784.1,306589,45507656,45546053,1,13,Mus_musculus,Gmpr,GMP reductase 1,38397
NP_001186233.1,306590,45557054,45568417,-1,13,Mus_musculus,Atxn1,ataxin-1 isoform b,11363
NP_001005422.1,306591,46273817,46299689,1,13,Mus_musculus,Stmnd1,stathmin domain-containing protein 1,25872
NP_001074894.1,306592,46419030,46429317,1,13,Mus_musculus,Rbm24,RNA-binding protein 24,10287
NP_080332.1,306593,46525415,46648364,1,13,Mus_musculus,Cap2,adenylyl cyclase-associated protein 2,122949
NP_001028364.1,306594,46669585,46675656,1,13,Mus_musculus,C78339,protein FAM8A1,6071
NP_786925.2,306595,46681157,46727473,-1,13,Mus_musculus,Nup153,nucleoporin 153,46316
NP_034747.2,306596,46750605,46929621,-1,13,Mus_musculus,Kif13a,kinesin-like protein KIF13A,179016
NP_780549.1,306597,47013573,47014779,-1,13,Mus_musculus,Nhlrc1,E3 ubiquitin-protein ligase NHLRC1,1206
NP_058065.2,306598,47025364,47041523,-1,13,Mus_musculus,Tpmt,thiopurine S-methyltransferase,16159
NP_758466.1,306599,47047915,47082958,1,13,Mus_musculus,Kdm1b,lysine-specific histone demethylase 1B,35043
NP_080176.2,306600,47086067,47105728,-1,13,Mus_musculus,Dek,protein DEK,19661
NP_666154.3,306601,47207385,47244501,1,13,Mus_musculus,Rnf144b,E3 ubiquitin-protein ligase RNF144B,37116
NP_112443.1,306602,48261497,48262329,1,13,Mus_musculus,Id4,DNA-binding protein inhibitor ID-4,832
NP_001158048.1,306603,48489201,48506939,-1,13,Mus_musculus,Zfp169,GLI-Kruppel family member HKR1 isoform b,17738
XP_001473814.1,306604,48514223,48514727,1,13,Mus_musculus,A830005F24Rik,uncharacterized protein A830005F24Rik,504
NP_997115.1,306605,48579735,48606354,-1,13,Mus_musculus,Ptpdc1,protein tyrosine phosphatase domain-containing protein 1 isoform 2,26619
NP_031552.2,306606,48663116,48665992,1,13,Mus_musculus,Barx1,homeobox protein BarH-like 1,2876
NP_035208.2,306607,48803598,48870765,-1,13,Mus_musculus,Phf2,lysine-specific demethylase PHF2,67167
NP_001028440.2,306608,48880795,48967828,-1,13,Mus_musculus,Fam120a,constitutive coactivator of PPAR-gamma-like protein 1,87033
NP_083637.2,306609,49036479,49147232,-1,13,Mus_musculus,Wnk2,serine/threonine-protein kinase WNK2 isoform c,110753
NP_038638.1,306610,49187562,49195048,1,13,Mus_musculus,Ninj1,ninjurin-1,7486
NP_081014.1,306611,49203119,49215943,-1,13,Mus_musculus,1110007C09Rik,bcl10-interacting CARD protein,12824
NP_079767.2,306612,49231135,49248132,-1,13,Mus_musculus,Susd3,sushi domain-containing protein 3 isoform 1,16997
NP_056574.2,306613,49263783,49296771,-1,13,Mus_musculus,Fgd3,"FYVE, RhoGEF and PH domain-containing protein 3",32988
NP_001034268.1,306614,49341670,49383352,1,13,Mus_musculus,Bicd2,protein bicaudal D homolog 2 isoform 1,41682
NP_951011.1,306615,49421385,49461759,1,13,Mus_musculus,Ippk,inositol-pentakisphosphate 2-kinase isoform a,40374
NP_079771.1,306616,49464209,49652689,-1,13,Mus_musculus,Cenpp,centromere protein P,188480
NP_001012324.1,306617,49514822,49531431,1,13,Mus_musculus,Ecm2,extracellular matrix protein 2 precursor,16609
NP_079987.2,306618,49551663,49566631,1,13,Mus_musculus,Aspn,asporin preproprotein,14968
NP_036180.1,306619,49589475,49592387,1,13,Mus_musculus,Omd,osteomodulin precursor,2912
NP_032786.1,306620,49609183,49622983,1,13,Mus_musculus,Ogn,mimecan precursor,13800
NP_001258326.1,306621,49653645,49678436,1,13,Mus_musculus,Nol8,nucleolar protein 8,24791
NP_742012.2,306622,49687392,49733741,1,13,Mus_musculus,Iars,"isoleucine--tRNA ligase, cytoplasmic",46349
XP_011242736.1,306623,49750605,49752406,1,13,Mus_musculus,Gm19334,LOW QUALITY PROTEIN: zinc finger protein 484,1801
XP_006517067.2,306624,49764495,49766106,1,13,Mus_musculus,LOC102638985,sperm motility kinase X-like,1611
XP_006517059.1,306625,49784899,49790200,-1,13,Mus_musculus,Gm30302,spermatogenesis-associated protein 31A6-like,5301
XP_006517055.1,306626,49820662,49828950,1,13,Mus_musculus,LOC102631805,serine/threonine-protein kinase par-1-like,8288
XP_006517054.1,306627,49858763,49864130,-1,13,Mus_musculus,Gm8672,spermatogenesis-associated protein 31A6-like,5367
XP_006517060.1,306628,49899188,49904648,-1,13,Mus_musculus,Gm8674,spermatogenesis-associated protein 31A6-like,5460
XP_011242737.1,306629,50054760,50069183,-1,13,Mus_musculus,LOC667541,LOW QUALITY PROTEIN: uncharacterized protein LOC667541,14423
XP_011242738.1,306630,50196053,50196939,1,13,Mus_musculus,LOC105242434,uncharacterized protein LOC105242434,886
NP_001028610.1,306631,50245234,50250264,-1,13,Mus_musculus,Gm906,uncharacterized protein LOC380882,5030
XP_006517068.1,306632,50399484,50400423,-1,13,Mus_musculus,Gm19536,uncharacterized protein Gm19536,939
XP_011242739.1,306633,50412062,50414577,-1,13,Mus_musculus,Gm8742,LOW QUALITY PROTEIN: uncharacterized protein Gm8742,2515
NP_780610.2,306634,50417897,50433406,1,13,Mus_musculus,Fbxw17,F-box and WD-40 domain protein 17,15509
NP_001028572.1,306635,50467400,50475103,1,13,Mus_musculus,Nutm2,NUT family member Gm806,7703
NP_001028942.1,306636,50643271,50645542,1,13,Mus_musculus,Gm904,uncharacterized protein LOC380845,2271
NP_001231578.1,306637,50698355,50703381,1,13,Mus_musculus,Gm8765,uncharacterized protein LOC667693,5026
NP_666155.1,306638,51123236,51149161,1,13,Mus_musculus,Spin1,spindlin-1 isoform 2,25925
NP_083449.1,306639,51171322,51174793,1,13,Mus_musculus,Nxnl2,nucleoredoxin-like protein 2,3471
XP_006517069.1,306640,51202687,51203068,-1,13,Mus_musculus,Hist1h2al,histone H2A type 2-A,381
NP_034231.1,306641,51418784,51419921,1,13,Mus_musculus,S1pr3,sphingosine 1-phosphate receptor 3,1137
NP_033193.2,306642,51431152,51567084,-1,13,Mus_musculus,Shc3,SHC-transforming protein 3,135932
NP_079691.1,306643,51645412,51650389,1,13,Mus_musculus,Cks2,cyclin-dependent kinases regulatory subunit 2,4977
NP_083555.1,306644,51651784,51683381,1,13,Mus_musculus,Secisbp2,selenocysteine insertion sequence-binding protein 2,31597
NP_038688.2,306645,51702608,51725329,-1,13,Mus_musculus,Sema4d,semaphorin-4D precursor,22721
NP_035947.2,306646,51846779,51847979,1,13,Mus_musculus,Gadd45g,growth arrest and DNA damage-inducible protein GADD45 gamma,1200
NP_001019645.1,306647,52507669,52508269,-1,13,Mus_musculus,Diras2,GTP-binding protein Di-Ras2,600
NP_001185906.1,306648,52610838,52645795,1,13,Mus_musculus,Syk,tyrosine-protein kinase SYK,34957
NP_057918.2,306649,52835473,52929641,-1,13,Mus_musculus,Auh,"methylglutaconyl-CoA hydratase, mitochondrial precursor",94168
NP_059069.1,306650,52967477,52968866,-1,13,Mus_musculus,Nfil3,nuclear factor interleukin-3-regulated protein,1389
NP_038874.3,306651,53110219,53285877,-1,13,Mus_musculus,Ror2,tyrosine-protein kinase transmembrane receptor ROR2 precursor,175658
NP_033295.2,306652,53333883,53377349,-1,13,Mus_musculus,Sptlc1,serine palmitoyltransferase 1,43466
XP_011242734.1,306653,53415983,53419007,-1,13,Mus_musculus,LOC102641557,spermatogenesis-associated protein 31A3-like,3024
NP_038629.2,306654,53468168,53472710,-1,13,Mus_musculus,Msx2,homeobox protein MSX-2,4542
NP_034206.1,306655,54052852,54054193,-1,13,Mus_musculus,Drd1,D(1A) dopamine receptor,1341
NP_081600.1,306656,54085459,54106603,1,13,Mus_musculus,Sfxn1,sideroflexin-1,21144
NP_032312.2,306657,54214006,54215083,1,13,Mus_musculus,Hrh2,histamine H2 receptor isoform 2,1077
NP_034076.1,306658,54378668,54379709,1,13,Mus_musculus,Cplx2,complexin-2,1041
NP_082873.2,306659,54460073,54468807,-1,13,Mus_musculus,Thoc3,THO complex subunit 3,8734
NP_795961.3,306660,54503875,54550633,1,13,Mus_musculus,Simc1,uncharacterized protein LOC319719,46758
NP_001239577.1,306661,54552611,54552982,-1,13,Mus_musculus,4833439L19Rik,putative monooxygenase p33MONOX isoform 4,371
NP_064352.2,306662,54575094,54580894,1,13,Mus_musculus,Arl10,ADP-ribosylation factor-like protein 10,5800
NP_848720.1,306663,54585280,54589967,-1,13,Mus_musculus,Nop16,nucleolar protein 16,4687
NP_080209.1,306664,54590265,54590890,1,13,Mus_musculus,Higd2a,HIG1 domain family member 2A,625
NP_083146.1,306665,54593870,54611264,-1,13,Mus_musculus,Cltb,clathrin light chain B,17394
NP_848484.2,306666,54621840,54661136,1,13,Mus_musculus,Faf2,FAS-associated factor 2,39296
NP_598825.2,306667,54681748,54684014,-1,13,Mus_musculus,Rnf44,RING finger protein 44 isoform 4,2266
NP_001028536.2,306668,54712627,54736580,1,13,Mus_musculus,Cdhr2,protocadherin 24 precursor,23953
NP_036144.2,306669,54737660,54740459,-1,13,Mus_musculus,Gprin1,G protein-regulated inducer of neurite outgrowth 1,2799
NP_291088.1,306670,54759508,54765683,-1,13,Mus_musculus,Sncb,beta-synuclein,6175
NP_001273109.1,306671,54784015,54786955,1,13,Mus_musculus,Eif4e1b,eukaryotic translation initiation factor 4E type 1B isoform 5,2940
NP_083117.2,306672,54789594,54796222,1,13,Mus_musculus,Tspan17,tetraspanin-17,6628
NP_694771.1,306673,54949661,55004971,1,13,Mus_musculus,Unc5a,netrin receptor UNC5A precursor,55310
NP_001193321.1,306674,55006170,55015060,-1,13,Mus_musculus,Hk3,hexokinase-3 isoform 3,8890
NP_001280589.1,306675,55028519,55093273,-1,13,Mus_musculus,Uimc1,BRCA1-A complex subunit RAP80 isoform 2,64754
NP_036147.1,306676,55105343,55132394,1,13,Mus_musculus,Zfp346,zinc finger protein 346,27051
NP_032037.2,306677,55155489,55168175,1,13,Mus_musculus,Fgfr4,fibroblast growth factor receptor 4 precursor,12686
NP_032765.3,306678,55213220,55313728,1,13,Mus_musculus,Nsd1,"histone-lysine N-methyltransferase, H3 lysine-36 and H4 lysine-20 specific",100508
NP_033026.1,306679,55320149,55321654,-1,13,Mus_musculus,Rab24,ras-related protein Rab-24,1505
NP_079872.4,306680,55322189,55324972,1,13,Mus_musculus,Prelid1,"PRELI domain-containing protein 1, mitochondrial precursor",2783
NP_057871.2,306681,55325782,55329667,-1,13,Mus_musculus,Mxd3,max dimerization protein 3,3885
NP_080104.2,306682,55346876,55362589,-1,13,Mus_musculus,Lman2,vesicular integral-membrane protein VIP36 precursor,15713
NP_058038.2,306683,55369891,55384135,1,13,Mus_musculus,Rgs14,regulator of G-protein signaling 14,14244
NP_035522.2,306684,55400457,55413637,1,13,Mus_musculus,Slc34a1,sodium-dependent phosphate transport protein 2A,13180
NP_083579.1,306685,55414752,55415166,-1,13,Mus_musculus,Pfn3,profilin-3,414
NP_067464.2,306686,55418098,55426768,-1,13,Mus_musculus,F12,coagulation factor XII precursor,8670
NP_036068.2,306687,55445508,55459338,1,13,Mus_musculus,Grk6,G protein-coupled receptor kinase 6 isoform b,13830
NP_001025467.1,306688,55472024,55472990,1,13,Mus_musculus,Prr7,proline-rich protein 7,966
NP_062787.2,306689,55474222,55487948,-1,13,Mus_musculus,Dbn1,drebrin isoform 3,13726
NP_001107560.1,306690,55498647,55512407,-1,13,Mus_musculus,Pdlim7,PDZ and LIM domain protein 7 isoform a,13760
NP_038767.1,306691,55523421,55528514,-1,13,Mus_musculus,Dok3,docking protein 3,5093
NP_598820.2,306692,55530594,55536507,-1,13,Mus_musculus,Ddx41,probable ATP-dependent RNA helicase DDX41,5913
NP_663357.2,306693,55541624,55556096,-1,13,Mus_musculus,Fam193b,protein FAM193B,14472
NP_080487.2,306694,55593173,55596990,1,13,Mus_musculus,Tmed9,transmembrane emp24 domain-containing protein 9 precursor,3817
NP_666157.1,306695,55600142,55609374,1,13,Mus_musculus,B4galt7,"beta-1,4-galactosyltransferase 7",9232
NP_031622.2,306696,55623090,55632000,1,13,Mus_musculus,Caml,calcium signal-modulating cyclophilin ligand,8910
NP_001268984.1,306697,55635178,55678831,1,13,Mus_musculus,Ddx46,probable ATP-dependent RNA helicase DDX46,43653
NP_851795.1,306698,55699075,55699642,1,13,Mus_musculus,B230219D22Rik,UPF0461 protein C5orf24 homolog,567
NP_780359.2,306699,55714777,55725863,1,13,Mus_musculus,Txndc15,thioredoxin domain-containing protein 15 precursor,11086
NP_082557.1,306700,55727372,55776700,1,13,Mus_musculus,Pcbd2,pterin-4-alpha-carbinolamine dehydratase 2,49328
NP_001239416.1,306701,55784661,55808919,1,13,Mus_musculus,Catsper3,cation channel sperm-associated protein 3 isoform 1,24258
NP_035227.1,306702,55826068,55830940,-1,13,Mus_musculus,Pitx1,pituitary homeobox 1,4872
NP_001152987.1,306703,56074226,56128448,-1,13,Mus_musculus,H2afy,core histone macro-H2A.1 isoform 4,54222
NP_666088.1,306704,56176184,56176628,-1,13,Mus_musculus,Tifab,TRAF-interacting protein with FHA domain-containing protein B,444
NP_035026.1,306705,56251197,56251932,-1,13,Mus_musculus,Neurog1,neurogenin-1,735
NP_062514.2,306706,56289791,56296173,-1,13,Mus_musculus,Cxcl14,C-X-C motif chemokine 14 precursor,6382
NP_808477.2,306707,56438489,56470472,1,13,Mus_musculus,Slc25a48,solute carrier family 25 member 48,31983
NP_032399.1,306708,56479362,56482231,-1,13,Mus_musculus,Il9,interleukin-9 precursor,2869
NP_848789.2,306709,56526915,56537467,1,13,Mus_musculus,Fbxl21,F-box/LRR-repeat protein 21,10552
NP_034832.2,306710,56542704,56548362,-1,13,Mus_musculus,Lect2,leukocyte cell-derived chemotaxin-2 precursor,5658
NP_033395.1,306711,56609646,56638757,1,13,Mus_musculus,Tgfbi,transforming growth factor-beta-induced protein ig-h3 precursor,29111
NP_001157513.1,306712,56723593,56737478,1,13,Mus_musculus,Smad5,mothers against decapentaplegic homolog 5,13885
NP_001289302.1,306713,56773763,56822614,-1,13,Mus_musculus,Trpc7,short transient receptor potential channel 7 isoform 3 precursor,48851
NP_001159937.1,306714,57423089,57907587,-1,13,Mus_musculus,Spock1,testican-1 isoform 5 precursor,484498
NP_001182004.1,306715,58005175,58102428,-1,13,Mus_musculus,Klhl3,kelch-like protein 3,97253
NP_084148.1,306716,58127395,58128313,-1,13,Mus_musculus,Hnrnpa0,heterogeneous nuclear ribonucleoprotein A0,918
NP_001041525.1,306717,58157686,58163519,1,13,Mus_musculus,Idnk,probable gluconokinase isoform b,5833
NP_689420.1,306718,58177875,58215436,-1,13,Mus_musculus,Ubqln1,ubiquilin-1 isoform 2,37561
NP_062806.1,306719,58233610,58264157,-1,13,Mus_musculus,Gkap1,G kinase-anchoring protein 1,30547
NP_780423.2,306720,58287792,58354862,-1,13,Mus_musculus,Kif27,kinesin-like protein KIF27,67070
NP_081611.1,306721,58381779,58385154,-1,13,Mus_musculus,2210016F16Rik,uncharacterized protein LOC70153,3375
NP_001288274.1,306722,58392385,58400390,-1,13,Mus_musculus,Hnrnpk,heterogeneous nuclear ribonucleoprotein K isoform 4,8005
NP_083180.3,306723,58407938,58409789,1,13,Mus_musculus,Rmi1,recQ-mediated genome instability protein 1,1851
NP_071712.3,306724,58555689,58610807,-1,13,Mus_musculus,Slc28a3,solute carrier family 28 member 3,55118
NP_032771.1,306725,58808728,58932060,1,13,Mus_musculus,Ntrk2,BDNF/NT-3 growth factors receptor isoform b precursor,123332
NP_001271148.1,306726,59450136,59514200,-1,13,Mus_musculus,Agtpbp1,cytosolic carboxypeptidase 1 isoform 3,64064
NP_084429.2,306727,59586157,59634477,1,13,Mus_musculus,Naa35,"N-alpha-acetyltransferase 35, NatC auxiliary subunit",48320
NP_001030294.1,306728,59637291,59665655,-1,13,Mus_musculus,Golm1,Golgi membrane protein 1,28364
NP_899113.1,306729,59689459,59691629,-1,13,Mus_musculus,4921517D22Rik,uncharacterized protein LOC70900,2170
NP_082433.2,306730,59700301,59706150,-1,13,Mus_musculus,Spata31d1a,uncharacterized protein LOC72219,5849
NP_001161065.1,306731,59712314,59719125,1,13,Mus_musculus,Spata31d1b,uncharacterized protein LOC238662,6811
NP_808379.2,306732,59725975,59731720,-1,13,Mus_musculus,Spata31d1d,uncharacterized protein LOC238663,5745
XP_006517548.1,306733,59741052,59744004,-1,13,Mus_musculus,LOC102638268,spermatogenesis-associated protein 31D1,2952
NP_081197.1,306734,59756854,59769704,-1,13,Mus_musculus,Isca1,"iron-sulfur cluster assembly 1 homolog, mitochondrial precursor",12850
NP_705766.3,306735,59778798,59822079,-1,13,Mus_musculus,Zcchc6,terminal uridylyltransferase 7,43281
NP_032112.1,306736,60175786,60176941,-1,13,Mus_musculus,Gas1,growth arrest-specific protein 1,1155
NP_598823.1,306737,60602534,60761867,1,13,Mus_musculus,Dapk1,death-associated protein kinase 1 isoform 1,159333
NP_954599.2,306738,60782154,60785145,-1,13,Mus_musculus,BC051665,uncharacterized protein LOC218275 precursor,2991
NP_081620.2,306739,60798499,60801415,-1,13,Mus_musculus,Ctsll3,cathepsin L-like 3 precursor,2916
NP_835199.1,306740,60842876,60854938,-1,13,Mus_musculus,4930486L24Rik,testin-2 precursor,12062
NP_031823.1,306741,60895710,60896714,-1,13,Mus_musculus,Ctla2b,protein CTLA-2-beta isoform a,1004
NP_080705.1,306742,60901554,60902635,-1,13,Mus_musculus,Tpbpb,trophoblast specific protein beta precursor,1081
NP_001139271.1,306743,60935019,60936044,-1,13,Mus_musculus,Ctla2a,protein CTLA-2-alpha isoform b,1025
NP_033437.2,306744,60939605,60940688,-1,13,Mus_musculus,Tpbpa,trophoblast-specific protein alpha precursor,1083
NP_036137.1,306745,61000476,61004550,-1,13,Mus_musculus,Ctsj,cathepsin J precursor,4074
NP_083912.2,306746,61035294,61039552,-1,13,Mus_musculus,Ctsq,cathepsin Q precursor,4258
NP_064680.1,306747,61159475,61163230,-1,13,Mus_musculus,Ctsr,cathepsin R precursor,3755
NP_067420.1,306748,61195400,61202265,-1,13,Mus_musculus,Cts6,cathepsin 6 precursor,6865
NP_062414.3,306749,61248153,61254081,-1,13,Mus_musculus,Cts8,cathepsin 8 precursor,5928
NP_062412.1,306750,61352735,61357036,-1,13,Mus_musculus,Cts7,cathepsin 7 precursor,4301
NP_071721.2,306751,61536554,61540313,-1,13,Mus_musculus,Ctsm,cathepsin M precursor,3759
NP_081182.2,306752,61564905,61568820,-1,13,Mus_musculus,Cts3,cathepsin 3 precursor,3915
XP_006517550.1,306753,61630595,61636300,1,13,Mus_musculus,LOC102639567,zinc finger protein 468-like,5705
XP_011242906.1,306754,61912786,61914649,1,13,Mus_musculus,Gm36349,zinc finger protein 431-like,1863
XP_011242895.1,306755,61979152,61993227,1,13,Mus_musculus,Gm21935,LOW QUALITY PROTEIN: zinc finger protein 781-like,14075
NP_001034328.2,306756,62130025,62173220,1,13,Mus_musculus,Zfp808,zinc finger protein 80,43195
NP_001156382.1,306757,62368862,62383082,-1,13,Mus_musculus,Gm3604,uncharacterized protein LOC100041979,14220
NP_849206.2,306758,62454322,62466709,-1,13,Mus_musculus,Zfp935,KRAB zinc finger protein isoform 1,12387
NP_780461.2,306759,62517499,62520451,-1,13,Mus_musculus,Zfp934,zinc finger protein 934 isoform 2,2952
NP_775557.1,306760,62605189,62624040,-1,13,Mus_musculus,6720489N17Rik,uncharacterized protein LOC211378,18851
XP_011242900.1,306761,62640560,62653105,-1,13,Mus_musculus,Gm36298,zinc finger protein 120-like,12545
NP_001242994.1,306762,62773607,62785683,-1,13,Mus_musculus,Gm5141,zinc-finger protein 80-like,12076
NP_032020.2,306763,62837085,62858297,-1,13,Mus_musculus,Fbp2,"fructose-1,6-bisphosphatase isozyme 2",21212
NP_062268.1,306764,62864975,62888043,-1,13,Mus_musculus,Fbp1,"fructose-1,6-bisphosphatase 1",23068
NP_001276853.1,306765,63015166,63298852,1,13,Mus_musculus,2010111I01Rik,aminopeptidase O,283686
NP_001269871.1,306766,63312665,63398136,-1,13,Mus_musculus,Fancc,Fanconi anemia group C protein homolog isoform 2,85471
NP_032983.1,306767,63511532,63565520,-1,13,Mus_musculus,Ptch1,protein patched homolog 1,53988
NP_075996.2,306768,63815474,63869184,1,13,Mus_musculus,Ercc6l2,DNA excision repair protein ERCC-6-like 2 isoform 2,53710
NP_032317.2,306769,64058568,64089128,-1,13,Mus_musculus,Hsd17b3,testosterone 17-beta-dehydrogenase 3,30560
NP_001001321.2,306770,64097581,64129307,-1,13,Mus_musculus,Slc35d2,UDP-N-acetylglucosamine/UDP-glucose/GDP-mannose transporter,31726
NP_780703.1,306771,64135313,64152989,-1,13,Mus_musculus,Zfp367,zinc finger protein 367,17676
NP_064370.2,306772,64161985,64185329,1,13,Mus_musculus,Habp4,intracellular hyaluronan-binding protein 4,23344
NP_001116461.1,306773,64205302,64248453,-1,13,Mus_musculus,Cdc14b,dual specificity protein phosphatase CDC14B isoform 2,43151
NP_079646.1,306774,64292100,64312684,-1,13,Mus_musculus,Aaed1,thioredoxin-like protein AAED1,20584
NP_034114.1,306775,64364097,64369153,-1,13,Mus_musculus,Ctsl,cathepsin L1 preproprotein,5056
NP_444410.1,306776,64432595,64438978,1,13,Mus_musculus,Cdk20,cyclin-dependent kinase 20,6383
NP_001182364.1,306777,64481763,64486000,-1,13,Mus_musculus,1190003K10Rik,uncharacterized protein LOC68880,4237
NP_001074598.1,306778,64738546,64903840,-1,13,Mus_musculus,Cntnap3,contactin-associated protein-like 3 precursor,165294
NP_084323.2,306779,64917482,64923084,1,13,Mus_musculus,Spata31,spermatogenesis-associated protein 31,5602
NP_001077359.2,306780,65033088,65037207,1,13,Mus_musculus,Spata31d1c,uncharacterized protein LOC238683,4119
NP_598441.3,306781,65066612,65112617,-1,13,Mus_musculus,Hiatl1,hippocampus abundant transcript-like protein 1,46005
NP_667030.2,306782,65152225,65153152,1,13,Mus_musculus,Olfr466,olfactory receptor 466,927
NP_780499.3,306783,65181563,65199442,-1,13,Mus_musculus,Nlrp4f,"NACHT, LRR and PYD domains-containing protein 4F",17879
NP_848141.3,306784,65278971,65297582,1,13,Mus_musculus,Zfp369,neurotrophin receptor-interacting factor 2,18611
XP_006517561.1,306785,65397567,65415024,-1,13,Mus_musculus,Gm31714,zinc finger protein 431-like,17457
XP_011242902.1,306786,65510450,65512944,1,13,Mus_musculus,LOC102634499,zinc finger protein 120-like,2494
XP_006517562.2,306787,65545851,65557594,-1,13,Mus_musculus,Gm19428,zinc finger protein 431-like,11743
NP_001171303.1,306788,66113557,66122836,1,13,Mus_musculus,Gm10324,zinc finger protein family member,9279
NP_898942.1,306789,66418244,66441022,-1,13,Mus_musculus,2410141K09Rik,zinc finger protein-like isoform b,22778
XP_011242903.1,306790,66850721,66862027,-1,13,Mus_musculus,LOC105245545,zinc finger protein 431-like,11306
NP_080495.1,306791,66900748,66905311,-1,13,Mus_musculus,Uqcrb,cytochrome b-c1 complex subunit 7,4563
NP_001171221.1,306792,66907944,66908256,1,13,Mus_musculus,Gm10767,uncharacterized protein LOC100038538,312
NP_079823.2,306793,66912183,66930203,-1,13,Mus_musculus,Mterf3,"transcription termination factor 3, mitochondrial precursor",18020
NP_032985.2,306794,66933507,66997077,1,13,Mus_musculus,Ptdss1,phosphatidylserine synthase 1,63570
NP_001159690.1,306795,67040343,67061068,-1,13,Mus_musculus,Zfp712,zinc finger protein 712,20725
NP_001278995.1,306796,67070167,67074866,-1,13,Mus_musculus,Zfp708,zinc finger protein 708 isoform d,4699
NP_001242981.1,306797,67098163,67113981,-1,13,Mus_musculus,Rslcan18,regulator of sex-limitation candidate 18,15818
NP_765980.3,306798,67128308,67140552,1,13,Mus_musculus,Zfp759,zinc finger protein 759,12244
NP_001013791.1,306799,67173217,67182947,1,13,Mus_musculus,Rsl1,regulator of sex limited protein 1,9730
NP_001041669.1,306800,67194588,67208055,1,13,Mus_musculus,Zfp455,zinc finger protein 455,13467
NP_001001152.1,306801,67256114,67269036,-1,13,Mus_musculus,Zfp458,zinc finger protein 728,12922
NP_001003666.2,306802,67292565,67306355,-1,13,Mus_musculus,Zfp457,zinc finger protein 457,13790
NP_808290.1,306803,67316328,67332472,-1,13,Mus_musculus,Zfp595,zin finger protein 595,16144
NP_001033740.1,306804,67342971,67360509,-1,13,Mus_musculus,Zfp953,zinc finger protein 953,17538
NP_001001186.3,306805,67366208,67372874,-1,13,Mus_musculus,Zfp456,zinc finger protein 456,6666
NP_001074410.1,306806,67389865,67399731,-1,13,Mus_musculus,Zfp429,zinc finger protein 429,9866
NP_808479.1,306807,67408158,67413957,-1,13,Mus_musculus,Zfp459,zinc finger protein 459,5799
NP_808380.1,306808,67442219,67451517,-1,13,Mus_musculus,Zfp874a,zinc finger protein 874,9298
NP_001070259.1,306809,67473833,67484146,-1,13,Mus_musculus,Zfp874b,zinc finger protein 874b,10313
NP_001007576.1,306810,67490900,67494726,-1,13,Mus_musculus,Zfp58,zinc finger protein 58,3826
NP_573491.2,306811,67516718,67526082,-1,13,Mus_musculus,Zfp87,zinc finger protein 87,9364
NP_001030308.1,306812,67540472,67553036,-1,13,Mus_musculus,Zfp748,zinc finger protein 748,12564
NP_001156718.1,306813,67591006,67609578,-1,13,Mus_musculus,AA987161,zinc finger protein,18572
NP_898969.2,306814,67619186,67637682,-1,13,Mus_musculus,A530054K11Rik,uncharacterized protein LOC212281,18496
NP_001001187.2,306815,67669488,67683438,-1,13,Mus_musculus,Zfp738,zinc finger protein 738,13950
NP_663597.1,306816,67707985,67729066,-1,13,Mus_musculus,Zfp65,"zinc finger protein 71, related sequence",21081
NP_001001130.1,306817,67748529,67755068,-1,13,Mus_musculus,Zfp85,zinc finger protein 85,6539
NP_082678.2,306818,67779813,67787084,1,13,Mus_musculus,Zfp493,regulator of sex-limitation candidate 12,7271
NP_938081.2,306819,67813890,67826260,1,13,Mus_musculus,Zfp273,zinc finger protein 273,12370
NP_001001185.1,306820,67863505,67863775,1,13,Mus_musculus,BC048507,dynein light chain LC8-type 1-like,270
XP_011242904.1,306821,67885468,67890777,-1,13,Mus_musculus,LOC105245547,uncharacterized protein LOC105245547,5309
XP_987269.2,306822,67951818,67952544,1,13,Mus_musculus,Gm7969,uncharacterized protein Gm7969,726
XP_011242907.1,306823,68360436,68372468,1,13,Mus_musculus,LOC105245579,LOW QUALITY PROTEIN: uncharacterized protein LOC105245579,12032
NP_766068.1,306824,68562287,68580679,-1,13,Mus_musculus,Mtrr,methionine synthase reductase,18392
NP_081399.3,306825,68583561,68592029,1,13,Mus_musculus,Fastkd3,FAST kinase domain-containing protein 3,8468
NP_081311.1,306826,68597475,68613009,1,13,Mus_musculus,1700001L19Rik,uncharacterized protein C5orf49 homolog,15534
NP_705762.2,306827,68620719,68999295,-1,13,Mus_musculus,Adcy2,adenylate cyclase type 2,378576
NP_001162602.1,306828,69499915,69515869,-1,13,Mus_musculus,Papd7,non-canonical poly(A) RNA polymerase PAPD7 isoform 2,15954
NP_780492.2,306829,69575129,69611247,-1,13,Mus_musculus,Srd5a1,3-oxo-5-alpha-steroid 4-dehydrogenase 1,36118
NP_663329.3,306830,69612092,69633851,1,13,Mus_musculus,Nsun2,tRNA (cytosine(34)-C(5))-methyltransferase,21759
NP_001138634.1,306831,69704041,69739340,-1,13,Mus_musculus,Ube2ql1,ubiquitin-conjugating enzyme E2Q-like protein 1,35299
NP_613062.1,306832,69809930,69815689,1,13,Mus_musculus,Med10,mediator of RNA polymerase II transcription subunit 10,5759
NP_659086.2,306833,70589600,70637597,-1,13,Mus_musculus,Ice1,little elongation complex subunit 1,47997
NP_742050.2,306834,70728851,70841549,-1,13,Mus_musculus,Adamts16,A disintegrin and metalloproteinase with thrombospondin motifs 16 precursor,112698
NP_084149.1,306835,70883475,70884239,1,13,Mus_musculus,8030423J24Rik,uncharacterized protein LOC77166,764
NP_034703.2,306836,71958615,71963488,-1,13,Mus_musculus,Irx1,iroquois-class homeodomain protein IRX-1,4873
NP_034704.1,306837,72629061,72632638,1,13,Mus_musculus,Irx2,iroquois-class homeodomain protein IRX-2,3577
NP_061373.1,306838,73264934,73269034,1,13,Mus_musculus,Irx4,iroquois-class homeodomain protein IRX-4,4100
NP_035018.1,306839,73319994,73328446,-1,13,Mus_musculus,Ndufs6,"NADH dehydrogenase [ubiquinone] iron-sulfur protein 6, mitochondrial precursor",8452
NP_444393.1,306840,73331372,73331681,1,13,Mus_musculus,Mrpl36,"39S ribosomal protein L36, mitochondrial",309
NP_663351.3,306841,73467382,73514538,1,13,Mus_musculus,Lpcat1,lysophosphatidylcholine acyltransferase 1,47156
NP_034150.1,306842,73538515,73577233,1,13,Mus_musculus,Slc6a3,sodium-dependent dopamine transporter,38718
NP_666159.2,306843,73604237,73620117,1,13,Mus_musculus,Clptm1l,cleft lip and palate transmembrane protein 1-like protein,15880
NP_033380.1,306844,73627029,73649013,1,13,Mus_musculus,Tert,telomerase reverse transcriptase,21984
NP_001129559.1,306845,73664121,73677929,-1,13,Mus_musculus,Slc6a18,sodium-dependent neutral amino acid transporter B(0)AT3 isoform 2,13808
NP_083154.1,306846,73681628,73700633,-1,13,Mus_musculus,Slc6a19,sodium-dependent neutral amino acid transporter B(0)AT1,19005
NP_082056.1,306847,73700035,73708960,1,13,Mus_musculus,Slc6a19os,uncharacterized protein LOC71390,8925
NP_035520.1,306848,73763766,73814934,1,13,Mus_musculus,Slc12a7,solute carrier family 12 member 7,51168
NP_082462.3,306849,73820959,73847427,-1,13,Mus_musculus,Nkd2,protein naked cuticle homolog 2,26468
NP_081458.1,306850,73913243,73937581,-1,13,Mus_musculus,Trip13,pachytene checkpoint protein 2 homolog,24338
NP_001019679.2,306851,73937893,73960338,1,13,Mus_musculus,Brd9,bromodomain-containing protein 9,22445
NP_081980.1,306852,73963920,73992642,1,13,Mus_musculus,Zdhhc11,probable palmitoyltransferase ZDHHC11,28722
NP_878259.1,306853,74021142,74031415,1,13,Mus_musculus,Tppp,tubulin polymerization-promoting protein,10273
NP_083235.3,306854,74038162,74062262,-1,13,Mus_musculus,Cep72,centrosomal protein of 72 kDa,24100
NP_001074529.1,306855,74121514,74166064,1,13,Mus_musculus,Slc9a3,sodium/hydrogen exchanger 3 precursor,44550
NP_796307.2,306856,74172072,74207080,-1,13,Mus_musculus,Exoc3,exocyst complex component 3,35008
NP_033774.1,306857,74213656,74283101,-1,13,Mus_musculus,Ahrr,aryl hydrocarbon receptor repressor,69445
NP_035181.1,306858,74303949,74317207,-1,13,Mus_musculus,Pdcd6,programmed cell death protein 6,13258
NP_075770.1,306859,74323086,74350208,-1,13,Mus_musculus,Sdha,"succinate dehydrogenase [ubiquinone] flavoprotein subunit, mitochondrial precursor",27122
NP_077163.1,306860,74352865,74357117,1,13,Mus_musculus,Ccdc127,coiled-coil domain-containing protein 127 isoform 1,4252
NP_001028214.1,306861,74360753,74363959,-1,13,Mus_musculus,Lrrc14b,leucine-rich repeat-containing protein 14B,3206
NP_001075149.1,306862,74371649,74376469,-1,13,Mus_musculus,Zfp72,zinc finger protein 72,4820
NP_666343.1,306863,74480516,74493852,-1,13,Mus_musculus,Zfp825,zinc finger protein 124,13336
NP_109636.1,306864,74646223,74690729,1,13,Mus_musculus,Erap1,endoplasmic reticulum aminopeptidase 1 precursor,44506
NP_001288089.1,306865,74695898,74734177,-1,13,Mus_musculus,Cast,calpastatin isoform 7,38279
NP_038656.1,306866,75090061,75132319,1,13,Mus_musculus,Pcsk1,neuroendocrine convertase 1 precursor,42258
NP_620403.2,306867,75707650,75770796,1,13,Mus_musculus,Ell2,RNA polymerase II elongation factor ELL2,63146
NP_444338.2,306868,75839968,75847286,1,13,Mus_musculus,Glrx,glutaredoxin-1,7318
NP_082769.1,306869,75872345,75943532,-1,13,Mus_musculus,Rhobtb3,rho-related BTB domain-containing protein 3,71187
NP_083619.1,306870,75967833,75998769,1,13,Mus_musculus,Spata9,spermatogenesis-associated protein 9,30936
NP_849247.3,306871,76002824,76008285,-1,13,Mus_musculus,Rfesd,Rieske domain-containing protein,5461
NP_780704.1,306872,76055540,76056824,-1,13,Mus_musculus,Gpr150,probable G-protein coupled receptor 150,1284
NP_084123.2,306873,76062255,76098508,-1,13,Mus_musculus,Arsk,arylsulfatase K precursor,36253
NP_001074821.1,306874,76108193,76187674,1,13,Mus_musculus,Ttc37,tetratricopeptide repeat protein 37,79481
XP_011242909.1,306875,76384317,76385232,-1,13,Mus_musculus,Gm10760,mediator of RNA polymerase II transcription subunit 26,915
NP_084450.2,306876,76641765,77029951,1,13,Mus_musculus,Mctp1,"multiple C2 domains, transmembrane 1",388186
NP_598832.3,306877,77043548,77126714,-1,13,Mus_musculus,Ankrd32,ankyrin repeat domain-containing protein 32,83166
NP_001074822.1,306878,77174853,77193228,1,13,Mus_musculus,2210408I21Rik,uncharacterized protein KIAA0825 homolog isoform 2,18375
NP_612185.1,306879,77742780,78163655,1,13,Mus_musculus,Fam172a,protein FAM172A isoform 1 precursor,420875
NP_034281.2,306880,78189732,78198573,-1,13,Mus_musculus,Nr2f1,COUP transcription factor 1,8841
NP_001036056.1,306881,80883649,80893426,1,13,Mus_musculus,Arrdc3,arrestin domain-containing protein 3,9777
NP_473394.3,306882,81095382,81633028,-1,13,Mus_musculus,Gpr98,G-protein coupled receptor 98 precursor,537646
NP_084533.1,306883,81665014,81669823,1,13,Mus_musculus,Lysmd3,lysM and putative peptidoglycan-binding domain-containing protein 3,4809
NP_001074645.1,306884,81676035,81699860,-1,13,Mus_musculus,Polr3g,DNA-directed RNA polymerase III subunit RPC7,23825
NP_082648.1,306885,81711528,81750346,1,13,Mus_musculus,Mblac2,metallo-beta-lactamase domain-containing protein 2,38818
NP_031710.1,306886,81783340,81796697,1,13,Mus_musculus,Cetn3,centrin-3,13357
NP_001164008.1,306887,83575676,83662631,1,13,Mus_musculus,Mef2c,myocyte-specific enhancer factor 2C isoform 1,86955
NP_780396.2,306888,84222431,84294880,1,13,Mus_musculus,Tmem161b,transmembrane protein 161B,72449
NP_075732.1,306889,85189535,85212778,1,13,Mus_musculus,Ccnh,cyclin-H,23243
NP_663427.2,306890,85216103,85288907,-1,13,Mus_musculus,Rasa1,RAS p21 protein activator 1,72804
NP_031775.1,306891,86045752,86046675,-1,13,Mus_musculus,Cox7c,"cytochrome c oxidase subunit 7C, mitochondrial precursor",923
NP_001033076.1,306892,88821981,89319820,1,13,Mus_musculus,Edil3,EGF-like repeat and discoidin I-like domain-containing protein 3 isoform a precursor,497839
NP_038528.3,306893,89584721,89608149,1,13,Mus_musculus,Hapln1,hyaluronan and proteoglycan link protein 1 precursor,23428
NP_001127947.1,306894,89657230,89731528,-1,13,Mus_musculus,Vcan,versican core protein isoform 4 precursor,74298
NP_082288.1,306895,89849357,90071679,-1,13,Mus_musculus,Xrcc4,DNA repair protein XRCC4,222322
NP_079611.2,306896,90089780,90104445,1,13,Mus_musculus,Tmem167,protein kish-A precursor,14665
NP_001139351.1,306897,90883550,90905292,-1,13,Mus_musculus,Atp6ap1l,"predicted gene, EG435376 precursor",21742
NP_077137.1,306898,90923195,90924683,1,13,Mus_musculus,Rps23,40S ribosomal protein S23,1488
NP_080046.3,306899,90936602,91208422,-1,13,Mus_musculus,Atg10,ubiquitin-like-conjugating enzyme ATG10,271820
NP_077234.2,306900,91461186,91700695,1,13,Mus_musculus,Ssbp2,single-stranded DNA-binding protein 2 isoform 2,239509
NP_083066.1,306901,91741530,91784780,1,13,Mus_musculus,Acot12,acyl-coenzyme A thioesterase 12,43250
NP_663428.2,306902,91797135,91806134,-1,13,Mus_musculus,Zcchc9,zinc finger CCHC domain-containing protein 9,8999
NP_940807.1,306903,91853528,91865333,-1,13,Mus_musculus,Ckmt2,"creatine kinase S-type, mitochondrial precursor",11805
NP_033053.2,306904,91884431,91988042,-1,13,Mus_musculus,Rasgrf2,ras-specific guanine nucleotide-releasing factor 2,103611
NP_034959.2,306905,92212434,92354900,-1,13,Mus_musculus,Msh3,DNA mismatch repair protein Msh3,142466
NP_034179.1,306906,92355258,92384803,1,13,Mus_musculus,Dhfr,dihydrofolate reductase,29545
NP_780664.2,306907,92438261,92439788,1,13,Mus_musculus,Ankrd34b,ankyrin repeat domain-containing protein 34B,1527
NP_001157099.1,306908,92450083,92483952,-1,13,Mus_musculus,Fam151b,uncharacterized protein LOC73942,33869
NP_775568.1,306909,92488461,92524299,-1,13,Mus_musculus,Zfyve16,zinc finger FYVE domain-containing protein 16,35838
NP_084513.3,306910,92574829,92575966,-1,13,Mus_musculus,Spz1,spermatogenic leucine zipper protein 1,1137
NP_766176.1,306911,92611260,92708137,1,13,Mus_musculus,Serinc5,serine incorporator 5,96877
NP_035712.1,306912,92751750,92794673,-1,13,Mus_musculus,Thbs4,thrombospondin-4 precursor,42923
NP_001156417.1,306913,92844786,92852894,1,13,Mus_musculus,Mtx3,metaxin-3,8108
NP_076310.2,306914,93041313,93144506,-1,13,Mus_musculus,Cmya5,cardiomyopathy-associated protein 5,103193
NP_598666.1,306915,93147590,93186439,-1,13,Mus_musculus,Papd4,poly(A) RNA polymerase GLD2,38849
NP_036112.1,306916,93305297,93356113,1,13,Mus_musculus,Homer1,homer protein homolog 1 isoform S,50816
NP_067285.2,306917,93439441,93499306,-1,13,Mus_musculus,Jmy,junction-mediating and -regulatory protein,59865
XP_889797.1,306918,93448487,93448835,1,13,Mus_musculus,Gm6109,60S ribosomal protein L30-like,348
NP_057877.1,306919,93617475,93637496,-1,13,Mus_musculus,Bhmt,betaine--homocysteine S-methyltransferase 1,20021
NP_075022.2,306920,93657062,93674270,-1,13,Mus_musculus,Bhmt2,S-methylmethionine--homocysteine S-methyltransferase BHMT2,17208
NP_083048.1,306921,93674446,93752465,1,13,Mus_musculus,Dmgdh,"dimethylglycine dehydrogenase, mitochondrial precursor",78019
NP_033842.3,306922,93771777,93940731,1,13,Mus_musculus,Arsb,arylsulfatase B precursor,168954
NP_766177.1,306923,94174223,94192101,1,13,Mus_musculus,Lhfpl2,lipoma HMGIC fusion partner-like 2 protein,17878
NP_083429.1,306924,94203998,94285276,-1,13,Mus_musculus,Scamp1,secretory carrier-associated membrane protein 1,81278
NP_033810.2,306925,94359103,94565758,1,13,Mus_musculus,Ap3b1,AP-3 complex subunit beta-1,206655
NP_033347.1,306926,94788949,94842730,1,13,Mus_musculus,Tbca,tubulin-specific chaperone A,53781
NP_035151.1,306927,94875769,94883620,1,13,Mus_musculus,Otp,homeobox protein orthopedia,7851
NP_766178.2,306928,94976538,95021825,1,13,Mus_musculus,Wdr41,WD repeat-containing protein 41,45287
XP_011243012.1,306929,95012471,95013218,-1,13,Mus_musculus,LOC105245591,endochitinase A-like,747
NP_001164140.1,306930,95026119,95222813,-1,13,Mus_musculus,Pde8b,"high affinity cAMP-specific and IBMX-insensitive 3',5'-cyclic phosphodiesterase 8B isoform 1",196694
NP_082382.1,306931,95336069,95336756,1,13,Mus_musculus,Zbed3,zinc finger BED domain-containing protein 3,687
NP_079906.2,306932,95351501,95375058,-1,13,Mus_musculus,Aggf1,angiogenic factor with G patch and FHA domains 1,23557
NP_940800.1,306933,95431936,95444680,-1,13,Mus_musculus,Crhbp,corticotropin-releasing factor-binding protein precursor,12744
NP_001074628.1,306934,95477300,95478655,-1,13,Mus_musculus,S100z,protein S100-Z,1355
NP_032000.3,306935,95513172,95525127,-1,13,Mus_musculus,F2rl1,proteinase-activated receptor 2 precursor,11955
NP_034299.2,306936,95603732,95618374,-1,13,Mus_musculus,F2r,proteinase-activated receptor 1 precursor,14642
NP_081987.1,306937,95628006,95891709,-1,13,Mus_musculus,Iqgap2,ras GTPase-activating-like protein IQGAP2,263703
NP_034300.3,306938,95697063,95701558,1,13,Mus_musculus,F2rl2,proteinase-activated receptor 3 precursor,4495
NP_083486.1,306939,95961279,96088799,-1,13,Mus_musculus,Sv2c,synaptic vesicle glycoprotein 2C,127520
NP_080449.1,306940,96391597,96414619,1,13,Mus_musculus,Poc5,centrosomal protein POC5,23022
NP_001036179.1,306941,96417838,96470948,-1,13,Mus_musculus,Ankdd1b,ankyrin repeat and death domain-containing protein 1B,53110
NP_036178.1,306942,96482169,96519160,-1,13,Mus_musculus,Polk,DNA polymerase kappa,36991
NP_075909.1,306943,96543163,96635877,1,13,Mus_musculus,Col4a3bp,collagen type IV alpha-3-binding protein isoform 1,92714
NP_032281.2,306944,96650578,96666685,-1,13,Mus_musculus,Hmgcr,3-hydroxy-3-methylglutaryl-coenzyme A reductase,16107
NP_001159537.1,306945,96946197,96947565,1,13,Mus_musculus,Gcnt4,"beta-1,3-galactosyl-O-glycosyl-glycoprotein beta-1,6-N-acetylglucosaminyltransferase 4",1368
NP_001271134.1,306946,97022450,97034265,-1,13,Mus_musculus,1700029F12Rik,uncharacterized protein LOC66479 isoform 3,11815
NP_001093928.1,306947,97091820,97127038,1,13,Mus_musculus,Fam169a,soluble lamin-associated protein of 75 kDa,35218
NP_067527.3,306948,97131160,97137757,-1,13,Mus_musculus,Nsa2,ribosome biogenesis protein NSA2 homolog,6597
NP_796240.3,306949,97141947,97175737,1,13,Mus_musculus,Gfm2,"ribosome-releasing factor 2, mitochondrial isoform 1",33790
NP_034552.1,306950,97176528,97198261,-1,13,Mus_musculus,Hexb,beta-hexosaminidase subunit beta precursor,21733
NP_031956.3,306951,97244983,97246753,1,13,Mus_musculus,Enc1,ectoderm-neural cortex protein 1,1770
NP_036156.2,306952,97899646,98145584,-1,13,Mus_musculus,Arhgef28,rho guanine nucleotide exchange factor 28,245938
NP_849249.1,306953,98249128,98260888,-1,13,Mus_musculus,Utp15,U3 small nucleolar RNA-associated protein 15 homolog,11760
NP_001258317.1,306954,98266246,98272884,1,13,Mus_musculus,Ankra2,ankyrin repeat family A protein 2 isoform a,6638
NP_001164011.1,306955,98310154,98316298,-1,13,Mus_musculus,Btf3,transcription factor BTF3 isoform 2,6144
NP_032268.2,306956,98354619,98355990,1,13,Mus_musculus,Foxd1,forkhead box protein D1,1371
NP_080961.1,306957,98636407,98637320,-1,13,Mus_musculus,Tmem174,transmembrane protein 174,913
NP_001020777.1,306958,98686320,98692640,-1,13,Mus_musculus,Tmem171,transmembrane protein 171,6320
NP_766179.2,306959,98725753,98815108,-1,13,Mus_musculus,Fcho2,FCH domain only protein 2,89355
NP_001041732.1,306960,98846455,98890781,-1,13,Mus_musculus,Tnpo1,transportin-1 isoform 2,44326
XP_011243013.1,306961,98926330,98929086,1,13,Mus_musculus,LOC105245603,choline O-acetyltransferase-like,2756
NP_081340.1,306962,98984144,98984516,-1,13,Mus_musculus,1700024P04Rik,histone H2B subacrosomal variant,372
XP_011243014.1,306963,98988927,98992317,-1,13,Mus_musculus,LOC105245604,endogenous retrovirus group K member 113 Pol protein-like,3390
NP_001004149.1,306964,99228332,99246571,1,13,Mus_musculus,Zfp366,zinc finger protein 366,18239
NP_081149.1,306965,99320168,99344669,-1,13,Mus_musculus,Ptcd2,"pentatricopeptide repeat-containing protein 2, mitochondrial",24501
NP_776118.2,306966,99344802,99414978,1,13,Mus_musculus,Mrps27,"28S ribosomal protein S27, mitochondrial",70176
NP_032660.2,306967,99425805,99516487,-1,13,Mus_musculus,Map1b,microtubule-associated protein 1B,90682
NP_001074962.1,306968,99898918,99900634,-1,13,Mus_musculus,Cartpt,cocaine- and amphetamine-regulated transcript protein isoform 2 preproprotein,1716
NP_084302.1,306969,99948838,100015514,-1,13,Mus_musculus,Mccc2,"methylcrotonoyl-CoA carboxylase beta chain, mitochondrial",66676
NP_001074530.1,306970,100020278,100103838,-1,13,Mus_musculus,Bdp1,transcription factor TFIIIB component B'' homolog,83560
NP_035483.1,306971,100108222,100114037,1,13,Mus_musculus,Serf1,small EDRK-rich factor 1,5815
NP_035550.1,306972,100124893,100135736,1,13,Mus_musculus,Smn1,survival motor neuron protein isoform 1,10843
NP_035002.2,306973,100144358,100189398,-1,13,Mus_musculus,Naip2,baculoviral IAP repeat-containing protein 1b,45040
NP_035000.2,306974,100212606,100246199,-1,13,Mus_musculus,Naip5,baculoviral IAP repeat-containing protein 1e,33593
NP_035001.2,306975,100283548,100316551,-1,13,Mus_musculus,Naip6,baculoviral IAP repeat-containing protein 1f,33003
NP_032696.2,306976,100408806,100444737,-1,13,Mus_musculus,Naip1,baculoviral IAP repeat-containing protein 1a,35931
NP_071294.3,306977,100468906,100490131,-1,13,Mus_musculus,Gtf2h2,general transcription factor IIH subunit 2,21225
NP_032782.1,306978,100498813,100541117,-1,13,Mus_musculus,Ocln,occludin,42304
NP_001033691.1,306979,100597288,100612569,-1,13,Mus_musculus,Marveld2,MARVEL domain-containing protein 2 isoform 1,15281
NP_001269940.1,306980,100617643,100633910,-1,13,Mus_musculus,Rad17,cell cycle checkpoint protein RAD17 isoform 2,16267
NP_081868.1,306981,100651417,100666019,1,13,Mus_musculus,Ak6,adenylate kinase isoenzyme 6,14602
NP_001161858.1,306982,100677913,100696118,1,13,Mus_musculus,Ccdc125,coiled-coil domain-containing protein 125 isoform B,18205
NP_034004.2,306983,100703477,100730839,-1,13,Mus_musculus,Cdk7,cyclin-dependent kinase 7,27362
NP_001177193.1,306984,100736255,100744568,-1,13,Mus_musculus,Mrps36,"28S ribosomal protein S36, mitochondrial isoform 2",8313
NP_068686.1,306985,100760101,100775802,-1,13,Mus_musculus,Cenph,centromere protein H,15701
NP_758505.2,306986,100779677,100786402,-1,13,Mus_musculus,Ccnb1,G2/mitotic-specific cyclin-B1,6725
NP_075023.2,306987,100803290,100833177,-1,13,Mus_musculus,Slc30a5,zinc transporter 5,29887
XP_003084990.1,306988,100946404,100946815,-1,13,Mus_musculus,Gm10257,histone H3.3-like,411
NP_001020126.1,306989,101684879,101692288,-1,13,Mus_musculus,Pik3r1,phosphatidylinositol 3-kinase regulatory subunit alpha isoform 1,7409
NP_032559.2,306990,102693699,102706433,1,13,Mus_musculus,Cd180,CD180 antigen precursor,12734
NP_780380.2,306991,102735001,103334192,-1,13,Mus_musculus,Mast4,microtubule-associated serine/threonine-protein kinase 4,599191
XP_011243020.1,306992,103340695,103461769,-1,13,Mus_musculus,LOC105245653,uncharacterized protein LOC105245653,121074
NP_766180.1,306993,103743563,103763953,-1,13,Mus_musculus,Srek1,splicing regulatory glutamine/lysine-rich protein 1,20390
NP_001276403.1,306994,103820698,103886329,-1,13,Mus_musculus,Erbb2ip,protein LAP2 isoform 4,65631
NP_083723.1,306995,104024945,104109456,-1,13,Mus_musculus,Nln,"neurolysin, mitochondrial precursor",84511
NP_659087.1,306996,104111089,104139851,1,13,Mus_musculus,Sgtb,small glutamine-rich tetratricopeptide repeat-containing protein beta,28762
NP_001087229.1,306997,104144137,104178159,-1,13,Mus_musculus,Trappc13,trafficking protein particle complex subunit 13 isoform 3,34022
NP_109656.1,306998,104181052,104201410,1,13,Mus_musculus,Trim23,E3 ubiquitin-protein ligase TRIM23,20358
NP_766395.2,306999,104205503,104228801,-1,13,Mus_musculus,Ppwd1,peptidylprolyl isomerase domain and WD repeat-containing protein 1,23298
NP_068562.1,307000,104229585,104249519,1,13,Mus_musculus,Cenpk,centromere protein K isoform 1,19934
NP_001074489.1,307001,104294727,104493704,1,13,Mus_musculus,Adamts6,A disintegrin and metalloproteinase with thrombospondin motifs 6 precursor,198977
NP_080348.1,307002,104631575,104816728,-1,13,Mus_musculus,Cwc27,peptidyl-prolyl cis-trans isomerase CWC27 homolog,185153
NP_080351.2,307003,104817353,104837548,1,13,Mus_musculus,Srek1ip1,protein SREK1IP1,20195
NP_084260.1,307004,104845935,104863713,-1,13,Mus_musculus,Fam159b,membrane protein FAM159B,17778
NP_084155.2,307005,104951490,105054214,-1,13,Mus_musculus,Rgs7bp,regulator of G-protein signaling 7-binding protein,102724
NP_080027.1,307006,105082159,105121421,1,13,Mus_musculus,4933425L06Rik,uncharacterized protein LOC66763,39262
NP_082210.1,307007,105149351,105271039,-1,13,Mus_musculus,Rnf180,E3 ubiquitin-protein ligase RNF180,121688
NP_032334.2,307008,105444253,105445519,1,13,Mus_musculus,Htr1a,5-hydroxytryptamine receptor 1A,1266
XP_011243018.1,307009,106712221,106760764,-1,13,Mus_musculus,Gm30411,uncharacterized protein Gm30411,48543
NP_083941.2,307010,106795630,106925150,-1,13,Mus_musculus,Ipo11,importin-11,129520
NP_079723.1,307011,106947204,106958697,1,13,Mus_musculus,Dimt1,probable dimethyladenosine transferase,11493
NP_032468.2,307012,106962138,106993925,-1,13,Mus_musculus,Kif2a,kinesin-like protein KIF2A isoform 1,31787
NP_663431.2,307013,107726434,107890049,-1,13,Mus_musculus,Zswim6,zinc finger SWIM domain-containing protein 6,163615
NP_001041715.1,307014,108047461,108047686,1,13,Mus_musculus,Smim15,small integral membrane protein 15,225
NP_001120818.1,307015,108052705,108158569,-1,13,Mus_musculus,Ndufaf2,"mimitin, mitochondrial",105864
NP_082318.2,307016,108158793,108194124,1,13,Mus_musculus,Ercc8,DNA excision repair protein ERCC-8,35331
NP_083277.3,307017,108256734,108282681,1,13,Mus_musculus,Elovl7,elongation of very long chain fatty acids protein 7,25947
NP_848798.1,307018,108316421,108388702,1,13,Mus_musculus,Depdc1b,DEP domain-containing protein 1B,72281
NP_035186.1,307019,108860165,109951344,1,13,Mus_musculus,Pde4d,"cAMP-specific 3',5'-cyclic phosphodiesterase 4D",1091179
NP_076341.1,307020,110061814,110280018,-1,13,Mus_musculus,Rab3c,ras-related protein Rab-3C,218204
NP_808381.1,307021,110353653,110354127,-1,13,Mus_musculus,Gapt,protein GAPT,474
NP_690017.2,307022,110395176,110400224,1,13,Mus_musculus,Plk2,serine/threonine-protein kinase PLK2,5048
NP_780706.1,307023,111255132,111256263,1,13,Mus_musculus,Actbl2,beta-actin-like protein 2,1131
NP_001116435.1,307024,111426492,111466913,-1,13,Mus_musculus,Gpbp1,vasculin isoform 1,40421
NP_766181.2,307025,111686345,111715141,1,13,Mus_musculus,Mier3,mesoderm induction early response protein 3,28796
NP_036075.2,307026,111748899,111808969,-1,13,Mus_musculus,Map3k1,mitogen-activated protein kinase kinase kinase 1,60070
NP_001161877.1,307027,112288927,112344228,1,13,Mus_musculus,Ankrd55,ankyrin repeat domain-containing protein 55 isoform 4,55301
NP_034690.3,307028,112475045,112504445,1,13,Mus_musculus,Il6st,interleukin-6 receptor subunit beta precursor,29400
NP_647460.2,307029,112523902,112559202,-1,13,Mus_musculus,Il31ra,interleukin-31 receptor subunit alpha precursor,35300
NP_034159.1,307030,112598944,112651403,-1,13,Mus_musculus,Ddx4,probable ATP-dependent RNA helicase DDX4 isoform 2,52459
NP_848861.1,307031,112669621,112731664,1,13,Mus_musculus,Slc38a9,putative sodium-coupled neutral amino acid transporter 9,62043
NP_032273.1,307032,112801208,112867568,1,13,Mus_musculus,Ppap2a,lipid phosphate phosphohydrolase 1 isoform 1,66360
NP_082427.1,307033,112867942,112927357,-1,13,Mus_musculus,Skiv2l2,superkiller viralicidic activity 2-like 2,59415
NP_766182.2,307034,112927792,112969187,1,13,Mus_musculus,Dhx29,ATP-dependent RNA helicase Dhx29,41395
NP_001074531.1,307035,112987897,112990057,1,13,Mus_musculus,Ccno,cyclin-O,2160
NP_001033003.1,307036,112993871,112999184,1,13,Mus_musculus,Mcidas,multicilin,5313
NP_001268416.1,307037,113035378,113091135,1,13,Mus_musculus,Cdc20b,cell division cycle protein 20 homolog B,55757
NP_081403.1,307038,113043135,113046375,-1,13,Mus_musculus,Gpx8,probable glutathione peroxidase 8,3240
NP_034500.1,307039,113093891,113100951,-1,13,Mus_musculus,Gzma,granzyme A precursor,7060
NP_032222.1,307040,113171873,113180897,-1,13,Mus_musculus,Gzmk,granzyme K precursor,9024
NP_076101.1,307041,113209842,113216740,1,13,Mus_musculus,Esm1,endothelial cell-specific molecule 1 precursor,6898
NP_570614.2,307042,113594608,113618395,-1,13,Mus_musculus,Snx18,sorting nexin-18,23787
NP_064344.1,307043,113663027,113663492,-1,13,Mus_musculus,Hspb3,heat shock protein beta-3,465
NP_766183.1,307044,113794648,114154856,1,13,Mus_musculus,Arl15,ADP-ribosylation factor-like protein 15,360208
NP_035017.2,307045,114288762,114388056,-1,13,Mus_musculus,Ndufs4,"NADH dehydrogenase [ubiquinone] iron-sulfur protein 4, mitochondrial",99294
NP_032072.1,307046,114453422,114458586,-1,13,Mus_musculus,Fst,follistatin isoform 2 precursor,5164
NP_038854.2,307047,114818305,114820928,1,13,Mus_musculus,Mocs2,molybdopterin synthase sulfur carrier subunit isoform Mocs2A,2623
NP_032422.2,307048,114836484,114931933,-1,13,Mus_musculus,Itga2,integrin alpha-2 precursor,95449
NP_001028400.2,307049,114960089,115101531,-1,13,Mus_musculus,Itga1,integrin alpha-1 precursor,141442
NP_067434.3,307050,116299479,116309422,-1,13,Mus_musculus,Isl1,insulin gene enhancer protein ISL-1,9943
NP_001074478.1,307051,116855189,117025470,-1,13,Mus_musculus,Parp8,poly [ADP-ribose] polymerase 8,170281
NP_034460.3,307052,117220848,117273062,1,13,Mus_musculus,Emb,embigin precursor,52214
NP_034538.2,307053,117602703,117976234,1,13,Mus_musculus,Hcn1,potassium/sodium hyperpolarization-activated cyclic nucleotide-gated channel 1,373531
NP_067531.1,307054,118380352,118387234,-1,13,Mus_musculus,Mrps30,"28S ribosomal protein S30, mitochondrial",6882
NP_032028.1,307055,118715383,118789316,1,13,Mus_musculus,Fgf10,fibroblast growth factor 10 precursor,73933
NP_663432.1,307056,119429132,119457081,1,13,Mus_musculus,Paip1,polyadenylate-binding protein-interacting protein 1 isoform 1,27949
NP_080403.4,307057,119466103,119485917,1,13,Mus_musculus,4833420G17Rik,uncharacterized protein C5orf34 homolog,19814
NP_001171137.1,307058,119492634,119495470,1,13,Mus_musculus,Gm7120,transmembrane protein C5orf28 homolog precursor,2836
NP_064675.1,307059,119623872,119651066,1,13,Mus_musculus,Ccl28,C-C motif chemokine 28 precursor,27194
NP_666054.2,307060,119699673,119706478,1,13,Mus_musculus,Hmgcs1,"hydroxymethylglutaryl-CoA synthase, cytoplasmic",6805
NP_780747.1,307061,119712045,119727871,-1,13,Mus_musculus,Nim1k,serine/threonine-protein kinase NIM1,15826
NP_082521.1,307062,119766351,119790272,-1,13,Mus_musculus,Zfp131,zinc finger protein 131 isoform 2,23921
NP_001001449.1,307063,119828166,119828658,-1,13,Mus_musculus,AF067063,uncharacterized protein LOC380878,492
NP_061226.1,307064,119893578,119894094,-1,13,Mus_musculus,Tcstv1,"2-cell-stage, variable group, member 1",516
NP_951015.1,307065,119912236,119912752,-1,13,Mus_musculus,AF067061,uncharacterized protein LOC236546,516
NP_001028941.1,307066,119949546,119950068,-1,13,Mus_musculus,B020031M17Rik,uncharacterized protein LOC333467,522
XP_011243021.1,307067,119968136,119968666,1,13,Mus_musculus,Anxa2r,LOW QUALITY PROTEIN: annexin-2 receptor,530
XP_006517870.1,307068,120026438,120027011,-1,13,Mus_musculus,Gm36079,annexin-2 receptor-like,573
NP_001289895.1,307069,120034758,120035331,-1,13,Mus_musculus,Gm21188,"predicted gene, 21188",573
NP_001034737.2,307070,120154626,120155136,1,13,Mus_musculus,Gm20767,"2-cell-stage, variable group, member 1-like",510
XP_011243019.1,307071,120173183,120173696,1,13,Mus_musculus,Gm21818,uncharacterized protein Gm21818,513
NP_001033014.1,307072,120308145,120308649,1,13,Mus_musculus,BC147527,"2-cell-stage, variable group, member 3-like",504
NP_705743.1,307073,120317566,120318076,1,13,Mus_musculus,Tcstv3,"2-cell-stage, variable group, member 3",510
