acc,species,chromosome,symbol,start,end,length,strand
NP_001073062.1,Bos_taurus,23,PRIM2,2476202,2809093,332891,-1
NP_001193835.1,Bos_taurus,23,RAB23,2936080,2953601,17521,1
NP_001029436.1,Bos_taurus,23,BAG2,2957953,2966813,8860,-1
NP_001179613.1,Bos_taurus,23,ZNF451,2971788,3058877,87089,-1
XP_010816413.1,Bos_taurus,23,LOC104975635,3089798,3101566,11768,-1
NP_001192483.1,Bos_taurus,23,BEND6,3125703,3149209,23506,-1
XP_015315228.1,Bos_taurus,23,LOC535297,3171446,3687407,515961,1
XP_015315231.1,Bos_taurus,23,LOC107131708,3521748,3523623,1875,1
XP_010816383.1,Bos_taurus,23,LOC104975620,3598757,3600695,1938,1
NP_001291945.1,Bos_taurus,23,BMP5,4390361,4533848,143487,1
NP_001178122.1,Bos_taurus,23,HMGCLL1,4709422,4906605,197183,1
XP_002697218.1,Bos_taurus,23,GFRAL,4937119,5011035,73916,-1
NP_001179606.1,Bos_taurus,23,HCRTR2,5043871,5175679,131808,-1
NP_001192724.1,Bos_taurus,23,FAM83B,5382147,5456386,74239,-1
NP_001030279.1,Bos_taurus,23,TINAG,5954017,6059880,105863,-1
NP_001192398.1,Bos_taurus,23,LRRC1,6530426,6666336,135910,-1
NP_001095425.1,Bos_taurus,23,KLHL31,6783411,6784602,1191,1
NP_001077143.1,Bos_taurus,23,GCLC,6922379,6965163,42784,1
NP_001077254.1,Bos_taurus,23,DSB,6975319,6990901,15582,1
NP_001012696.1,Bos_taurus,23,BOLA-DYA,7011969,7016704,4735,1
NP_001012697.1,Bos_taurus,23,BOLA-DYB,7037656,7045301,7645,-1
NP_001013618.1,Bos_taurus,23,BOLA-DOB,7054418,7063641,9223,-1
NP_776647.1,Bos_taurus,23,TAP2,7079942,7086289,6347,-1
NP_001040087.1,Bos_taurus,23,LOC618733,7102159,7108985,6826,-1
NP_001035570.1,Bos_taurus,23,PSMB8,7113530,7116653,3123,-1
NP_001091527.1,Bos_taurus,23,TAP1,7118280,7126521,8241,-1
NP_001029560.1,Bos_taurus,23,PSMB9,7127111,7133556,6445,1
NP_001108326.1,Bos_taurus,23,H2B,7150820,7151201,381,1
NP_001035571.1,Bos_taurus,23,BOLA-DMB,7187385,7193432,6047,-1
NP_001012692.2,Bos_taurus,23,BOLA-DMA,7204349,7207030,2681,1
NP_001192849.1,Bos_taurus,23,BOLA-DOA,7218988,7264202,45214,-1
NP_001039331.1,Bos_taurus,23,BRD2,7240059,7247225,7166,1
NP_001039664.1,Bos_taurus,23,COL11A2,7290454,7318840,28386,-1
NP_001077109.1,Bos_taurus,23,RXRB,7321253,7326765,5512,-1
NP_001069705.2,Bos_taurus,23,SLC39A7,7327540,7331098,3558,1
NP_001039789.1,Bos_taurus,23,HSD17B8,7331904,7333829,1925,1
NP_001098521.1,Bos_taurus,23,RING1,7338398,7341191,2793,1
NP_001179989.1,Bos_taurus,23,VPS52,7371501,7388338,16837,-1
NP_001028786.1,Bos_taurus,23,RPS18,7388745,7393324,4579,1
NP_001070565.1,Bos_taurus,23,B3GALT4,7394421,7395558,1137,1
NP_001015564.1,Bos_taurus,23,WDR46,7396283,7405420,9137,-1
NP_001068889.1,Bos_taurus,23,PFDN6,7406076,7407024,948,1
NP_001068622.1,Bos_taurus,23,RGL2,7408357,7414640,6283,-1
NP_001039350.1,Bos_taurus,23,TAPBP,7416811,7425484,8673,-1
XP_005223345.1,Bos_taurus,23,ZBTB22,7426486,7428391,1905,-1
NP_001068623.1,Bos_taurus,23,DAXX,7430007,7433175,3168,-1
NP_001095406.1,Bos_taurus,23,KIFC1,7512905,7527481,14576,1
NP_001092384.2,Bos_taurus,23,PHF1,7529643,7533769,4126,1
NP_001068847.1,Bos_taurus,23,CUTA,7534316,7535286,970,-1
NP_001192395.1,Bos_taurus,23,SYNGAP1,7537951,7566234,28283,1
NP_001178391.1,Bos_taurus,23,ZBTB9,7569199,7570585,1386,1
NP_001071386.1,Bos_taurus,23,BAK1,7655891,7658885,2994,-1
NP_001092463.1,Bos_taurus,23,LOC516410,7662116,7666998,4882,1
XP_015315241.1,Bos_taurus,23,LOC100847319,7675174,7679416,4242,1
NP_776795.1,Bos_taurus,23,ITPR3,7687273,7756518,69245,1
NP_001193543.1,Bos_taurus,23,MNF1,7758195,7783928,25733,-1
NP_001035632.2,Bos_taurus,23,IP6K3,7797291,7810505,13214,-1
NP_001179408.1,Bos_taurus,23,LEMD2,7843194,7858338,15144,-1
NP_776363.1,Bos_taurus,23,MLN,7865269,7870112,4843,-1
XP_003587709.1,Bos_taurus,23,GRM4,8085749,8188237,102488,-1
NP_001069991.1,Bos_taurus,23,HMGA1,8263647,8267618,3971,1
NP_001103917.1,Bos_taurus,23,LOC100126544,8269435,8270377,942,-1
NP_001075935.1,Bos_taurus,23,NUDT3,8299345,8414435,115090,-1
NP_001029888.1,Bos_taurus,23,RPS10,8434615,8440388,5773,-1
NP_001094571.1,Bos_taurus,23,PACSIN1,8525929,8531878,5949,1
NP_001075047.1,Bos_taurus,23,SPDEF,8537857,8544735,6878,-1
NP_001069939.1,Bos_taurus,23,C23H6orf106,8592159,8688735,96576,-1
NP_001069802.1,Bos_taurus,23,SNRPC,8726741,8737181,10440,-1
NP_001029448.1,Bos_taurus,23,TAF11,8829704,8836752,7048,-1
NP_001103549.1,Bos_taurus,23,TCP11,9023111,9051908,28797,-1
XP_002697245.2,Bos_taurus,23,LOC107131220,9196405,9201776,5371,1
XP_005223365.1,Bos_taurus,23,LOC107131220,9196405,9201776,5371,1
XP_003587718.4,Bos_taurus,23,ZNF76,9225816,9235277,9461,1
NP_001092464.1,Bos_taurus,23,DEF6,9237803,9263491,25688,1
NP_001077105.1,Bos_taurus,23,PPARD,9340997,9353750,12753,1
NP_001179278.1,Bos_taurus,23,FANCE,9381625,9390135,8510,1
NP_001015647.1,Bos_taurus,23,RPL10A,9391550,9393982,2432,1
NP_001193657.1,Bos_taurus,23,TULP1,9422867,9437261,14394,-1
NP_001179791.1,Bos_taurus,23,FKBP5,9523457,9593213,69756,-1
XP_002697259.1,Bos_taurus,23,CLPSL2,9711821,9714190,2369,1
NP_001071435.1,Bos_taurus,23,CLPS,9723924,9726190,2266,-1
XP_015315260.1,Bos_taurus,23,LOC107131713,9732875,9733271,396,-1
NP_001192875.1,Bos_taurus,23,LHFPL5,9733330,9742158,8828,1
XP_002697249.2,Bos_taurus,23,SRPK1,9753394,9824588,71194,-1
NP_001095600.1,Bos_taurus,23,SLC26A8,9853525,9935037,81512,-1
NP_001095644.1,Bos_taurus,23,MAPK14,9945204,10020848,75644,1
NP_001014947.1,Bos_taurus,23,MAPK13,10036740,10044800,8060,1
NP_001192556.1,Bos_taurus,23,BRPF3,10099946,10130192,30246,1
NP_001092670.1,Bos_taurus,23,PNPLA1,10167496,10222306,54810,1
XP_015315266.1,Bos_taurus,23,PXT1,10319263,10338707,19444,-1
NP_001094563.1,Bos_taurus,23,KCTD20,10376706,10388224,11518,1
NP_001075071.1,Bos_taurus,23,STK38,10397543,10431778,34235,-1
NP_001029872.1,Bos_taurus,23,SRSF3,10483016,10487325,4309,1
NP_001075891.1,Bos_taurus,23,RPS4Y1,10528535,10529327,792,-1
NP_001092428.1,Bos_taurus,23,CDKN1A,10565064,10567022,1958,1
XP_003587720.1,Bos_taurus,23,LOC520334,10627252,10628281,1029,1
NP_001192568.1,Bos_taurus,23,CPNE5,10632881,10734548,101667,-1
NP_001014869.1,Bos_taurus,23,PPIL1,10749915,10769294,19379,-1
XP_005223417.1,Bos_taurus,23,C23H6orf89,10785266,10808457,23191,1
XP_005223418.1,Bos_taurus,23,C23H6orf89,10785266,10808457,23191,1
XP_002697254.3,Bos_taurus,23,C23H6orf89,10785266,10808457,23191,1
NP_001019658.1,Bos_taurus,23,PI16,10836849,10847835,10986,1
NP_001096775.1,Bos_taurus,23,MTCH1,10854951,10873743,18792,-1
NP_001069038.1,Bos_taurus,23,FGD2,10892239,10917998,25759,1
NP_776569.1,Bos_taurus,23,PIM1,11051838,11055416,3578,-1
NP_001073096.1,Bos_taurus,23,TMEM217,11109986,11110565,579,-1
NP_001092618.1,Bos_taurus,23,TBC1D22B,11133141,11205614,72473,1
NP_001039681.1,Bos_taurus,23,RNF8,11229849,11266714,36865,1
NP_001075899.1,Bos_taurus,23,CMTR1,11305605,11355819,50214,1
NP_001073705.1,Bos_taurus,23,CCDC167,11358397,11373667,15270,-1
NP_001179811.1,Bos_taurus,23,MDGA1,11531142,11594184,63042,-1
NP_001095615.1,Bos_taurus,23,ZFAND3,11712948,12038930,325982,1
NP_001121970.1,Bos_taurus,23,BTBD9,12047050,12066121,19071,-1
NP_001121970.1,Bos_taurus,23,BTBD9,12124681,12425511,300830,-1
NP_001076965.1,Bos_taurus,23,GLO1,12484841,12509188,24347,-1
XP_015315271.1,Bos_taurus,23,DNAH8,12550366,12883810,333444,1
XP_010816463.1,Bos_taurus,23,LOC101904084,12756146,12756620,474,1
XP_015315270.1,Bos_taurus,23,GLP1R,12913567,12940627,27060,1
NP_001033314.1,Bos_taurus,23,SAYSD1,12964618,12970995,6377,-1
NP_001178073.1,Bos_taurus,23,KCNK5,13057052,13095305,38253,-1
NP_776983.1,Bos_taurus,23,KCNK17,13160630,13172855,12225,-1
XP_003587722.1,Bos_taurus,23,KCNK16,13175050,13181345,6295,-1
XP_015315273.1,Bos_taurus,23,LOC104968668,13191045,13212289,21244,-1
XP_015315272.1,Bos_taurus,23,LOC100139627,13483734,13613272,129538,-1
XP_015315274.1,Bos_taurus,23,LOC107131718,13821468,13831009,9541,-1
NP_001159769.1,Bos_taurus,23,MOCS1,13833190,13866914,33724,-1
NP_001013615.1,Bos_taurus,23,MOCS1,13836087,13866914,30827,-1
NP_001179524.1,Bos_taurus,23,LRFN2,14309127,14351087,41960,-1
XP_005223572.1,Bos_taurus,23,UNC5CL,14959071,14965828,6757,-1
XP_005223573.1,Bos_taurus,23,UNC5CL,14959071,14965828,6757,-1
XP_010816539.1,Bos_taurus,23,UNC5CL,14959071,14965828,6757,-1
XP_015315316.1,Bos_taurus,23,UNC5CL,14959071,14965828,6757,-1
XP_015315317.1,Bos_taurus,23,UNC5CL,14959071,14965828,6757,-1
XP_015315306.1,Bos_taurus,23,TSPO2,14974417,14975436,1019,1
NP_001029527.1,Bos_taurus,23,APOBEC2,14985546,14994946,9400,1
NP_001070581.1,Bos_taurus,23,OARD1,15000774,15005102,4328,-1
NP_001014956.1,Bos_taurus,23,NFYA,15013685,15029907,16222,1
NP_001073048.1,Bos_taurus,23,TREM2,15090366,15094707,4341,-1
NP_996853.1,Bos_taurus,23,TREM1,15148526,15163157,14631,-1
NP_001192453.1,Bos_taurus,23,FOXP4,15391989,15423646,31657,1
NP_001192466.1,Bos_taurus,23,MDFI,15467449,15482104,14655,1
NP_001192595.1,Bos_taurus,23,TFEB,15507709,15514007,6298,-1
NP_001192720.1,Bos_taurus,23,PGC,15544731,15568677,23946,-1
NP_001092388.1,Bos_taurus,23,FRS3,15592630,15598158,5528,-1
NP_001107190.1,Bos_taurus,23,TOMM6,15609410,15610160,750,1
NP_001096763.1,Bos_taurus,23,MED20,15687640,15696662,9022,-1
NP_001014924.1,Bos_taurus,23,BYSL,15697194,15705885,8691,1
NP_001029881.1,Bos_taurus,23,CCND3,15708570,15714284,5714,-1
NP_001094670.1,Bos_taurus,23,TAF8,15803563,15820671,17108,1
XP_015315308.1,Bos_taurus,23,C23H6orf132,15841663,15874544,32881,-1
NP_001070551.1,Bos_taurus,23,MGC137036,15887225,15893213,5988,1
NP_776971.1,Bos_taurus,23,GUCA1A,15901354,15908049,6695,1
NP_777211.1,Bos_taurus,23,GUCA1B,15910681,15920974,10293,-1
NP_001030391.1,Bos_taurus,23,MRPS10,15930317,15941557,11240,-1
NP_001179567.1,Bos_taurus,23,UBR2,16264296,16369924,105628,1
NP_001159959.1,Bos_taurus,23,PRPH2,16376477,16390351,13874,-1
NP_001069177.1,Bos_taurus,23,TBCC,16406537,16407575,1038,-1
NP_001192709.1,Bos_taurus,23,GLTSCR1L,16478579,16509798,31219,1
NP_001193230.1,Bos_taurus,23,RPL7L1,16520011,16524508,4497,1
XP_002697289.1,Bos_taurus,23,C23H6orf226,16541218,16541560,342,-1
NP_001069101.1,Bos_taurus,23,PTCRA,16554188,16559231,5043,1
NP_001068907.1,Bos_taurus,23,CNPY3,16562967,16571110,8143,1
NP_001193045.1,Bos_taurus,23,GNMT,16579608,16582852,3244,1
NP_001179876.1,Bos_taurus,23,PEX6,16583614,16597347,13733,-1
NP_001193287.1,Bos_taurus,23,PPP2R5D,16602270,16624415,22145,1
NP_777073.1,Bos_taurus,23,MEA1,16625595,16626515,920,-1
NP_001014966.1,Bos_taurus,23,KLHDC3,16629725,16633148,3423,1
NP_001098949.1,Bos_taurus,23,RRP36,16634042,16637619,3577,1
XP_005223608.1,Bos_taurus,23,CUL7,16640985,16654717,13732,-1
NP_001035617.2,Bos_taurus,23,MRPL2,16656329,16660414,4085,-1
NP_001179894.1,Bos_taurus,23,PTK7,16677998,16739973,61975,1
NP_001192945.1,Bos_taurus,23,SRF,16747957,16754379,6422,1
XP_010816567.1,Bos_taurus,23,DNPH1,16795449,16797797,2348,-1
NP_001094517.1,Bos_taurus,23,SLC22A7,16865903,16871554,5651,1
NP_001179618.1,Bos_taurus,23,CRIP3,16872591,16875110,2519,-1
NP_001076963.1,Bos_taurus,23,DLK2,16981991,16985997,4006,-1
NP_001179348.1,Bos_taurus,23,TJAP1,17018937,17024703,5766,1
NP_001069687.1,Bos_taurus,23,YIPF3,17031400,17035246,3846,-1
NP_001033213.1,Bos_taurus,23,POLR1C,17035558,17042137,6579,1
XP_002697347.2,Bos_taurus,23,XPO5,17044425,17085615,41190,-1
NP_001029622.1,Bos_taurus,23,POLH,17092571,17115947,23376,1
NP_001076890.1,Bos_taurus,23,GTPBP2,17119814,17126853,7039,-1
NP_001069849.1,Bos_taurus,23,MAD2L1BP,17131608,17135248,3640,1
NP_001039732.1,Bos_taurus,23,RSPH9,17138234,17151388,13154,1
NP_001094699.1,Bos_taurus,23,MRPS18A,17152109,17168144,16035,-1
XP_005223613.3,Bos_taurus,23,LOC107131286,17257442,17260947,3505,-1
NP_001303884.1,Bos_taurus,23,VEGFA,17260415,17269465,9050,1
NP_001303921.1,Bos_taurus,23,VEGFA,17260415,17269465,9050,1
NP_001303885.1,Bos_taurus,23,VEGFA,17260415,17269399,8984,1
NP_776641.1,Bos_taurus,23,VEGFA,17260415,17269399,8984,1
NP_001303922.1,Bos_taurus,23,VEGFA,17260415,17269399,8984,1
XP_010816570.1,Bos_taurus,23,C23H6orf223,17512651,17513651,1000,1
XP_015315310.1,Bos_taurus,23,TCTE1,17585592,17597948,12356,-1
NP_001178140.1,Bos_taurus,23,AARS2,17609852,17676785,66933,-1
NP_001069805.1,Bos_taurus,23,MRPL14,17645296,17647817,2521,-1
NP_001157411.1,Bos_taurus,23,TMEM63B,17663878,17797642,133764,1
XP_002697305.3,Bos_taurus,23,SPATS1,17681088,17726157,45069,1
NP_001070010.1,Bos_taurus,23,CDC5L,17731148,17771196,40048,1
XP_015315311.1,Bos_taurus,23,CAPN11,17807544,17820030,12486,1
NP_001029570.2,Bos_taurus,23,SLC29A1,17846050,17855653,9603,1
NP_001073105.1,Bos_taurus,23,HSP90AB1,17868994,17873174,4180,1
NP_001070433.1,Bos_taurus,23,SLC35B2,17875755,17878469,2714,-1
NP_001124218.1,Bos_taurus,23,NFKBIE,17880438,17886997,6559,-1
NP_001192792.1,Bos_taurus,23,TMEM151B,17891618,17895776,4158,1
NP_001098478.1,Bos_taurus,23,SUPT3H,18223259,18611124,387865,-1
NP_776701.1,Bos_taurus,23,CLIC5,19167448,19333118,165670,-1
NP_001075004.1,Bos_taurus,23,ENPP4,19375919,19380975,5056,1
NP_001193653.1,Bos_taurus,23,ENPP5,19388632,19395174,6542,-1
NP_001300961.1,Bos_taurus,23,RCAN2,19437662,19667184,229522,-1
NP_001015632.2,Bos_taurus,23,RCAN2,19437662,19537357,99695,-1
NP_001092408.1,Bos_taurus,23,CYP39A1,19777772,19860182,82410,-1
NP_001193123.1,Bos_taurus,23,SLC25A27,19860794,19882600,21806,1
NP_001179259.1,Bos_taurus,23,TDRD6,19892714,19903575,10861,1
NP_777003.2,Bos_taurus,23,PLA2G7,19907187,19928621,21434,-1
XP_002697314.1,Bos_taurus,23,ANKRD66,19956588,19965986,9398,1
XP_010816580.1,Bos_taurus,23,MEP1A,20014169,20040232,26063,1
NP_001180172.1,Bos_taurus,23,ADGRF5,20053545,20110595,57050,-1
NP_001179256.1,Bos_taurus,23,ADGRF1,20206492,20236403,29911,-1
XP_002697352.4,Bos_taurus,23,LOC100296156,20383917,20384229,312,1
NP_001070379.1,Bos_taurus,23,TNFRSF21,20412019,20474574,62555,-1
NP_001193468.1,Bos_taurus,23,CD2AP,20597063,20680179,83116,1
NP_001178191.1,Bos_taurus,23,ADGRF2,20708928,20731119,22191,1
NP_001137347.1,Bos_taurus,23,ADGRF4,20745535,20758331,12796,1
NP_001193009.1,Bos_taurus,23,OPN5,20801931,20834318,32387,1
XP_015315313.1,Bos_taurus,23,LOC107131722,20893700,20895233,1533,-1
NP_001095613.1,Bos_taurus,23,PTCHD4,21090639,21091248,609,-1
NP_776364.2,Bos_taurus,23,MUT,21938807,21972915,34108,-1
NP_001071533.1,Bos_taurus,23,CENPQ,21985013,21997135,12122,1
NP_001138533.1,Bos_taurus,23,GLYATL3,22011841,22024395,12554,1
NP_001139125.1,Bos_taurus,23,C23H6orf141,22040538,22041105,567,1
NP_776596.1,Bos_taurus,23,RHAG,22088890,22109630,20740,-1
NP_001033178.1,Bos_taurus,23,CRISP2,22131367,22146648,15281,-1
NP_001073103.1,Bos_taurus,23,CRISP3,22164420,22178460,14040,-1
NP_001116507.1,Bos_taurus,23,PGK2,22221076,22222330,1254,-1
NP_001193188.1,Bos_taurus,23,CRISP1,22245232,22261583,16351,-1
XP_002697354.1,Bos_taurus,23,DEFB110,22369893,22374864,4971,-1
XP_015315314.1,Bos_taurus,23,DEFB112,22381952,22423235,41283,-1
NP_001179258.1,Bos_taurus,23,TFAP2D,22998427,23057489,59062,1
NP_001069715.1,Bos_taurus,23,TFAP2B,23097807,23122686,24879,1
XP_002697357.2,Bos_taurus,23,PKHD1,23795771,24250799,455028,-1
NP_001008412.1,Bos_taurus,23,IL17A,24347044,24350010,2966,1
NP_001179011.1,Bos_taurus,23,IL17F,24391184,24397891,6707,-1
NP_001013604.2,Bos_taurus,23,MCM3,24439485,24456276,16791,-1
XP_015315334.1,Bos_taurus,23,LOC107131728,24547395,24547635,240,1
NP_001094605.1,Bos_taurus,23,PAQR8,24567893,24568958,1065,1
NP_001179173.1,Bos_taurus,23,EFHC1,24588128,24627606,39478,1
NP_001180079.1,Bos_taurus,23,TRAM2,24638149,24702830,64681,-1
NP_001029551.1,Bos_taurus,23,TMEM14A,24807975,24813528,5553,1
NP_803481.1,Bos_taurus,23,GSTA2,24823887,24831484,7597,-1
NP_001071617.1,Bos_taurus,23,GSTA3,24875680,24883511,7831,-1
NP_001092486.1,Bos_taurus,23,GSTA5,24895015,24909300,14285,-1
NP_001070580.1,Bos_taurus,23,GSTA3,24935716,24948163,12447,-1
NP_001015651.1,Bos_taurus,23,GSTA4,24963701,24976300,12599,-1
NP_001092357.1,Bos_taurus,23,ICK,24984469,25012392,27923,-1
NP_001029584.1,Bos_taurus,23,FBXO9,25030689,25051289,20600,1
NP_001179034.1,Bos_taurus,23,GCM1,25067220,25084501,17281,-1
NP_001192219.1,Bos_taurus,23,GCM1,25067220,25084501,17281,-1
NP_001040062.1,Bos_taurus,23,ELOVL5,25157473,25186845,29372,-1
XP_015315336.1,Bos_taurus,23,BOLA-DQA2,25351285,25356908,5623,-1
NP_001012694.2,Bos_taurus,23,BOLA-DQB,25375347,25388103,12756,1
NP_001012693.2,Bos_taurus,23,BOLA-DQA5,25405112,25411578,6466,-1
XP_003587740.1,Bos_taurus,23,LOC100848815,25426572,25430097,3525,-1
XP_015330756.1,Bos_taurus,23,BOLA-DRB3,25472160,25476537,4377,1
NP_001013619.3,Bos_taurus,23,BOLA-DQA1,25489989,25490245,256,-1
XP_010816599.2,Bos_taurus,23,BOLA-DRB2,25539596,25557851,18255,1
XP_015315343.1,Bos_taurus,23,LOC101902890,25574617,25586120,11503,1
NP_001012695.1,Bos_taurus,23,BOLA-DRA,25588639,25592144,3505,-1
NP_001095821.1,Bos_taurus,23,BTNL2,25618595,25631944,13349,1
NP_001075192.1,Bos_taurus,23,LOC525599,25634966,25642597,7631,-1
NP_001029379.1,Bos_taurus,23,LOC504295,25649539,25656197,6658,1
NP_001029840.2,Bos_taurus,23,BLA-DQB,25855492,25862994,7502,-1
XP_015315347.1,Bos_taurus,23,LOC104972343,26226530,26269588,43058,1
XP_015315348.1,Bos_taurus,23,LOC107131729,26404304,26412906,8602,1
XP_015315385.1,Bos_taurus,23,C23H6orf10,26726613,26795033,68420,1
XP_002697389.3,Bos_taurus,23,LOC786065,26932836,26938393,5557,1
NP_001193877.1,Bos_taurus,23,NOTCH4,26973190,26998620,25430,1
NP_001243812.1,Bos_taurus,23,PBX2,27003268,27006729,3461,1
NP_776407.1,Bos_taurus,23,AGER,27008849,27011781,2932,1
NP_001098915.1,Bos_taurus,23,RNF5,27012545,27014357,1812,-1
NP_803484.1,Bos_taurus,23,AGPAT1,27021362,27023483,2121,1
NP_001092657.1,Bos_taurus,23,EGFL8,27024789,27026621,1832,-1
NP_001030395.2,Bos_taurus,23,PPT2,27028828,27035444,6616,-1
NP_001070415.1,Bos_taurus,23,PRRT1,27038297,27040649,2352,1
NP_001095452.1,Bos_taurus,23,FKBPL,27056298,27057274,976,1
NP_001077152.1,Bos_taurus,23,ATF6B,27057896,27067313,9417,1
XP_005223750.1,Bos_taurus,23,LOC107131209,27076266,27079933,3667,1
XP_015315387.1,Bos_taurus,23,LOC107131730,27083668,27084155,487,1
NP_777128.1,Bos_taurus,23,TNXB,27085606,27140674,55068,-1
XP_015315388.1,Bos_taurus,23,LOC781663,27152124,27162956,10832,1
NP_001013614.1,Bos_taurus,23,CYP21,27169511,27172439,2928,-1
NP_001091466.1,Bos_taurus,23,STK19,27199777,27206513,6736,-1
NP_001014872.2,Bos_taurus,23,DXO,27207267,27209706,2439,1
XP_003587743.1,Bos_taurus,23,LOC100139548,27209206,27219157,9951,-1
NP_001069672.1,Bos_taurus,23,NELFE,27219882,27225046,5164,1
NP_001035616.1,Bos_taurus,23,CFB,27225317,27231182,5865,-1
NP_001029664.1,Bos_taurus,23,C2,27232001,27243331,11330,-1
XP_005223753.1,Bos_taurus,23,ZBTB12,27274033,27275413,1380,1
XP_010816681.1,Bos_taurus,23,ZBTB12,27274033,27275413,1380,1
XP_010816682.1,Bos_taurus,23,ZBTB12,27274033,27275413,1380,1
XP_010816683.1,Bos_taurus,23,ZBTB12,27274033,27275413,1380,1
XP_015315391.1,Bos_taurus,23,ZBTB12,27274033,27275413,1380,1
NP_001193192.1,Bos_taurus,23,EHMT2,27277595,27291159,13564,1
NP_001076911.1,Bos_taurus,23,SLC44A4,27291972,27305226,13254,1
NP_001077111.1,Bos_taurus,23,NEU1,27305749,27309102,3353,1
NP_976067.2,Bos_taurus,23,HSPA1A,27331772,27333698,1926,-1
NP_001161367.1,Bos_taurus,23,HSPA1L,27336058,27337984,1926,1
NP_001094647.1,Bos_taurus,23,LSM2,27339721,27344137,4416,1
NP_001068674.1,Bos_taurus,23,VWA7,27356280,27364477,8197,-1
XP_002697393.2,Bos_taurus,23,VARS,27365290,27373768,8478,-1
NP_001075936.1,Bos_taurus,23,SAPCD1,27374662,27375211,549,-1
NP_001192428.1,Bos_taurus,23,MSH5,27376010,27389175,13165,-1
NP_001015608.1,Bos_taurus,23,CLIC1,27393514,27398704,5190,1
NP_001029876.1,Bos_taurus,23,DDAH2,27400387,27402628,2241,1
NP_001071549.1,Bos_taurus,23,C23H6orf25,27404677,27406348,1671,-1
NP_001071324.1,Bos_taurus,23,LY6G6C,27407664,27409835,2171,1
XP_003587745.1,Bos_taurus,23,LY6G6D,27411104,27412890,1786,-1
NP_001074989.1,Bos_taurus,23,LY6G6E,27414664,27415981,1317,1
NP_001069662.1,Bos_taurus,23,LY6G6F,27417917,27420583,2666,-1
NP_001069073.1,Bos_taurus,23,ABHD16A,27423467,27435476,12009,1
XP_010816698.1,Bos_taurus,23,LY6G5C,27440559,27442830,2271,1
NP_001179131.1,Bos_taurus,23,LY6G5B,27445629,27446642,1013,-1
NP_001039919.1,Bos_taurus,23,CSNK2B,27447650,27450752,3102,-1
NP_001069936.1,Bos_taurus,23,GPANK1,27453294,27454932,1638,1
NP_001094737.1,Bos_taurus,23,C23H6orf47,27457507,27458401,894,1
NP_001029429.2,Bos_taurus,23,APOM,27459385,27461297,1912,-1
NP_001068834.2,Bos_taurus,23,BAG6,27464366,27474569,10203,1
NP_001192486.1,Bos_taurus,23,PRRC2A,27475780,27488714,12934,-1
NP_776410.1,Bos_taurus,23,AIF1,27503302,27505358,2056,-1
NP_001035614.1,Bos_taurus,23,NCR3,27521487,27523736,2249,1
NP_776391.2,Bos_taurus,23,TNF,27534701,27536481,1780,-1
NP_001013419.1,Bos_taurus,23,LTA,27538543,27539457,914,-1
NP_001015597.1,Bos_taurus,23,NFKBIL1,27550805,27560565,9760,-1
NP_001069132.1,Bos_taurus,23,ATP6V1G2,27561650,27562821,1171,1
NP_001028801.1,Bos_taurus,23,DDX39B,27567309,27576518,9209,1
XP_002697394.1,Bos_taurus,23,MCCD1,27576912,27578064,1152,-1
XP_010816685.2,Bos_taurus,23,MGC126945,27600072,27602201,2129,1
NP_001108327.1,Bos_taurus,23,BoLA,27647098,27651987,4889,1
NP_001120789.1,Bos_taurus,23,MIC1,27659408,27729696,70288,-1
XP_015315396.1,Bos_taurus,23,BOLA,27689389,27691564,2175,1
XP_015315397.1,Bos_taurus,23,LOC788634,27715004,27718274,3270,1
NP_777005.1,Bos_taurus,23,POU5F1,27769892,27774392,4500,1
NP_001077153.1,Bos_taurus,23,TCF19,27776232,27778556,2324,-1
NP_001019707.1,Bos_taurus,23,CCHCR1,27780957,27791106,10149,1
NP_001073843.1,Bos_taurus,23,PSORS1C2,27793301,27794338,1037,1
NP_001071418.1,Bos_taurus,23,CDSN,27808500,27812246,3746,1
NP_001193388.1,Bos_taurus,23,LOC616942,27842301,27845887,3586,1
XP_002697398.4,Bos_taurus,23,MUC21,27908223,27912268,4045,-1
XP_005223770.1,Bos_taurus,23,DPCR1,27927623,27936148,8525,-1
NP_001107995.1,Bos_taurus,23,SFTA2,27945614,27946212,598,1
NP_001243473.1,Bos_taurus,23,VARS2,27949848,27961390,11542,-1
NP_001094527.1,Bos_taurus,23,GTF2H4,27962286,27967930,5644,-1
NP_001069480.2,Bos_taurus,23,DDR1,27976470,27986825,10355,-1
XP_015315398.1,Bos_taurus,23,LOC107131732,27991050,27994058,3008,-1
NP_001068670.1,Bos_taurus,23,IER3,28088485,28089056,571,1
NP_001070355.1,Bos_taurus,23,FLOT1,28090672,28099794,9122,1
NP_001040014.1,Bos_taurus,23,TUBB,28101901,28105152,3251,-1
NP_001032685.1,Bos_taurus,23,NRM,28112227,28114509,2282,-1
XP_002697401.2,Bos_taurus,23,MDC1,28117863,28128504,10641,-1
NP_001070387.1,Bos_taurus,23,PPP1R18,28128502,28136174,7672,1
NP_001193139.1,Bos_taurus,23,DHX16,28140392,28152392,12000,1
NP_001033267.1,Bos_taurus,23,C23H6orf136,28152846,28156283,3437,-1
NP_001263252.1,Bos_taurus,23,ATAT1,28156840,28169399,12559,-1
NP_001033613.1,Bos_taurus,23,MRPS18B,28170189,28176461,6272,-1
NP_001137335.1,Bos_taurus,23,PPP1R10,28183953,28192535,8582,1
NP_001193838.1,Bos_taurus,23,ABCF1,28199128,28211313,12185,-1
NP_001029726.1,Bos_taurus,23,PRR3,28219794,28223657,3863,-1
NP_001096742.1,Bos_taurus,23,GNL1,28224817,28231252,6435,1
XP_003587749.2,Bos_taurus,23,LOC615278,28262694,28271496,8802,-1
XP_015315399.1,Bos_taurus,23,LOC615278,28262694,28271496,8802,-1
NP_001070309.1,Bos_taurus,23,LOC512672,28299512,28307097,7585,1
NP_001099086.1,Bos_taurus,23,BOLA-NC1,28355357,28358325,2968,-1
NP_001035588.1,Bos_taurus,23,JSP.1,28470055,28473371,3316,-1
NP_001033607.1,Bos_taurus,23,BOLA,28502825,28506291,3466,-1
XP_002697385.1,Bos_taurus,23,LOC785873,28570977,28579480,8503,1
NP_001192693.1,Bos_taurus,23,TRIM15,28600574,28610886,10312,-1
NP_001015607.1,Bos_taurus,23,TRIM10,28614283,28622043,7760,1
NP_001096776.1,Bos_taurus,23,TRIM40,28626338,28638013,11675,-1
XP_003587753.4,Bos_taurus,23,RNF39,28702051,28706222,4171,1
NP_001093765.1,Bos_taurus,23,PPP1R11,28708301,28710184,1883,-1
NP_001039865.1,Bos_taurus,23,ZNRD1,28714663,28717599,2936,-1
NP_001013602.1,Bos_taurus,23,MOG,28740641,28750890,10249,-1
NP_001156747.1,Bos_taurus,23,GABBR1,28775568,28802663,27095,1
NP_001092433.1,Bos_taurus,23,GABBR1,28780240,28802663,22423,1
XP_002697423.1,Bos_taurus,23,LOC504548,28873685,28875436,1751,-1
XP_010816709.1,Bos_taurus,23,LOC506486,28889173,28890127,954,-1
XP_015315411.1,Bos_taurus,23,LOC506486,28889173,28890127,954,-1
XP_010816708.1,Bos_taurus,23,OR2H1,28902964,28903903,939,-1
NP_001193402.1,Bos_taurus,23,UBD,28918458,28920198,1740,1
XP_015315412.1,Bos_taurus,23,LOC107131305,28921913,28925097,3184,-1
XP_002697445.1,Bos_taurus,23,OR10C1,28950028,28950967,939,-1
XP_002697446.1,Bos_taurus,23,LOC523768,28955605,28956565,960,-1
XP_002697447.2,Bos_taurus,23,LOC523769,28967923,28968892,969,1
XP_015315402.1,Bos_taurus,23,LOC523389,28984363,28985380,1017,1
XP_002697449.2,Bos_taurus,23,LOC786846,28992087,28993017,930,-1
XP_002697450.1,Bos_taurus,23,LOC785910,29004624,29005551,927,-1
XP_002697427.1,Bos_taurus,23,LOC785811,29032405,29033332,927,-1
XP_002697454.1,Bos_taurus,23,LOC785779,29038752,29039682,930,-1
XP_002707943.2,Bos_taurus,23,LOC789690,29061839,29062766,927,-1
XP_003587759.2,Bos_taurus,23,LOC616306,29071804,29072758,954,-1
XP_015315405.1,Bos_taurus,23,LOC785712,29078909,29079824,915,-1
XP_002697432.1,Bos_taurus,23,LOC785639,29092561,29093488,927,-1
NP_001091852.1,Bos_taurus,23,OR12D2,29107825,29108752,927,-1
XP_003587755.2,Bos_taurus,23,LOC785582,29122353,29123280,927,-1
XP_002697457.1,Bos_taurus,23,LOC514434,29143550,29144498,948,1
XP_002697434.1,Bos_taurus,23,OR12D3,29149973,29150924,951,1
XP_002697458.2,Bos_taurus,23,LOC512579,29157653,29158610,957,1
XP_002697459.2,Bos_taurus,23,LOC618034,29167548,29168487,939,1
XP_002697435.1,Bos_taurus,23,LOC785431,29176695,29177619,924,1
XP_002697436.1,Bos_taurus,23,OR5V1,29186919,29187873,954,1
XP_002697437.2,Bos_taurus,23,OR14J1,29206926,29207889,963,-1
XP_005223773.1,Bos_taurus,23,LOC510530,29212490,29213456,966,-1
XP_002697438.1,Bos_taurus,23,LOC618052,29223811,29224756,945,-1
XP_002697461.3,Bos_taurus,23,LOC785277,29241748,29242690,942,-1
XP_015315403.1,Bos_taurus,23,LOC107131736,29268470,29269403,933,1
XP_002697463.4,Bos_taurus,23,LOC618064,29280760,29281705,945,1
XP_002697464.2,Bos_taurus,23,LOC785162,29290562,29291507,945,1
XP_010816714.1,Bos_taurus,23,LOC516273,29299941,29300874,933,1
XP_002697466.1,Bos_taurus,23,LOC516274,29314809,29315760,951,1
XP_002697467.1,Bos_taurus,23,LOC618070,29327102,29328065,963,-1
XP_002697468.1,Bos_taurus,23,LOC782341,29349631,29350570,939,1
XP_002697469.1,Bos_taurus,23,LOC782301,29360767,29361715,948,1
XP_002697471.1,Bos_taurus,23,LOC515704,29387308,29388250,942,1
XP_015315404.1,Bos_taurus,23,LOC782379,29394474,29395409,935,1
XP_002697440.1,Bos_taurus,23,LOC785479,29403152,29403978,826,1
XP_002697474.2,Bos_taurus,23,LOC509155,29411405,29412041,636,-1
XP_010816717.1,Bos_taurus,23,LOC784614,29412971,29414889,1918,-1
XP_002697484.1,Bos_taurus,23,LOC784652,29451996,29452938,942,1
XP_002697485.1,Bos_taurus,23,LOC784681,29462781,29463723,942,1
XP_002697486.1,Bos_taurus,23,LOC528343,29480529,29481468,939,1
XP_002697487.1,Bos_taurus,23,OR2J3,29503334,29504264,930,-1
XP_015315413.1,Bos_taurus,23,LOC784787,29518648,29519287,639,1
XP_010816718.1,Bos_taurus,23,LOC511103,29540766,29541693,927,-1
XP_002697490.1,Bos_taurus,23,LOC784858,29552974,29553937,963,1
XP_002697477.1,Bos_taurus,23,LOC616517,29572203,29573142,939,1
XP_002697478.3,Bos_taurus,23,LOC789367,29581501,29582479,978,1
XP_015315414.1,Bos_taurus,23,LOC789358,29593367,29594294,927,-1
XP_003587760.1,Bos_taurus,23,LOC788675,29622275,29623226,951,1
XP_010816722.1,Bos_taurus,23,LOC788663,29632637,29633571,934,1
XP_010816720.1,Bos_taurus,23,OR2J2,29661569,29662598,1029,-1
XP_010816721.1,Bos_taurus,23,LOC509280,29678972,29679926,954,1
XP_002697483.1,Bos_taurus,23,OR2W1,29698015,29698978,963,1
XP_010816738.1,Bos_taurus,23,LOC782475,29764538,29765510,972,1
XP_002697522.1,Bos_taurus,23,LOC782554,29784663,29785587,924,1
NP_001069267.1,Bos_taurus,23,TRIM27,29906705,29920283,13578,1
NP_001070606.1,Bos_taurus,23,ZSCAN12,30080783,30090123,9340,1
NP_001039702.1,Bos_taurus,23,ZSCAN31,30121195,30123823,2628,1
NP_001069642.1,Bos_taurus,23,PGBD1,30154311,30154773,462,-1
NP_001095427.1,Bos_taurus,23,ZSCAN26,30161122,30166332,5210,-1
NP_001095968.1,Bos_taurus,23,NKAPL,30178136,30178959,823,-1
XP_002697494.2,Bos_taurus,23,ZKSCAN4,30186450,30193866,7416,-1
XP_015315428.1,Bos_taurus,23,ZSCAN9,30206788,30211745,4957,-1
XP_015315425.1,Bos_taurus,23,LOC104975673,30237436,30241949,4513,-1
NP_001138603.1,Bos_taurus,23,ZNF389,30265551,30266367,816,-1
NP_001093814.1,Bos_taurus,23,ZKSCAN8,30279018,30287143,8125,-1
NP_001029583.1,Bos_taurus,23,ZSCAN16,30305198,30311510,6312,-1
NP_001178305.1,Bos_taurus,23,ZNF165,30332604,30336576,3972,-1
XP_002697531.3,Bos_taurus,23,LOC528914,30349198,30350140,942,-1
XP_003587763.1,Bos_taurus,23,LOC100849008,30464776,30465715,939,1
XP_005223788.1,Bos_taurus,23,LOC101904987,30474842,30475787,945,-1
XP_002697537.1,Bos_taurus,23,LOC619021,30487471,30488416,945,-1
XP_002697539.1,Bos_taurus,23,LOC783311,30528180,30529125,945,-1
XP_002697540.1,Bos_taurus,23,LOC783203,30585742,30586705,963,-1
XP_002697541.2,Bos_taurus,23,LOC528373,30607389,30608346,957,1
XP_010816746.1,Bos_taurus,23,OR2B6,30620726,30621668,942,1
XP_015315429.1,Bos_taurus,23,LOC783041,30685947,30693562,7615,-1
XP_010816747.1,Bos_taurus,23,LOC783002,30695955,30696900,945,1
XP_015315427.1,Bos_taurus,23,HIST1H2BI,30713381,30713762,381,-1
XP_010816763.1,Bos_taurus,23,LOC104968446,30714063,30714456,393,1
XP_002697506.1,Bos_taurus,23,HIST1H3C,30715879,30716290,411,1
XP_010816762.1,Bos_taurus,23,LOC528329,30724825,30748119,23294,1
XP_010816761.1,Bos_taurus,23,HIST1H1B,30729157,30729838,681,1
XP_005223785.1,Bos_taurus,23,LOC529277,30730259,30730652,393,-1
XP_010816759.1,Bos_taurus,23,LOC104975676,30730957,30731338,381,1
NP_001075211.1,Bos_taurus,23,HIST1H2BB,30741267,30741648,381,-1
XP_003587761.1,Bos_taurus,23,LOC614970,30741967,30742360,393,1
XP_002697516.1,Bos_taurus,23,LOC527645,30757274,30757586,312,-1
XP_010816754.1,Bos_taurus,23,LOC616868,30760428,30760809,381,-1
XP_010816755.1,Bos_taurus,23,LOC616868,30760428,30760809,381,-1
XP_010816756.1,Bos_taurus,23,LOC616868,30760428,30760809,381,-1
XP_010816757.1,Bos_taurus,23,LOC616868,30760428,30760809,381,-1
NP_001092190.1,Bos_taurus,23,HIST1H2AG,30761115,30761508,393,1
XP_010816767.1,Bos_taurus,23,LOC616819,30764309,30764720,411,1
XP_010816748.1,Bos_taurus,23,HIST1H2AJ,30766956,30767343,387,-1
XP_010816749.1,Bos_taurus,23,LOC100295221,30767649,30768030,381,1
XP_010816750.1,Bos_taurus,23,LOC100295221,30767649,30768030,381,1
XP_010816751.1,Bos_taurus,23,LOC100295221,30767649,30768030,381,1
XP_010816752.1,Bos_taurus,23,LOC100295221,30767649,30768030,381,1
NP_001093842.1,Bos_taurus,23,ZNF184,30960834,30979663,18829,1
NP_001093822.1,Bos_taurus,23,ZNF391,30995073,30996150,1077,-1
NP_001156399.1,Bos_taurus,23,POM121L2,31040856,31043949,3093,1
XP_010816800.1,Bos_taurus,23,PRSS16,31067237,31073523,6286,-1
XP_010816805.1,Bos_taurus,23,HIST1H2AH,31111940,31112327,387,-1
NP_001071531.1,Bos_taurus,23,HIST1H2BN,31112650,31113031,381,1
XP_002697546.1,Bos_taurus,23,HIST1H2BJ,31121373,31121754,381,1
NP_001091624.1,Bos_taurus,23,ZNF322,31214786,31215995,1209,1
XP_010816806.1,Bos_taurus,23,LOC515414,31235373,31236321,948,1
XP_010816807.1,Bos_taurus,23,LOC514235,31250288,31251215,927,1
XP_002697600.1,Bos_taurus,23,LOC521167,31260280,31261204,924,1
NP_001069620.1,Bos_taurus,23,ABT1,31279671,31281319,1648,-1
NP_001040012.1,Bos_taurus,23,HMGN4,31324374,31324647,273,-1
XP_015315455.1,Bos_taurus,23,BTN1A1,31343550,31344106,556,-1
XP_015315451.1,Bos_taurus,23,LOC107131743,31344921,31348078,3157,1
NP_776933.1,Bos_taurus,23,BTN1A1,31362492,31366608,4116,1
XP_015315461.1,Bos_taurus,23,BTN3A3,31379280,31390409,11129,-1
XP_010816809.2,Bos_taurus,23,LOC527388,31456885,31479686,22801,1
XP_010816810.1,Bos_taurus,23,HIST1H2BM,31460913,31461294,381,-1
XP_002697551.1,Bos_taurus,23,HIST1H2AM,31461685,31462078,393,1
XP_015315463.1,Bos_taurus,23,LOC107131750,31463931,31464342,411,1
XP_002697553.1,Bos_taurus,23,LOC104968456,31472338,31472719,381,-1
XP_010816812.2,Bos_taurus,23,LOC518961,31485394,31503087,17693,-1
NP_001094536.1,Bos_taurus,23,HIST1H1D,31490519,31491185,666,1
XP_015315464.1,Bos_taurus,23,HIST1H2AC,31518524,31518917,393,-1
NP_001099113.1,Bos_taurus,23,H2B,31519420,31519624,204,1
XP_002697561.1,Bos_taurus,23,LOC505183,31525878,31526259,381,-1
XP_010816815.1,Bos_taurus,23,LOC104975683,31526581,31526974,393,1
NP_001092459.1,Bos_taurus,23,HIST1H1E,31531156,31531789,633,-1
NP_001093194.1,Bos_taurus,23,LOC617875,31534758,31535070,312,1
XP_010816816.1,Bos_taurus,23,LOC787465,31539668,31540049,381,-1
NP_001039711.1,Bos_taurus,23,HIST1H2BD,31554875,31555256,381,-1
XP_002697564.1,Bos_taurus,23,HIST1H1E,31556332,31556992,660,-1
NP_001192525.1,Bos_taurus,23,HIST1H2AC,31588780,31589173,393,-1
XP_003587771.1,Bos_taurus,23,LOC787269,31589503,31589884,381,1
XP_010816820.1,Bos_taurus,23,LOC104975686,31604876,31605513,637,1
XP_010816819.2,Bos_taurus,23,LOC617905,31607478,31669974,62496,-1
NP_001012399.1,Bos_taurus,23,HFE,31614300,31621316,7016,1
NP_001076894.1,Bos_taurus,23,HIST1H1C,31636946,31637588,642,1
XP_002697571.1,Bos_taurus,23,HIST1H2BB,31646216,31646597,381,1
XP_010816817.1,Bos_taurus,23,LOC104975684,31652713,31653106,393,1
XP_005223855.1,Bos_taurus,23,HIST1H3G,31654043,31654454,411,1
NP_776305.1,Bos_taurus,23,H4,31665599,31665911,312,1
XP_002697575.1,Bos_taurus,23,HIST1H3I,31670730,31671141,411,-1
XP_010816821.1,Bos_taurus,23,HIST1H1A,31674089,31674746,657,1
NP_001029746.1,Bos_taurus,23,TRIM38,31693877,31706914,13037,-1
NP_001033207.1,Bos_taurus,23,SLC17A2,31727728,31738931,11203,1
NP_001069255.1,Bos_taurus,23,SLC17A3,31761096,31778340,17244,1
XP_010816831.2,Bos_taurus,23,SLC17A1,31792595,31830098,37503,1
XP_010816832.2,Bos_taurus,23,SLC17A1,31792595,31830098,37503,1
XP_010816833.2,Bos_taurus,23,SLC17A1,31792595,31830098,37503,1
XP_010816823.1,Bos_taurus,23,HIST1H2BA,31914983,31915367,384,1
XP_015315477.1,Bos_taurus,23,HIST1H2BA,31918124,31918676,552,-1
XP_015315478.1,Bos_taurus,23,HIST1H2AA,31918730,31919276,546,1
NP_001092643.1,Bos_taurus,23,SCGN,31952426,32004255,51829,-1
NP_001179832.1,Bos_taurus,23,LRRC16A,32030008,32339087,309079,-1
NP_001030502.1,Bos_taurus,23,FAM65B,32713473,32763479,50006,1
XP_005223873.1,Bos_taurus,23,C23H6orf229,32769204,32772075,2871,1
NP_001020508.1,Bos_taurus,23,GMNN,32775886,32784223,8337,-1
NP_001071467.1,Bos_taurus,23,C23H6orf62,32823091,32833540,10449,1
NP_001095315.1,Bos_taurus,23,ACOT13,32836780,32848919,12139,-1
NP_001098811.1,Bos_taurus,23,TDP2,32849365,32859925,10560,1
XP_002697584.1,Bos_taurus,23,KIAA0319,32901067,32942266,41199,1
XP_005223874.1,Bos_taurus,23,KIAA0319,32901067,32942266,41199,1
NP_001179664.1,Bos_taurus,23,ALDH5A1,32952153,32976657,24504,-1
NP_777241.1,Bos_taurus,23,GPLD1,32984494,33036019,51525,1
NP_001095373.1,Bos_taurus,23,MRS2,33040800,33077125,36325,-1
NP_001068937.1,Bos_taurus,23,NRSN1,33269564,33281467,11903,-1
XP_003587783.2,Bos_taurus,23,LOC788801,34219297,34219825,528,-1
NP_997613.2,Bos_taurus,23,PRP4,34357860,34368707,10847,-1
NP_001033289.1,Bos_taurus,23,PRP8,34431221,34440564,9343,-1
NP_991347.1,Bos_taurus,23,PRP6,34479818,34491927,12109,-1
NP_776584.1,Bos_taurus,23,PRP1,34531553,34543417,11864,-1
XP_010816845.1,Bos_taurus,23,LOC100298767,34576554,34588550,11996,-1
NP_001073846.2,Bos_taurus,23,PRP2,34634194,34647033,12839,-1
XP_015315452.1,Bos_taurus,23,LOC100336962,34667010,34678330,11320,-1
NP_001091031.1,Bos_taurus,23,PRP14,34693484,34705968,12484,-1
NP_001033221.1,Bos_taurus,23,PRP9,34719463,34731112,11649,-1
NP_001012286.1,Bos_taurus,23,PRP-VII,34806750,34818831,12081,-1
NP_776585.1,Bos_taurus,23,PRP3,34861329,34866557,5228,-1
NP_851350.2,Bos_taurus,23,CSH2,35059473,35072020,12547,1
NP_001157793.1,Bos_taurus,23,CSH2,35059473,35072020,12547,1
NP_776378.2,Bos_taurus,23,PRL,35105283,35113696,8413,-1
NP_001001136.2,Bos_taurus,23,HDGFL1,35438513,35439221,708,-1
XP_010816846.1,Bos_taurus,23,LOC100847951,35789778,36174436,384658,-1
NP_001071596.1,Bos_taurus,23,SOX4,36292361,36293944,1583,-1
NP_001179620.1,Bos_taurus,23,CDKAL1,36602047,37210133,608086,-1
NP_001179767.1,Bos_taurus,23,E2F3,37262071,37343552,81481,-1
NP_001179786.1,Bos_taurus,23,MBOAT1,37498772,37608122,109350,1
NP_001092498.1,Bos_taurus,23,RNF144B,38955598,39030849,75251,-1
NP_001093187.1,Bos_taurus,23,DEK,39134122,39163796,29674,1
NP_001068999.1,Bos_taurus,23,TPMT,39215601,39231827,16226,1
XP_002697596.1,Bos_taurus,23,NHLRC1,39239197,39240382,1185,1
NP_001192683.1,Bos_taurus,23,NUP153,39534811,39605312,70501,1
NP_001075187.1,Bos_taurus,23,FAM8A1,39612050,39619566,7516,-1
NP_001092449.1,Bos_taurus,23,CAP2,39646901,39758309,111408,-1
NP_001098455.1,Bos_taurus,23,RBM24,39836076,39846177,10101,-1
XP_003587785.1,Bos_taurus,23,STMND1,39906664,39927833,21169,-1
NP_001020518.1,Bos_taurus,23,LOC574091,40610631,40610988,357,1
NP_001069445.1,Bos_taurus,23,GMPR,40616625,40676937,60312,-1
NP_001095723.1,Bos_taurus,23,MYLIP,40771805,40789604,17799,-1
NP_001039412.1,Bos_taurus,23,DTNBP1,41076274,41165191,88917,1
NP_001040055.1,Bos_taurus,23,CD83,42336229,42354809,18580,-1
NP_001071406.1,Bos_taurus,23,RNF182,42467106,42467856,750,-1
NP_001095779.1,Bos_taurus,23,MCUR1,42547987,42567084,19097,1
XP_010816870.2,Bos_taurus,23,RANBP9,42736665,42794220,57555,1
NP_001029556.1,Bos_taurus,23,NOL7,42795874,42799980,4106,-1
NP_001029467.1,Bos_taurus,23,SIRT5,42804422,42820539,16117,-1
NP_001015643.1,Bos_taurus,23,TBC1D7,43002796,43023933,21137,1
NP_001179840.1,Bos_taurus,23,PHACTR1,43054177,43249577,195400,-1
XP_015315488.1,Bos_taurus,23,LOC107131301,43504755,43647528,142773,-1
NP_851353.1,Bos_taurus,23,EDN1,44011560,44017131,5571,-1
XP_010816910.1,Bos_taurus,23,HIVEP1,44139449,44268437,128988,-1
NP_001032710.1,Bos_taurus,23,ADTRP,44469120,44536106,66986,1
XP_002697637.2,Bos_taurus,23,TMEM170B,44660174,44688019,27845,-1
NP_001095317.2,Bos_taurus,23,NEDD9,44955888,44986928,31040,1
NP_001129050.1,Bos_taurus,23,SMIM13,45024691,45041722,17031,-1
NP_001076986.1,Bos_taurus,23,ELOVL2,45093668,45111322,17654,1
XP_002697663.3,Bos_taurus,23,GCM2,45183078,45191309,8231,1
NP_001039880.2,Bos_taurus,23,MAK,45215424,45258157,42733,1
NP_001030514.1,Bos_taurus,23,TMEM14C,45266131,45271264,5133,-1
NP_001014852.1,Bos_taurus,23,PAK1IP1,45276647,45287337,10690,-1
XP_005223944.1,Bos_taurus,23,LOC100848875,45347953,45404713,56760,-1
NP_001094697.1,Bos_taurus,23,GCNT2,45370690,45371656,966,-1
NP_001073697.1,Bos_taurus,23,TFAP2A,45480585,45497627,17042,1
XP_015315497.1,Bos_taurus,23,OFCC1,45861270,45953579,92309,1
NP_001035689.1,Bos_taurus,23,EEF1E1,47219521,47234197,14676,1
NP_001092345.1,Bos_taurus,23,BLOC1S5,47244999,47268188,23189,1
NP_001193661.1,Bos_taurus,23,TXNDC5,47333405,47349788,16383,-1
XP_002697643.1,Bos_taurus,23,SNRNP48,47647916,47663909,15993,-1
XP_005223950.1,Bos_taurus,23,SNRNP48,47647916,47663909,15993,-1
XP_010816917.1,Bos_taurus,23,SNRNP48,47647916,47663909,15993,-1
NP_001179297.1,Bos_taurus,23,DSP,47671218,47714288,43070,-1
XP_015315500.1,Bos_taurus,23,CAGE1,47807173,47846154,38981,1
NP_001095592.1,Bos_taurus,23,SSR1,47853878,47869743,15865,1
NP_001077230.1,Bos_taurus,23,LY86,48385735,48430517,44782,-1
NP_001161366.1,Bos_taurus,23,F13A1,48635989,48775083,139094,1
NP_001039903.1,Bos_taurus,23,NRN1,48868378,48876549,8171,1
NP_001070273.1,Bos_taurus,23,FARS2,48974819,49233786,258967,-1
NP_001069774.1,Bos_taurus,23,LYRM4,49283282,49373963,90681,1
XP_010816926.1,Bos_taurus,23,PPP1R3G,49386707,49387742,1035,-1
NP_001098872.1,Bos_taurus,23,RPP40,49410733,49420147,9414,1
NP_001095693.1,Bos_taurus,23,CDYL,49452872,49548143,95271,-1
NP_001029414.2,Bos_taurus,23,ECI2,49909572,49923551,13979,1
XP_015315489.1,Bos_taurus,23,C23H6orf201,49923711,49931181,7470,-1
XP_015315503.1,Bos_taurus,23,FAM217A,49939604,49947593,7989,1
NP_001069025.1,Bos_taurus,23,PRPF4B,49954743,49977786,23043,-1
NP_001070400.1,Bos_taurus,23,PXDC1,50077730,50094900,17170,1
NP_001069809.1,Bos_taurus,23,SLC22A23,50234200,50323372,89172,1
XP_002697651.1,Bos_taurus,23,PSMG4,50327519,50331670,4151,-1
NP_001003900.1,Bos_taurus,23,TUBB2B,50354937,50357631,2694,1
XP_010816931.1,Bos_taurus,23,LOC104969934,50377724,50378817,1093,1
NP_001039383.1,Bos_taurus,23,BPHL,50395183,50417050,21867,-1
NP_001030184.1,Bos_taurus,23,RIPK1,50421320,50446671,25351,-1
NP_001029495.1,Bos_taurus,23,NQO2,50487524,50496961,9437,-1
XP_010816934.1,Bos_taurus,23,LOC617396,50573367,50581382,8015,-1
NP_777214.1,Bos_taurus,23,SERPINB6,50609754,50617511,7757,1
NP_001069327.1,Bos_taurus,23,SERPINB9,50638189,50644250,6061,1
NP_001193539.1,Bos_taurus,23,SERPINB1,50673609,50678834,5225,-1
NP_001096576.1,Bos_taurus,23,WRNIP1,50703901,50742372,38471,-1
NP_001073800.1,Bos_taurus,23,GMDS,51115435,51453348,337913,1
XP_015315491.1,Bos_taurus,23,LOC101905813,51606432,51610902,4470,1
XP_010816950.1,Bos_taurus,23,LOC104969983,51622496,51650353,27857,1
NP_001193088.1,Bos_taurus,23,EXOC2,51917536,52014590,97054,1
NP_001193091.1,Bos_taurus,23,IRF4,52050984,52063652,12668,-1
XP_010799069.1,Bos_taurus,23,LOC613394,52397482,52398420,938,-1
XP_010799071.2,Bos_taurus,23,LOC100138976,52431757,52432741,984,1
XP_002683845.1,Bos_taurus,23,OR5M10,52444475,52445489,1014,-1
XP_010799072.2,Bos_taurus,23,LOC101909723,52504147,52505054,907,-1
NP_443141.3,Homo_sapiens,5,PLEKHG4B,140307,182323,42016,1
NP_001073947.1,Homo_sapiens,5,LRRC14B,191538,195353,3815,1
NP_660308.1,Homo_sapiens,5,CCDC127,205296,216849,11553,-1
NP_004159.2,Homo_sapiens,5,SDHA,218355,256420,38065,1
NP_001281261.1,Homo_sapiens,5,SDHA,218355,256420,38065,1
NP_037364.1,Homo_sapiens,5,PDCD6,271720,314515,42795,1
NP_001254485.1,Homo_sapiens,5,PDCD6,271720,314515,42795,1
NP_001254486.1,Homo_sapiens,5,PDCD6,271720,314515,42795,1
NP_001254488.1,Homo_sapiens,5,PDCD6,271720,314418,42698,1
NP_065782.2,Homo_sapiens,5,AHRR,304219,434834,130615,1
NP_001229341.1,Homo_sapiens,5,AHRR,304219,434834,130615,1
NP_001254487.1,Homo_sapiens,5,PDCD6,306603,314515,7912,1
NP_009208.2,Homo_sapiens,5,EXOC3,446205,466898,20693,1
NP_001271280.1,Homo_sapiens,5,SLC9A3,473378,524322,50944,-1
NP_004165.2,Homo_sapiens,5,SLC9A3,473378,524322,50944,-1
NP_060610.2,Homo_sapiens,5,CEP72,612361,653153,40792,1
NP_008961.1,Homo_sapiens,5,TPPP,665101,678060,12959,-1
NP_079062.1,Homo_sapiens,5,ZDHHC11,801106,850602,49496,-1
NP_076413.3,Homo_sapiens,5,BRD9,864467,892657,28190,-1
NP_001009877.2,Homo_sapiens,5,BRD9,864467,891752,27285,-1
NP_001304880.1,Homo_sapiens,5,BRD9,864467,889699,25232,-1
NP_004228.1,Homo_sapiens,5,TRIP13,892998,917103,24105,1
NP_001159732.1,Homo_sapiens,5,TRIP13,892998,908465,15467,1
NP_149111.1,Homo_sapiens,5,NKD2,1009057,1038373,29316,1
NP_001258011.1,Homo_sapiens,5,NKD2,1009057,1037668,28611,1
NP_006589.2,Homo_sapiens,5,SLC12A7,1052359,1111991,59632,-1
NP_001003841.1,Homo_sapiens,5,SLC6A19,1201650,1221904,20254,1
NP_872438.2,Homo_sapiens,5,SLC6A18,1225477,1246078,20601,1
NP_001180305.1,Homo_sapiens,5,TERT,1253727,1294989,41262,-1
NP_937983.2,Homo_sapiens,5,TERT,1253727,1294989,41262,-1
NP_110409.2,Homo_sapiens,5,CLPTM1L,1318368,1344841,26473,-1
NP_001035.1,Homo_sapiens,5,SLC6A3,1394734,1443197,48463,-1
NP_079106.3,Homo_sapiens,5,LPCAT1,1463650,1523844,60194,-1
NP_115868.1,Homo_sapiens,5,MRPL36,1798623,1798935,312,-1
NP_004544.1,Homo_sapiens,5,NDUFS6,1801417,1815916,14499,1
NP_001265561.1,Homo_sapiens,5,IRX4,1877968,1882647,4679,-1
NP_001265563.1,Homo_sapiens,5,IRX4,1877968,1882647,4679,-1
NP_057442.1,Homo_sapiens,5,IRX4,1877968,1882647,4679,-1
NP_001265562.1,Homo_sapiens,5,IRX4,1877968,1882647,4679,-1
NP_001265564.1,Homo_sapiens,5,IRX4,1877968,1882647,4679,-1
NP_001127694.1,Homo_sapiens,5,IRX2,2747563,2751413,3850,-1
NP_150366.1,Homo_sapiens,5,IRX2,2747563,2751413,3850,-1
NP_848664.1,Homo_sapiens,5,C5orf38,2752264,2755041,2777,1
NP_001281266.1,Homo_sapiens,5,C5orf38,2752264,2755041,2777,1
NP_001293078.1,Homo_sapiens,5,C5orf38,2752264,2753359,1095,1
NP_001293079.1,Homo_sapiens,5,C5orf38,2752264,2753359,1095,1
NP_077313.3,Homo_sapiens,5,IRX1,3596105,3601040,4935,1
NP_620687.2,Homo_sapiens,5,ADAMTS16,5140467,5319138,178671,1
NP_056140.1,Homo_sapiens,5,ICE1,5422915,5489330,66415,1
NP_115662.2,Homo_sapiens,5,MED10,6372502,6378483,5981,-1
NP_001138633.1,Homo_sapiens,5,UBE2QL1,6448893,6491349,42456,1
NP_001180384.1,Homo_sapiens,5,NSUN2,6599925,6632979,33054,-1
NP_060225.4,Homo_sapiens,5,NSUN2,6599925,6632979,33054,-1
NP_001311251.1,Homo_sapiens,5,SRD5A1,6633550,6668268,34718,1
NP_001038.1,Homo_sapiens,5,SRD5A1,6633576,6668268,34692,1
NP_001311252.1,Homo_sapiens,5,SRD5A1,6645235,6668268,23033,1
NP_008930.1,Homo_sapiens,5,PAPD7,6737543,6754945,17402,1
NP_001165276.1,Homo_sapiens,5,PAPD7,6737543,6754945,17402,1
NP_001165277.1,Homo_sapiens,5,PAPD7,6746258,6754945,8687,1
NP_065433.2,Homo_sapiens,5,ADCY2,7396296,7826871,430575,1
NP_001083053.1,Homo_sapiens,5,C5orf49,7831849,7851021,19172,-1
NP_076996.2,Homo_sapiens,5,FASTKD3,7859434,7868083,8649,-1
NP_076915.2,Homo_sapiens,5,MTRR,7869133,7900058,30925,1
NP_002445.2,Homo_sapiens,5,MTRR,7870794,7900058,29264,1
NP_003957.2,Homo_sapiens,5,SEMA5A,9042896,9379946,337050,-1
NP_062545.1,Homo_sapiens,5,TAS2R1,9629132,9630032,900,-1
NP_001245317.1,Homo_sapiens,5,FAM173B,10227440,10249873,22433,-1
NP_954584.2,Homo_sapiens,5,FAM173B,10227440,10249873,22433,-1
NP_001245318.1,Homo_sapiens,5,FAM173B,10227621,10249873,22252,-1
NP_001293082.1,Homo_sapiens,5,CCT5,10250003,10264783,14780,1
NP_036205.1,Homo_sapiens,5,CCT5,10250340,10264783,14443,1
NP_001293083.1,Homo_sapiens,5,CCT5,10250340,10264783,14443,1
NP_001293085.1,Homo_sapiens,5,CCT5,10254153,10264783,10630,1
NP_001293084.1,Homo_sapiens,5,CCT5,10254153,10264783,10630,1
NP_620164.1,Homo_sapiens,5,CMBL,10280452,10290762,10310,-1
NP_005876.2,Homo_sapiens,5,MARCH6,10353898,10433684,79786,1
NP_001257589.1,Homo_sapiens,5,MARCH6,10353898,10433684,79786,1
NP_001257590.1,Homo_sapiens,5,MARCH6,10353898,10433684,79786,1
NP_114122.2,Homo_sapiens,5,ROPN1L,10442167,10464947,22780,1
NP_001188395.1,Homo_sapiens,5,ROPN1L,10442167,10464947,22780,1
XP_011512492.1,Homo_sapiens,5,LOC105369214,10463969,10464695,726,1
NP_001157912.1,Homo_sapiens,5,ANKRD33B,10564467,10650113,85646,1
NP_001278892.1,Homo_sapiens,5,DAP,10680706,10761068,80362,-1
NP_004385.1,Homo_sapiens,5,DAP,10681055,10761068,80013,-1
NP_001323.1,Homo_sapiens,5,CTNND2,10973452,11903853,930401,-1
NP_001275645.1,Homo_sapiens,5,CTNND2,10973452,11564957,591505,-1
NP_001275644.1,Homo_sapiens,5,CTNND2,10973452,11564957,591505,-1
NP_001275646.1,Homo_sapiens,5,CTNND2,10973452,11364768,391316,-1
NP_001360.1,Homo_sapiens,5,DNAH5,13691983,13944438,252455,-1
NP_009049.2,Homo_sapiens,5,TRIO,14143725,14508422,364697,1
NP_061891.1,Homo_sapiens,5,FAM105A,14581894,14610314,28420,1
NP_612357.4,Homo_sapiens,5,OTULIN,14664825,14693048,28223,1
NP_473368.1,Homo_sapiens,5,ANKH,14711196,14871447,160251,-1
NP_036436.1,Homo_sapiens,5,FBXL7,15500676,15937186,436510,1
NP_001265246.1,Homo_sapiens,5,FBXL7,15927903,15937186,9283,1
NP_001096032.1,Homo_sapiens,5,MARCH11,16067470,16179575,112105,-1
NP_219482.1,Homo_sapiens,5,ZNF622,16451656,16465665,14009,-1
NP_001030022.1,Homo_sapiens,5,FAM134B,16474740,16616971,142231,-1
NP_061873.2,Homo_sapiens,5,FAM134B,16474740,16508612,33872,-1
NP_036466.2,Homo_sapiens,5,MYO10,16666691,16935808,269117,-1
NP_006308.3,Homo_sapiens,5,BASP1,17275216,17275900,684,1
NP_001258535.1,Homo_sapiens,5,BASP1,17275216,17275900,684,1
NP_004925.1,Homo_sapiens,5,CDH18,19473225,19838986,365761,-1
NP_001278885.1,Homo_sapiens,5,CDH18,19473225,19838986,365761,-1
NP_001161139.1,Homo_sapiens,5,CDH18,19483348,19838986,355638,-1
NP_001278886.1,Homo_sapiens,5,CDH18,19483348,19838986,355638,-1
NP_001304157.1,Homo_sapiens,5,CDH12,21751736,22078676,326940,-1
NP_004052.2,Homo_sapiens,5,CDH12,21751736,22078676,326940,-1
NP_001304156.1,Homo_sapiens,5,CDH12,21751736,22078676,326940,-1
NP_064612.2,Homo_sapiens,5,PRDM9,23509033,23527773,18740,1
NP_001304153.1,Homo_sapiens,5,CDH10,24487662,24593490,105828,-1
NP_006718.2,Homo_sapiens,5,CDH10,24487662,24593490,105828,-1
NP_001304151.1,Homo_sapiens,5,CDH10,24487662,24491669,4007,-1
NP_057363.3,Homo_sapiens,5,CDH9,26881135,26988333,107198,-1
NP_004923.1,Homo_sapiens,5,CDH6,31267473,31323308,55835,1
NP_001093882.1,Homo_sapiens,5,DROSHA,31401431,31529059,127628,-1
NP_037367.3,Homo_sapiens,5,DROSHA,31401431,31529059,127628,-1
NP_060826.2,Homo_sapiens,5,C5orf22,31532392,31552902,20510,1
NP_835260.2,Homo_sapiens,5,PDZD2,31799248,32108135,308887,1
NP_071413.1,Homo_sapiens,5,GOLPH3,32126211,32174034,47823,-1
NP_001281273.1,Homo_sapiens,5,MTMR12,32229777,32312838,83061,-1
NP_001281272.1,Homo_sapiens,5,MTMR12,32229777,32312838,83061,-1
NP_001035536.1,Homo_sapiens,5,MTMR12,32229777,32312838,83061,-1
NP_057191.2,Homo_sapiens,5,ZFR,32355759,32444658,88899,-1
NP_006704.3,Homo_sapiens,5,SUB1,32588512,32601084,12572,1
NP_001191305.1,Homo_sapiens,5,NPR3,32710662,32786345,75683,1
NP_001191304.1,Homo_sapiens,5,NPR3,32711776,32786345,74569,1
NP_000899.1,Homo_sapiens,5,NPR3,32711776,32786345,74569,1
NP_001245367.1,Homo_sapiens,5,TARS,33441086,33467708,26622,1
NP_689508.3,Homo_sapiens,5,TARS,33441086,33467708,26622,1
NP_001245366.1,Homo_sapiens,5,TARS,33441086,33467708,26622,1
NP_112217.2,Homo_sapiens,5,ADAMTS12,33527187,33891856,364669,-1
NP_057652.1,Homo_sapiens,5,RXFP3,33936740,33938150,1410,1
NP_057264.3,Homo_sapiens,5,SLC45A2,33944647,33984583,39936,-1
NP_001012527.1,Homo_sapiens,5,SLC45A2,33947147,33984583,37436,-1
NP_001284346.2,Homo_sapiens,5,SLC45A2,33951651,33984583,32932,-1
NP_001161067.1,Homo_sapiens,5,AMACR,33988307,34008019,19712,-1
NP_055139.4,Homo_sapiens,5,AMACR,33989092,34008019,18927,-1
NP_976316.1,Homo_sapiens,5,AMACR,33989483,34008019,18536,-1
NP_112207.1,Homo_sapiens,5,C1QTNF3,34020582,34043125,22543,-1
NP_852100.3,Homo_sapiens,5,C1QTNF3,34020582,34043125,22543,-1
NP_056392.2,Homo_sapiens,5,RAI14,34686919,34830765,143846,1
NP_001138992.1,Homo_sapiens,5,RAI14,34686919,34830765,143846,1
NP_001138993.1,Homo_sapiens,5,RAI14,34686919,34830765,143846,1
NP_001138994.1,Homo_sapiens,5,RAI14,34686919,34830765,143846,1
NP_001138995.1,Homo_sapiens,5,RAI14,34687710,34830765,143055,1
NP_001138997.1,Homo_sapiens,5,RAI14,34688203,34830765,142562,1
NP_001304878.1,Homo_sapiens,5,TTC23L,34839634,34896778,57144,1
NP_653326.3,Homo_sapiens,5,TTC23L,34840671,34896778,56107,1
NP_002844.1,Homo_sapiens,5,RAD1,34908764,34914892,6128,-1
NP_060791.3,Homo_sapiens,5,BRIX1,34915738,34925495,9757,1
NP_919259.3,Homo_sapiens,5,DNAJC21,34929819,34954714,24895,1
NP_001012339.2,Homo_sapiens,5,DNAJC21,34929819,34954714,24895,1
NP_001293102.1,Homo_sapiens,5,AGXT2,34998718,35047892,49174,-1
NP_114106.1,Homo_sapiens,5,AGXT2,34998718,35047892,49174,-1
NP_001191247.1,Homo_sapiens,5,PRLR,35049286,35089620,40334,-1
NP_001191245.1,Homo_sapiens,5,PRLR,35049286,35089620,40334,-1
NP_001191246.1,Homo_sapiens,5,PRLR,35049396,35089620,40224,-1
NP_001191243.1,Homo_sapiens,5,PRLR,35065088,35089620,24532,-1
NP_000940.1,Homo_sapiens,5,PRLR,35065088,35089620,24532,-1
NP_001191244.1,Homo_sapiens,5,PRLR,35065335,35089620,24285,-1
NP_079143.3,Homo_sapiens,5,SPEF2,35617997,35814553,196556,1
NP_653323.1,Homo_sapiens,5,SPEF2,35617997,35670248,52251,1
NP_002176.2,Homo_sapiens,5,IL7R,35856977,35876486,19509,1
NP_001036090.1,Homo_sapiens,5,CAPSL,35904544,35921120,16576,-1
NP_653248.3,Homo_sapiens,5,CAPSL,35904544,35921120,16576,-1
NP_689617.3,Homo_sapiens,5,UGT3A1,35954201,35991240,37039,-1
NP_001165344.1,Homo_sapiens,5,UGT3A1,35962873,35988483,25610,-1
NP_001161788.1,Homo_sapiens,5,UGT3A2,36035697,36066789,31092,-1
NP_777574.2,Homo_sapiens,5,UGT3A2,36035697,36066789,31092,-1
NP_001007528.1,Homo_sapiens,5,LMBRD2,36104045,36143349,39304,-1
NP_116026.1,Homo_sapiens,5,SKP2,36152262,36184011,31749,1
NP_005974.2,Homo_sapiens,5,SKP2,36152262,36182031,29769,1
NP_001230049.1,Homo_sapiens,5,SKP2,36166633,36182031,15398,1
NP_001078880.1,Homo_sapiens,5,NADK2,36195143,36241798,46655,-1
NP_694558.1,Homo_sapiens,5,NADK2,36195143,36225612,30469,-1
NP_001274269.1,Homo_sapiens,5,NADK2,36195143,36225612,30469,-1
NP_001274270.1,Homo_sapiens,5,NADK2,36195143,36225612,30469,-1
NP_001310202.1,Homo_sapiens,5,RANBP3L,36248640,36301416,52776,-1
NP_001310207.1,Homo_sapiens,5,RANBP3L,36249653,36301416,51763,-1
NP_001310204.1,Homo_sapiens,5,RANBP3L,36249653,36301416,51763,-1
NP_001310208.1,Homo_sapiens,5,RANBP3L,36249653,36301416,51763,-1
NP_659437.3,Homo_sapiens,5,RANBP3L,36249653,36301416,51763,-1
NP_001154901.1,Homo_sapiens,5,RANBP3L,36249653,36301416,51763,-1
NP_001310209.1,Homo_sapiens,5,RANBP3L,36251304,36301416,50112,-1
NP_001310205.1,Homo_sapiens,5,RANBP3L,36251304,36301416,50112,-1
NP_001310206.1,Homo_sapiens,5,RANBP3L,36251304,36301416,50112,-1
NP_001310203.1,Homo_sapiens,5,RANBP3L,36251304,36301416,50112,-1
NP_004163.3,Homo_sapiens,5,SLC1A3,36608423,36686269,77846,1
NP_001160167.1,Homo_sapiens,5,SLC1A3,36608423,36686269,77846,1
NP_001276869.1,Homo_sapiens,5,SLC1A3,36608423,36686269,77846,1
NP_001276868.1,Homo_sapiens,5,SLC1A3,36608423,36686269,77846,1
NP_001160168.1,Homo_sapiens,5,SLC1A3,36608423,36608621,198,1
NP_597677.2,Homo_sapiens,5,NIPBL,36953696,37064892,111196,1
NP_056199.2,Homo_sapiens,5,NIPBL,36953696,37064023,110327,1
NP_075561.3,Homo_sapiens,5,C5orf42,37107601,37247698,140097,-1
NP_001265241.1,Homo_sapiens,5,NUP155,37291899,37370977,79078,-1
NP_705618.1,Homo_sapiens,5,NUP155,37291899,37370977,79078,-1
NP_004289.1,Homo_sapiens,5,NUP155,37291899,37364364,72465,-1
NP_060504.1,Homo_sapiens,5,WDR70,37379367,37752573,373206,1
NP_001177398.1,Homo_sapiens,5,GDNF,37815650,37835658,20008,-1
NP_001177397.1,Homo_sapiens,5,GDNF,37815650,37835658,20008,-1
NP_954701.1,Homo_sapiens,5,GDNF,37815650,37834796,19146,-1
NP_000505.1,Homo_sapiens,5,GDNF,37815650,37834796,19146,-1
NP_001265027.1,Homo_sapiens,5,GDNF,37815650,37816130,480,-1
NP_001265023.1,Homo_sapiens,5,GDNF-AS1,37875356,37875674,318,1
NP_001192230.1,Homo_sapiens,5,EGFLAM,38258754,38463986,205232,1
NP_689616.2,Homo_sapiens,5,EGFLAM,38258754,38463986,205232,1
NP_877950.1,Homo_sapiens,5,EGFLAM,38403881,38463986,60105,1
NP_877953.1,Homo_sapiens,5,EGFLAM,38451342,38463986,12644,1
NP_001121143.1,Homo_sapiens,5,LIFR,38481594,38530647,49053,-1
NP_002301.1,Homo_sapiens,5,LIFR,38481594,38530647,49053,-1
NP_001310435.1,Homo_sapiens,5,OSMR,38869044,38933444,64400,1
NP_001310434.1,Homo_sapiens,5,OSMR,38869044,38933444,64400,1
NP_003990.1,Homo_sapiens,5,OSMR,38869044,38933444,64400,1
NP_001310436.1,Homo_sapiens,5,OSMR,38869044,38919367,50323,1
NP_001310433.1,Homo_sapiens,5,OSMR,38869044,38886228,17184,1
NP_001161827.1,Homo_sapiens,5,OSMR,38869044,38886228,17184,1
NP_689969.2,Homo_sapiens,5,RICTOR,38942303,39074377,132074,-1
NP_001272368.1,Homo_sapiens,5,RICTOR,38942303,39074377,132074,-1
NP_001272369.1,Homo_sapiens,5,RICTOR,38942303,38975570,33267,-1
NP_001230022.1,Homo_sapiens,5,FYB,39107442,39270571,163129,-1
NP_955367.1,Homo_sapiens,5,FYB,39107442,39202960,95518,-1
NP_001456.3,Homo_sapiens,5,FYB,39107442,39202960,95518,-1
NP_001728.1,Homo_sapiens,5,C9,39285198,39364464,79266,-1
NP_001231800.1,Homo_sapiens,5,DAB2,39375018,39394320,19302,-1
NP_001334.2,Homo_sapiens,5,DAB2,39375018,39394320,19302,-1
NP_000949.1,Homo_sapiens,5,PTGER4,40680993,40692378,11385,1
NP_036514.1,Homo_sapiens,5,TTC33,40716144,40747018,30874,-1
NP_006242.5,Homo_sapiens,5,PRKAA1,40762777,40798189,35412,-1
NP_996790.3,Homo_sapiens,5,PRKAA1,40762777,40798189,35412,-1
NP_000988.1,Homo_sapiens,5,RPL37,40832503,40835185,2682,-1
NP_115976.2,Homo_sapiens,5,CARD6,40841382,40854446,13064,1
NP_000578.2,Homo_sapiens,5,C7,40909610,40981573,71963,1
NP_775760.3,Homo_sapiens,5,MROH2B,40998051,41070852,72801,-1
NP_000056.2,Homo_sapiens,5,C6,41142824,41203230,60406,-1
NP_001108603.2,Homo_sapiens,5,C6,41142824,41203230,60406,-1
NP_001005473.1,Homo_sapiens,5,PLCXD3,41313616,41510526,196910,-1
NP_000427.1,Homo_sapiens,5,OXCT1,41731728,41870358,138630,-1
NP_787117.3,Homo_sapiens,5,C5orf51,41904367,41917299,12932,1
NP_036308.1,Homo_sapiens,5,FBXO4,41925309,41941281,15972,1
NP_001284366.1,Homo_sapiens,5,FBXO4,41925309,41941211,15902,1
NP_277019.1,Homo_sapiens,5,FBXO4,41925309,41934334,9025,1
NP_001229328.1,Homo_sapiens,5,GHR,42424588,42719424,294836,1
NP_001229329.1,Homo_sapiens,5,GHR,42565874,42719424,153550,1
NP_001229330.1,Homo_sapiens,5,GHR,42565874,42719424,153550,1
NP_001229331.1,Homo_sapiens,5,GHR,42565874,42719424,153550,1
NP_001229332.1,Homo_sapiens,5,GHR,42565874,42719424,153550,1
NP_001229333.1,Homo_sapiens,5,GHR,42565874,42719424,153550,1
NP_001229334.1,Homo_sapiens,5,GHR,42565874,42719424,153550,1
NP_001229335.1,Homo_sapiens,5,GHR,42565874,42719424,153550,1
NP_000154.1,Homo_sapiens,5,GHR,42565874,42719424,153550,1
NP_001229389.1,Homo_sapiens,5,GHR,42565874,42719424,153550,1
NP_001229391.1,Homo_sapiens,5,GHR,42565874,42718465,152591,1
NP_001128320.1,Homo_sapiens,5,CCDC152,42759121,42799781,40660,1
NP_001087195.1,Homo_sapiens,5,SEPP1,42800719,42810767,10048,-1
NP_001078955.1,Homo_sapiens,5,SEPP1,42800719,42808353,7634,-1
NP_005401.3,Homo_sapiens,5,SEPP1,42800719,42808353,7634,-1
NP_001014301.1,Homo_sapiens,5,ANXA2R,43039464,43040046,582,-1
NP_001284477.1,Homo_sapiens,5,ZNF131,43122053,43175133,53080,1
NP_003423.1,Homo_sapiens,5,ZNF131,43122053,43175133,53080,1
NP_699192.1,Homo_sapiens,5,NIM1K,43245775,43280729,34954,1
NP_001311151.1,Homo_sapiens,5,HMGCS1,43291130,43298965,7835,-1
NP_001311152.1,Homo_sapiens,5,HMGCS1,43291130,43298965,7835,-1
NP_001311153.1,Homo_sapiens,5,HMGCS1,43291130,43298965,7835,-1
NP_001311149.1,Homo_sapiens,5,HMGCS1,43291130,43298965,7835,-1
NP_001311148.1,Homo_sapiens,5,HMGCS1,43291130,43298965,7835,-1
NP_001091742.1,Homo_sapiens,5,HMGCS1,43291130,43298965,7835,-1
NP_002121.4,Homo_sapiens,5,HMGCS1,43291130,43298965,7835,-1
NP_683513.1,Homo_sapiens,5,CCL28,43381859,43412316,30457,-1
NP_001288802.1,Homo_sapiens,5,CCL28,43381859,43412316,30457,-1
NP_001288803.1,Homo_sapiens,5,CCL28,43381859,43412316,30457,-1
NP_001288804.1,Homo_sapiens,5,CCL28,43381859,43388399,6540,-1
NP_071928.2,Homo_sapiens,5,TMEM267,43446221,43453969,7748,-1
NP_940968.1,Homo_sapiens,5,C5orf34,43486914,43509339,22425,-1
NP_877590.1,Homo_sapiens,5,PAIP1,43527375,43556846,29471,-1
NP_006442.2,Homo_sapiens,5,PAIP1,43527375,43556846,29471,-1
NP_899152.1,Homo_sapiens,5,PAIP1,43527375,43555928,28553,-1
NP_892022.2,Homo_sapiens,5,NNT,43609195,43704404,95209,1
NP_036475.3,Homo_sapiens,5,NNT,43609195,43704404,95209,1
NP_004456.1,Homo_sapiens,5,FGF10,44304994,44388682,83688,-1
NP_057724.2,Homo_sapiens,5,MRPS30,44808962,44815202,6240,1
NP_066550.2,Homo_sapiens,5,HCN1,45261920,45696093,434173,-1
NP_940851.1,Homo_sapiens,5,EMB,50399272,50441151,41879,-1
NP_078891.2,Homo_sapiens,5,PARP8,50667095,50842068,174973,1
NP_001171526.1,Homo_sapiens,5,PARP8,50667095,50842068,174973,1
NP_001171527.1,Homo_sapiens,5,PARP8,50667095,50842068,174973,1
NP_002193.2,Homo_sapiens,5,ISL1,51383671,51393610,9939,1
NP_852478.1,Homo_sapiens,5,ITGA1,52788353,52952451,164098,1
NP_057030.3,Homo_sapiens,5,PELO,52800394,52801840,1446,1
NP_002194.2,Homo_sapiens,5,ITGA2,52989468,53090599,101131,1
NP_004522.1,Homo_sapiens,5,MOCS2,53098601,53107174,8573,-1
NP_789776.1,Homo_sapiens,5,MOCS2,53107094,53109729,2635,-1
NP_037541.1,Homo_sapiens,5,FST,53480791,53486033,5242,1
NP_006341.1,Homo_sapiens,5,FST,53480791,53485688,4897,1
NP_002486.1,Homo_sapiens,5,NDUFS4,53560662,53683221,122559,1
NP_001304980.1,Homo_sapiens,5,NDUFS4,53560662,53683130,122468,1
NP_061960.1,Homo_sapiens,5,ARL15,53886560,54310479,423919,-1
NP_006299.1,Homo_sapiens,5,HSPB3,54455789,54456242,453,1
NP_001096045.1,Homo_sapiens,5,SNX18,54517952,54543432,25480,1
NP_001138899.1,Homo_sapiens,5,SNX18,54517952,54543180,25228,1
NP_443102.2,Homo_sapiens,5,SNX18,54517952,54519839,1887,1
NP_001129076.1,Homo_sapiens,5,ESM1,54979331,54985517,6186,-1
NP_008967.1,Homo_sapiens,5,ESM1,54979331,54985517,6186,-1
NP_002095.1,Homo_sapiens,5,GZMK,55024322,55033926,9604,1
NP_006135.1,Homo_sapiens,5,GZMA,55102682,55110182,7500,1
NP_001139206.2,Homo_sapiens,5,CDC20B,55114217,55173000,58783,-1
NP_689836.2,Homo_sapiens,5,CDC20B,55114217,55173000,58783,-1
NP_001163873.1,Homo_sapiens,5,CDC20B,55114217,55173000,58783,-1
NP_001008398.2,Homo_sapiens,5,GPX8,55160192,55164218,4026,1
NP_001293126.1,Homo_sapiens,5,GPX8,55160192,55164218,4026,1
NP_001293130.1,Homo_sapiens,5,GPX8,55160192,55164218,4026,1
NP_001293127.1,Homo_sapiens,5,GPX8,55160192,55164123,3931,1
NP_001177716.1,Homo_sapiens,5,MCIDAS,55220365,55227138,6773,-1
NP_066970.3,Homo_sapiens,5,CCNO,55231374,55233523,2149,-1
NP_061903.2,Homo_sapiens,5,DHX29,55256487,55307573,51086,-1
NP_056175.3,Homo_sapiens,5,SKIV2L2,55308013,55424772,116759,1
NP_003702.2,Homo_sapiens,5,PLPP1,55425205,55534629,109424,-1
NP_795714.1,Homo_sapiens,5,PLPP1,55425205,55534629,109424,-1
NP_775785.2,Homo_sapiens,5,SLC38A9,55626493,55697958,71465,-1
NP_001245216.1,Homo_sapiens,5,SLC38A9,55626493,55691220,64727,-1
NP_001245215.1,Homo_sapiens,5,SLC38A9,55626493,55672619,46126,-1
NP_001269358.1,Homo_sapiens,5,SLC38A9,55626493,55669616,43123,-1
NP_077726.1,Homo_sapiens,5,DDX4,55738963,55816540,77577,1
NP_001136021.1,Homo_sapiens,5,DDX4,55738963,55816540,77577,1
NP_001160005.1,Homo_sapiens,5,DDX4,55738963,55816540,77577,1
NP_001160006.1,Homo_sapiens,5,DDX4,55766929,55816540,49611,1
NP_001229566.1,Homo_sapiens,5,IL31RA,55851570,55922432,70862,1
NP_620586.3,Homo_sapiens,5,IL31RA,55851570,55917120,65550,1
NP_001284499.1,Homo_sapiens,5,IL31RA,55851570,55908659,57089,1
NP_001229567.1,Homo_sapiens,5,IL31RA,55853561,55922432,68871,1
NP_001229565.1,Homo_sapiens,5,IL31RA,55853561,55917120,63559,1
NP_001229568.1,Homo_sapiens,5,IL31RA,55872423,55917120,44697,1
NP_001284501.1,Homo_sapiens,5,IL31RA,55872423,55908659,36236,1
NP_001177910.1,Homo_sapiens,5,IL6ST,55941081,55976278,35197,-1
NP_002175.2,Homo_sapiens,5,IL6ST,55941081,55976278,35197,-1
NP_786943.1,Homo_sapiens,5,IL6ST,55956218,55976278,20060,-1
NP_078945.2,Homo_sapiens,5,ANKRD55,56100182,56232913,132731,-1
NP_001273982.1,Homo_sapiens,5,C5orf67,56511721,56556172,44451,-1
XP_016865616.1,Homo_sapiens,5,LOC105378979,56771005,56771924,919,-1
NP_005912.1,Homo_sapiens,5,MAP3K1,56815573,56893680,78107,1
NP_001165461.1,Homo_sapiens,5,SETD9,56909645,56925336,15691,1
NP_714917.2,Homo_sapiens,5,SETD9,56909645,56916902,7257,1
NP_001309948.1,Homo_sapiens,5,SETD9,56909645,56914036,4391,1
NP_001309947.1,Homo_sapiens,5,SETD9,56910374,56916902,6528,1
NP_001309949.1,Homo_sapiens,5,SETD9,56910374,56914036,3662,1
NP_001309951.1,Homo_sapiens,5,SETD9,56911526,56916902,5376,1
NP_689835.3,Homo_sapiens,5,MIER3,56923127,56952102,28975,-1
NP_001284528.1,Homo_sapiens,5,MIER3,56923127,56952102,28975,-1
NP_001284527.1,Homo_sapiens,5,MIER3,56923127,56952102,28975,-1
NP_001120708.1,Homo_sapiens,5,GPBP1,57214130,57262752,48622,1
NP_001120707.2,Homo_sapiens,5,GPBP1,57214130,57262752,48622,1
NP_075064.1,Homo_sapiens,5,GPBP1,57214130,57262752,48622,1
NP_001190175.1,Homo_sapiens,5,GPBP1,57246334,57262752,16418,1
NP_001017992.1,Homo_sapiens,5,ACTBL2,57481576,57482707,1131,-1
NP_001239155.1,Homo_sapiens,5,PLK2,58454582,58459959,5377,-1
NP_006613.2,Homo_sapiens,5,PLK2,58454582,58459959,5377,-1
NP_689900.1,Homo_sapiens,5,GAPT,58494536,58495010,474,1
NP_001291360.1,Homo_sapiens,5,GAPT,58494536,58495010,474,1
NP_001291358.1,Homo_sapiens,5,GAPT,58494536,58495010,474,1
NP_001291357.1,Homo_sapiens,5,GAPT,58494536,58495010,474,1
NP_001304844.1,Homo_sapiens,5,RAB3C,58582396,58851351,268955,1
NP_612462.1,Homo_sapiens,5,RAB3C,58583208,58851351,268143,1
NP_001159371.1,Homo_sapiens,5,PDE4D,58974663,60185598,1210935,-1
NP_001098101.1,Homo_sapiens,5,PDE4D,58974663,59893622,918959,-1
NP_001184147.1,Homo_sapiens,5,PDE4D,58974663,59768509,793846,-1
NP_006194.2,Homo_sapiens,5,PDE4D,58974663,59586375,611712,-1
NP_001184148.1,Homo_sapiens,5,PDE4D,58974663,59356846,382183,-1
NP_001184149.1,Homo_sapiens,5,PDE4D,58974663,59275402,300739,-1
NP_001184151.1,Homo_sapiens,5,PDE4D,58974663,59039107,64444,-1
NP_001184150.1,Homo_sapiens,5,PDE4D,58974663,59038873,64210,-1
NP_001184152.1,Homo_sapiens,5,PDE4D,58974663,58999536,24873,-1
NP_001138680.1,Homo_sapiens,5,DEPDC1B,60597752,60700093,102341,-1
NP_060839.2,Homo_sapiens,5,DEPDC1B,60597752,60700093,102341,-1
NP_079206.2,Homo_sapiens,5,ELOVL7,60754623,60787397,32774,-1
NP_001098028.1,Homo_sapiens,5,ELOVL7,60754623,60787397,32774,-1
NP_001284546.1,Homo_sapiens,5,ELOVL7,60754623,60784118,29495,-1
NP_001284547.1,Homo_sapiens,5,ELOVL7,60754623,60767897,13274,-1
NP_000073.1,Homo_sapiens,5,ERCC8,60874614,60945008,70394,-1
NP_001007234.1,Homo_sapiens,5,ERCC8,60874614,60922154,47540,-1
NP_001277214.1,Homo_sapiens,5,ERCC8,60874614,60918286,43672,-1
NP_001007235.1,Homo_sapiens,5,ERCC8,60903579,60945008,41429,-1
NP_777549.1,Homo_sapiens,5,NDUFAF2,60945255,61152955,207700,1
NP_001041714.1,Homo_sapiens,5,SMIM15,61159946,61160171,225,-1
NP_065979.1,Homo_sapiens,5,ZSWIM6,61332272,61544317,212045,1
NP_775938.1,Homo_sapiens,5,C5orf64,61643363,61704033,60670,1
NP_001091981.1,Homo_sapiens,5,KIF2A,62306472,62385569,79097,1
NP_004511.2,Homo_sapiens,5,KIF2A,62306472,62385569,79097,1
NP_001230882.1,Homo_sapiens,5,KIF2A,62306472,62385569,79097,1
NP_001230881.1,Homo_sapiens,5,KIF2A,62308507,62385569,77062,1
NP_055288.1,Homo_sapiens,5,DIMT1,62389009,62403772,14763,-1
NP_001128251.1,Homo_sapiens,5,IPO11,62419013,62627318,208305,1
NP_057422.3,Homo_sapiens,5,IPO11,62437279,62627318,190039,1
NP_852607.3,Homo_sapiens,5,LRRC70,62579438,62581307,1869,1
NP_000515.2,Homo_sapiens,5,HTR1A,63960450,63961719,1269,-1
NP_001107033.1,Homo_sapiens,5,RNF180,64200807,64369814,169007,1
NP_001310221.1,Homo_sapiens,5,RNF180,64200807,64330420,129613,1
NP_848627.1,Homo_sapiens,5,RNF180,64200807,64217420,16613,1
NP_001310220.1,Homo_sapiens,5,RNF180,64200807,64217420,16613,1
NP_001025046.1,Homo_sapiens,5,RGS7BP,64506624,64609252,102628,1
NP_001258819.1,Homo_sapiens,5,RGS7BP,64575840,64609252,33412,1
NP_001258820.1,Homo_sapiens,5,RGS7BP,64575840,64609164,33324,1
NP_001157914.1,Homo_sapiens,5,FAM159B,64690623,64718022,27399,1
NP_776190.1,Homo_sapiens,5,SREK1IP1,64724383,64768517,44134,-1
NP_005860.2,Homo_sapiens,5,CWC27,64769146,65018321,249175,1
NP_001284573.1,Homo_sapiens,5,CWC27,64769146,65018182,249036,1
NP_001304929.1,Homo_sapiens,5,CWC27,64769146,64844986,75840,1
NP_001284574.1,Homo_sapiens,5,CWC27,64769146,64807806,38660,1
NP_922932.2,Homo_sapiens,5,ADAMTS6,65151835,65473673,321838,-1
NP_071428.2,Homo_sapiens,5,CENPK,65518474,65554907,36433,-1
NP_001253967.1,Homo_sapiens,5,CENPK,65518474,65554907,36433,-1
NP_056157.1,Homo_sapiens,5,PPWD1,65563310,65587396,24086,1
NP_001265855.1,Homo_sapiens,5,PPWD1,65563437,65587396,23959,1
NP_001265856.1,Homo_sapiens,5,PPWD1,65567563,65587396,19833,1
NP_001265858.1,Homo_sapiens,5,PPWD1,65569945,65587396,17451,1
NP_150230.1,Homo_sapiens,5,TRIM23,65590298,65624274,33976,-1
NP_150231.1,Homo_sapiens,5,TRIM23,65591483,65624274,32791,-1
NP_001647.1,Homo_sapiens,5,TRIM23,65591768,65624274,32506,-1
NP_001087224.1,Homo_sapiens,5,TRAPPC13,65625060,65664611,39551,1
NP_079217.2,Homo_sapiens,5,TRAPPC13,65625060,65664611,39551,1
NP_001230666.1,Homo_sapiens,5,TRAPPC13,65625060,65664611,39551,1
NP_001087225.1,Homo_sapiens,5,TRAPPC13,65625060,65664611,39551,1
NP_061945.1,Homo_sapiens,5,SGTB,65670245,65720807,50562,-1
NP_065777.1,Homo_sapiens,5,NLN,65722373,65822915,100542,1
NP_001240628.1,Homo_sapiens,5,ERBIN,65992718,66078530,85812,1
NP_001240626.1,Homo_sapiens,5,ERBIN,65992718,66078530,85812,1
NP_061165.1,Homo_sapiens,5,ERBIN,65992718,66078530,85812,1
NP_001240627.1,Homo_sapiens,5,ERBIN,65992718,66078530,85812,1
NP_001006600.1,Homo_sapiens,5,ERBIN,65992718,66078530,85812,1
NP_001240630.1,Homo_sapiens,5,ERBIN,65992718,66078530,85812,1
NP_001070667.1,Homo_sapiens,5,SREK1,66144376,66178868,34492,1
NP_001310458.1,Homo_sapiens,5,SREK1,66144376,66178868,34492,1
NP_001310462.1,Homo_sapiens,5,SREK1,66144376,66178755,34379,1
NP_001310456.1,Homo_sapiens,5,SREK1,66159271,66178868,19597,1
NP_631907.1,Homo_sapiens,5,SREK1,66159271,66178868,19597,1
NP_001257421.1,Homo_sapiens,5,SREK1,66159271,66178868,19597,1
NP_001310463.1,Homo_sapiens,5,SREK1,66163831,66178868,15037,1
NP_001310464.1,Homo_sapiens,5,SREK1,66163831,66178868,15037,1
NP_001158136.1,Homo_sapiens,5,MAST4,66596655,67167051,570396,1
NP_942123.1,Homo_sapiens,5,MAST4,66596655,66986486,389831,1
NP_001277157.1,Homo_sapiens,5,MAST4,66596655,66986486,389831,1
NP_055998.1,Homo_sapiens,5,MAST4,66828843,67167051,338208,1
NP_001277155.1,Homo_sapiens,5,MAST4,66959247,67167051,207804,1
NP_001284580.1,Homo_sapiens,5,MAST4,67004993,67167051,162058,1
NP_001277156.1,Homo_sapiens,5,MAST4,67004993,67167051,162058,1
NP_005573.2,Homo_sapiens,5,CD180,67182856,67196641,13785,-1
NP_852664.1,Homo_sapiens,5,PIK3R1,68226675,68297601,70926,1
NP_852665.1,Homo_sapiens,5,PIK3R1,68288735,68297601,8866,1
NP_852556.2,Homo_sapiens,5,PIK3R1,68290728,68297601,6873,1
NP_001229395.1,Homo_sapiens,5,PIK3R1,68293170,68297601,4431,1
NP_075053.2,Homo_sapiens,5,SLC30A5,69094255,69129617,35362,1
NP_076960.1,Homo_sapiens,5,SLC30A5,69094255,69104045,9790,1
NP_001238898.1,Homo_sapiens,5,SLC30A5,69094255,69104045,9790,1
NP_114172.1,Homo_sapiens,5,CCNB1,69167262,69177631,10369,1
NP_075060.1,Homo_sapiens,5,CENPH,69189634,69209799,20165,1
NP_150597.1,Homo_sapiens,5,MRPS36,69217829,69229225,11396,1
NP_001790.1,Homo_sapiens,5,CDK7,69234975,69277135,42160,1
NP_001310999.1,Homo_sapiens,5,CDK7,69234975,69277135,42160,1
NP_001311000.1,Homo_sapiens,5,CDK7,69235009,69277135,42126,1
NP_001310998.1,Homo_sapiens,5,CDK7,69250828,69277135,26307,1
NP_001311003.1,Homo_sapiens,5,CDK7,69255510,69277135,21625,1
NP_001311001.1,Homo_sapiens,5,CDK7,69255510,69277135,21625,1
NP_001311006.1,Homo_sapiens,5,CDK7,69255510,69277135,21625,1
NP_001311004.1,Homo_sapiens,5,CDK7,69255510,69277135,21625,1
NP_001311007.1,Homo_sapiens,5,CDK7,69255510,69277135,21625,1
NP_789786.2,Homo_sapiens,5,CCDC125,69282728,69320540,37812,-1
NP_001284626.1,Homo_sapiens,5,CCDC125,69282728,69311195,28467,-1
NP_001284625.1,Homo_sapiens,5,CCDC125,69285341,69320540,35199,-1
NP_001015891.1,Homo_sapiens,5,AK6,69352060,69369675,17615,-1
NP_057367.1,Homo_sapiens,5,AK6,69352060,69369490,17430,-1
NP_003178.1,Homo_sapiens,5,TAF9,69364942,69365737,795,-1
NP_001015892.1,Homo_sapiens,5,TAF9,69364942,69365737,795,-1
NP_579917.1,Homo_sapiens,5,RAD17,69371515,69414292,42777,1
NP_579916.1,Homo_sapiens,5,RAD17,69372208,69414292,42084,1
NP_579920.1,Homo_sapiens,5,RAD17,69372208,69414292,42084,1
NP_579921.1,Homo_sapiens,5,RAD17,69372208,69414292,42084,1
NP_579922.1,Homo_sapiens,5,RAD17,69372208,69414292,42084,1
NP_002864.1,Homo_sapiens,5,RAD17,69372208,69414292,42084,1
NP_001265551.1,Homo_sapiens,5,RAD17,69372208,69414292,42084,1
NP_579919.1,Homo_sapiens,5,RAD17,69372208,69414292,42084,1
NP_579918.1,Homo_sapiens,5,RAD17,69382044,69414292,32248,1
NP_001033692.2,Homo_sapiens,5,MARVELD2,69419385,69441654,22269,1
NP_001231663.1,Homo_sapiens,5,MARVELD2,69419385,69441654,22269,1
NP_001192183.1,Homo_sapiens,5,OCLN,69504244,69553671,49427,1
NP_002529.1,Homo_sapiens,5,OCLN,69504244,69553671,49427,1
NP_001192184.1,Homo_sapiens,5,OCLN,69513971,69553671,39700,1
NP_001092198.1,Homo_sapiens,5,GTF2H2C,69565132,69592198,27066,1
NP_075267.1,Homo_sapiens,5,SERF1B,70025451,70041740,16289,1
NP_001171558.1,Homo_sapiens,5,SERF1B,70025451,70032387,6936,1
NP_075013.1,Homo_sapiens,5,SMN2,70049685,70077033,27348,1
NP_075015.1,Homo_sapiens,5,SMN2,70049685,70077033,27348,1
NP_059107.1,Homo_sapiens,5,SMN2,70049685,70076571,26886,1
NP_075014.1,Homo_sapiens,5,SMN2,70049685,70076571,26886,1
XP_016865593.1,Homo_sapiens,5,LOC107986351,70510538,70512509,1971,1
XP_016865597.1,Homo_sapiens,5,LOC107986354,70529861,70530446,585,-1
NP_068802.1,Homo_sapiens,5,SERF1A,70900869,70917157,16288,1
NP_075257.1,Homo_sapiens,5,SERF1A,70900869,70907806,6937,1
NP_001284644.1,Homo_sapiens,5,SMN1,70925103,70952453,27350,1
NP_000335.1,Homo_sapiens,5,SMN1,70925103,70951991,26888,1
NP_075012.1,Homo_sapiens,5,SMN1,70925103,70951991,26888,1
NP_075043.1,Homo_sapiens,5,NAIP,70970103,71024373,54270,-1
NP_004527.2,Homo_sapiens,5,NAIP,70970103,71012915,42812,-1
NP_001506.1,Homo_sapiens,5,GTF2H2,71035676,71062763,27087,-1
XP_016865595.1,Homo_sapiens,5,LOC107986352,71215799,71216384,585,-1
XP_016865596.1,Homo_sapiens,5,LOC107986353,71233820,71234405,585,-1
NP_060899.2,Homo_sapiens,5,BDP1,71455877,71564885,109008,1
NP_071415.1,Homo_sapiens,5,MCCC2,71587425,71656860,69435,1
NP_004282.1,Homo_sapiens,5,CARTPT,71719293,71720615,1322,1
NP_005900.2,Homo_sapiens,5,MAP1B,72107531,72205239,97708,1
NP_001311184.1,Homo_sapiens,5,MAP1B,72186622,72205239,18617,1
NP_055899.2,Homo_sapiens,5,MRPS27,72220908,72320221,99313,-1
NP_001273677.1,Homo_sapiens,5,MRPS27,72220908,72320221,99313,-1
NP_001273680.1,Homo_sapiens,5,MRPS27,72220908,72297685,76777,-1
NP_079030.3,Homo_sapiens,5,PTCD2,72320382,72358427,38045,1
NP_001271332.1,Homo_sapiens,5,PTCD2,72320382,72358427,38045,1
NP_001271333.1,Homo_sapiens,5,PTCD2,72326710,72358427,31717,1
NP_001271334.1,Homo_sapiens,5,PTCD2,72335816,72358427,22611,1
NP_689838.1,Homo_sapiens,5,ZNF366,72443755,72461496,17741,-1
NP_002261.3,Homo_sapiens,5,TNPO1,72816737,72905410,88673,1
NP_694858.1,Homo_sapiens,5,TNPO1,72848393,72905410,57017,1
NP_620137.2,Homo_sapiens,5,FCHO2,72956096,73088090,131994,1
NP_001139504.1,Homo_sapiens,5,FCHO2,72956096,73088090,131994,1
NP_775761.4,Homo_sapiens,5,TMEM171,73123373,73131730,8357,1
NP_001154814.1,Homo_sapiens,5,TMEM171,73123373,73131730,8357,1
NP_694949.1,Homo_sapiens,5,TMEM174,73173243,73174165,922,1
NP_004463.1,Homo_sapiens,5,FOXD1,73446964,73448362,1398,-1
NP_001032726.1,Homo_sapiens,5,BTF3,73498667,73505238,6571,1
NP_001198.2,Homo_sapiens,5,BTF3,73499133,73505238,6105,1
NP_075526.1,Homo_sapiens,5,ANKRA2,73552796,73562881,10085,-1
NP_115551.2,Homo_sapiens,5,UTP15,73567344,73580094,12750,1
NP_001271359.1,Homo_sapiens,5,UTP15,73567344,73580094,12750,1
NP_001271360.1,Homo_sapiens,5,UTP15,73570608,73580094,9486,1
NP_001073948.2,Homo_sapiens,5,ARHGEF28,73684851,73941013,256162,1
NP_001171164.1,Homo_sapiens,5,ARHGEF28,73684851,73941013,256162,1
NP_001231293.1,Homo_sapiens,5,ARHGEF28,73813588,73941013,127425,1
NP_001243503.1,Homo_sapiens,5,ENC1,74634715,74636485,1770,-1
NP_001243504.1,Homo_sapiens,5,ENC1,74634715,74636485,1770,-1
NP_003624.1,Homo_sapiens,5,ENC1,74634715,74636485,1770,-1
NP_001243505.1,Homo_sapiens,5,ENC1,74634715,74636266,1551,-1
NP_000512.1,Homo_sapiens,5,HEXB,74685260,74721175,35915,1
NP_001278933.1,Homo_sapiens,5,HEXB,74705224,74721175,15951,1
NP_001268231.1,Homo_sapiens,5,GFM2,74721654,74765106,43452,-1
NP_733792.1,Homo_sapiens,5,GFM2,74721654,74763742,42088,-1
NP_115756.2,Homo_sapiens,5,GFM2,74721654,74763742,42088,-1
NP_733781.1,Homo_sapiens,5,GFM2,74736763,74763742,26979,-1
NP_055701.1,Homo_sapiens,5,NSA2,74767360,74776671,9311,1
NP_001258594.1,Homo_sapiens,5,NSA2,74767360,74776651,9291,1
NP_056381.1,Homo_sapiens,5,FAM169A,74781459,74841676,60217,-1
NP_057675.1,Homo_sapiens,5,GCNT4,75028675,75030037,1362,-1
NP_001157915.1,Homo_sapiens,5,ANKRD31,75068518,75236686,168168,-1
NP_000850.1,Homo_sapiens,5,HMGCR,75342605,75360342,17737,1
NP_001124468.1,Homo_sapiens,5,HMGCR,75342605,75360342,17737,1
NP_001123577.1,Homo_sapiens,5,COL4A3BP,75379345,75511844,132499,-1
NP_112729.1,Homo_sapiens,5,COL4A3BP,75379345,75511207,131862,-1
NP_005704.1,Homo_sapiens,5,COL4A3BP,75379345,75511207,131862,-1
NP_057302.1,Homo_sapiens,5,POLK,75547022,75598018,50996,1
NP_001263642.1,Homo_sapiens,5,ANKDD1B,75611634,75671040,59406,1
NP_001092741.1,Homo_sapiens,5,POC5,75674434,75712937,38503,-1
NP_689621.2,Homo_sapiens,5,POC5,75674434,75712384,37950,-1
NP_001284645.1,Homo_sapiens,5,SV2C,76131750,76353160,221410,1
NP_055794.3,Homo_sapiens,5,SV2C,76131750,76325547,193797,1
NP_006624.2,Homo_sapiens,5,IQGAP2,76403545,76707313,303768,1
NP_001272389.1,Homo_sapiens,5,IQGAP2,76562399,76707313,144914,1
NP_001272390.1,Homo_sapiens,5,IQGAP2,76609163,76707313,98150,1
NP_001272391.1,Homo_sapiens,5,IQGAP2,76609214,76707313,98099,1
NP_004092.1,Homo_sapiens,5,F2RL2,76617581,76623230,5649,-1
NP_001243495.1,Homo_sapiens,5,F2RL2,76617581,76618640,1059,-1
NP_001983.2,Homo_sapiens,5,F2R,76716307,76733503,17196,1
NP_001298242.1,Homo_sapiens,5,F2R,76732588,76733503,915,1
NP_005233.3,Homo_sapiens,5,F2RL1,76819182,76833801,14619,1
NP_570128.2,Homo_sapiens,5,S100Z,76875359,76877832,2473,1
NP_001873.2,Homo_sapiens,5,CRHBP,76953134,76968885,15751,1
NP_060516.2,Homo_sapiens,5,AGGF1,77030766,77063252,32486,1
NP_115743.1,Homo_sapiens,5,ZBED3,77077173,77077878,705,-1
NP_003710.1,Homo_sapiens,5,PDE8B,77210925,77426554,215629,1
NP_001025023.1,Homo_sapiens,5,PDE8B,77210925,77426554,215629,1
NP_001025025.1,Homo_sapiens,5,PDE8B,77210925,77426554,215629,1
NP_001025022.1,Homo_sapiens,5,PDE8B,77210925,77426554,215629,1
NP_001025024.1,Homo_sapiens,5,PDE8B,77210925,77426554,215629,1
NP_060738.2,Homo_sapiens,5,WDR41,77433134,77492220,59086,-1
NP_115485.1,Homo_sapiens,5,OTP,77630263,77638549,8286,-1
NP_001284669.1,Homo_sapiens,5,TBCA,77691417,77776257,84840,-1
NP_004598.1,Homo_sapiens,5,TBCA,77691417,77776257,84840,-1
NP_001284667.1,Homo_sapiens,5,TBCA,77693121,77776257,83136,-1
XP_011542076.1,Homo_sapiens,5,LOC105379045,77775790,77776159,369,-1
NP_003655.3,Homo_sapiens,5,AP3B1,78002901,78294579,291678,-1
NP_001258698.1,Homo_sapiens,5,AP3B1,78002901,78267576,264675,-1
NP_004857.4,Homo_sapiens,5,SCAMP1,78360671,78475668,114997,1
NP_001277158.1,Homo_sapiens,5,SCAMP1,78360671,78475668,114997,1
NP_005770.1,Homo_sapiens,5,LHFPL2,78488896,78510213,21317,-1
NP_000037.2,Homo_sapiens,5,ARSB,78780396,78985248,204852,-1
NP_942002.1,Homo_sapiens,5,ARSB,78816085,78985248,169163,-1
NP_037523.2,Homo_sapiens,5,DMGDH,78998081,79069620,71539,-1
NP_060084.2,Homo_sapiens,5,BHMT2,79069782,79088574,18792,1
NP_001171476.1,Homo_sapiens,5,BHMT2,79069782,79088574,18792,1
NP_001704.2,Homo_sapiens,5,BHMT,79111885,79131116,19231,1
NP_689618.4,Homo_sapiens,5,JMY,79236650,79316307,79657,1
NP_001264006.1,Homo_sapiens,5,HOMER1,79376008,79512774,136766,-1
NP_004263.1,Homo_sapiens,5,HOMER1,79376008,79512774,136766,-1
NP_001264007.1,Homo_sapiens,5,HOMER1,79376190,79512774,136584,-1
NP_776158.2,Homo_sapiens,5,PAPD4,79619648,79685273,65625,1
NP_001107865.1,Homo_sapiens,5,PAPD4,79619648,79685273,65625,1
NP_001107866.1,Homo_sapiens,5,PAPD4,79619648,79685273,65625,1
NP_001284674.1,Homo_sapiens,5,PAPD4,79619648,79685273,65625,1
NP_001284673.1,Homo_sapiens,5,PAPD4,79619648,79685273,65625,1
NP_705838.3,Homo_sapiens,5,CMYA5,79689907,79799616,109709,1
NP_001161213.1,Homo_sapiens,5,MTX3,79983683,79990204,6521,-1
NP_001010891.4,Homo_sapiens,5,MTX3,79983786,79991238,7452,-1
NP_003239.2,Homo_sapiens,5,THBS4,80035537,80083141,47604,1
NP_001293141.1,Homo_sapiens,5,THBS4,80040261,80083141,42880,1
NP_001293143.1,Homo_sapiens,5,THBS4,80040261,80083141,42880,1
NP_001293142.1,Homo_sapiens,5,THBS4,80040261,80083141,42880,1
NP_001167542.1,Homo_sapiens,5,SERINC5,80113600,80255922,142322,-1
NP_840060.1,Homo_sapiens,5,SERINC5,80113600,80255922,142322,-1
NP_001167543.1,Homo_sapiens,5,SERINC5,80143662,80255922,112260,-1
NP_115956.3,Homo_sapiens,5,SPZ1,80320215,80321508,1293,1
NP_055548.3,Homo_sapiens,5,ZFYVE16,80434147,80477377,43230,1
NP_001098721.1,Homo_sapiens,5,ZFYVE16,80434147,80477377,43230,1
NP_001271165.1,Homo_sapiens,5,ZFYVE16,80434147,80477377,43230,1
NP_001271166.1,Homo_sapiens,5,ZFYVE16,80434147,80440043,5896,1
NP_991111.2,Homo_sapiens,5,FAM151B,80488123,80541832,53709,1
NP_001004441.2,Homo_sapiens,5,ANKRD34B,80558474,80560019,1545,-1
NP_000782.1,Homo_sapiens,5,DHFR,80629086,80654489,25403,-1
NP_001277283.1,Homo_sapiens,5,DHFR,80629086,80649474,20388,-1
NP_001277286.1,Homo_sapiens,5,DHFR,80629144,80654489,25345,-1
NP_001177399.1,Homo_sapiens,5,MTRNR2L2,80649999,80650086,87,-1
NP_002430.3,Homo_sapiens,5,MSH3,80654727,80875862,221135,1
NP_008840.1,Homo_sapiens,5,RASGRF2,80960738,81225770,265032,1
NP_001816.2,Homo_sapiens,5,CKMT2,81251132,81266258,15126,1
NP_001093205.1,Homo_sapiens,5,CKMT2,81251132,81266258,15126,1
NP_001093206.1,Homo_sapiens,5,CKMT2,81251132,81266258,15126,1
NP_115656.1,Homo_sapiens,5,ZCCHC9,81304757,81312662,7905,1
NP_001124507.1,Homo_sapiens,5,ZCCHC9,81304757,81312662,7905,1
NP_001124508.1,Homo_sapiens,5,ZCCHC9,81304757,81312662,7905,1
NP_570123.1,Homo_sapiens,5,ACOT12,81330393,81394114,63721,-1
NP_001243665.1,Homo_sapiens,5,SSBP2,81420503,81751042,330539,-1
NP_001243664.1,Homo_sapiens,5,SSBP2,81420503,81751042,330539,-1
NP_001243663.1,Homo_sapiens,5,SSBP2,81420503,81751042,330539,-1
NP_001243662.1,Homo_sapiens,5,SSBP2,81420503,81751042,330539,-1
NP_036578.2,Homo_sapiens,5,SSBP2,81420503,81751042,330539,-1
NP_001243661.1,Homo_sapiens,5,SSBP2,81420503,81751042,330539,-1
NP_113670.1,Homo_sapiens,5,ATG10,81987570,82253425,265855,1
NP_001124500.1,Homo_sapiens,5,ATG10,81987570,82253425,265855,1
NP_001016.1,Homo_sapiens,5,RPS23,82276108,82278323,2215,-1
NP_001017971.1,Homo_sapiens,5,ATP6AP1L,82305401,82318300,12899,1
NP_777569.1,Homo_sapiens,5,TMEM167A,83057083,83077323,20240,-1
NP_071801.1,Homo_sapiens,5,XRCC4,83104919,83353242,248323,1
NP_001304941.1,Homo_sapiens,5,XRCC4,83104919,83353242,248323,1
NP_072044.1,Homo_sapiens,5,XRCC4,83104919,83353242,248323,1
NP_003392.1,Homo_sapiens,5,XRCC4,83104919,83353242,248323,1
NP_001304942.1,Homo_sapiens,5,XRCC4,83104919,83310828,205909,1
NP_004376.2,Homo_sapiens,5,VCAN,83483518,83580434,96916,1
NP_001157570.1,Homo_sapiens,5,VCAN,83483518,83580434,96916,1
NP_001157569.1,Homo_sapiens,5,VCAN,83483518,83580434,96916,1
NP_001119808.1,Homo_sapiens,5,VCAN,83483518,83580434,96916,1
NP_001875.1,Homo_sapiens,5,HAPLN1,83641495,83673523,32028,-1
NP_001265571.1,Homo_sapiens,5,EDIL3,83943418,84384374,440956,-1
NP_005702.3,Homo_sapiens,5,EDIL3,83943418,84384374,440956,-1
NP_001858.1,Homo_sapiens,5,COX7C,86618055,86619469,1414,1
NP_002881.1,Homo_sapiens,5,RASA1,87268451,87390883,122432,1
NP_072179.1,Homo_sapiens,5,RASA1,87269047,87390883,121836,1
NP_001230.1,Homo_sapiens,5,CCNH,87394445,87412794,18349,-1
NP_001186118.1,Homo_sapiens,5,CCNH,87394445,87411304,16859,-1
NP_001275936.1,Homo_sapiens,5,TMEM161B,88190051,88268723,78672,-1
NP_699185.1,Homo_sapiens,5,TMEM161B,88196210,88268723,72513,-1
NP_001275937.1,Homo_sapiens,5,TMEM161B,88196210,88240886,44676,-1
NP_001180277.1,Homo_sapiens,5,MEF2C,88722603,88823788,101185,-1
NP_001180278.1,Homo_sapiens,5,MEF2C,88722603,88823788,101185,-1
NP_001124477.1,Homo_sapiens,5,MEF2C,88722603,88823788,101185,-1
NP_001180276.1,Homo_sapiens,5,MEF2C,88722603,88823788,101185,-1
NP_001294931.1,Homo_sapiens,5,MEF2C,88722603,88823788,101185,-1
NP_002388.2,Homo_sapiens,5,MEF2C,88722603,88823788,101185,-1
NP_001180279.1,Homo_sapiens,5,MEF2C,88722603,88823788,101185,-1
NP_001284697.1,Homo_sapiens,5,CETN3,90394063,90409661,15598,-1
NP_004356.2,Homo_sapiens,5,CETN3,90394063,90409661,15598,-1
NP_001284694.1,Homo_sapiens,5,CETN3,90394063,90409661,15598,-1
NP_981951.1,Homo_sapiens,5,MBLAC2,90461166,90474292,13126,-1
NP_006458.2,Homo_sapiens,5,POLR3G,90485567,90512139,26572,1
NP_938014.1,Homo_sapiens,5,LYSMD3,90518818,90525289,6471,-1
NP_001273741.1,Homo_sapiens,5,LYSMD3,90519296,90525289,5993,-1
NP_115495.3,Homo_sapiens,5,ADGRV1,90558895,91163900,605005,1
NP_065852.1,Homo_sapiens,5,ARRDC3,91371399,91383092,11693,-1
NP_005645.1,Homo_sapiens,5,NR2F1,93585023,93593842,8819,1
NP_114431.2,Homo_sapiens,5,FAM172A,93620986,94074751,453765,-1
NP_001156890.1,Homo_sapiens,5,FAM172A,93620986,94053195,432209,-1
NP_001156889.1,Homo_sapiens,5,FAM172A,93620986,94053195,432209,-1
NP_694948.1,Homo_sapiens,5,POU5F2,93740576,93741563,987,-1
NP_001139150.1,Homo_sapiens,5,KIAA0825,94154006,94537126,383120,-1
NP_775936.1,Homo_sapiens,5,KIAA0825,94520242,94537126,16884,-1
NP_115666.2,Homo_sapiens,5,SLF1,94628810,94695312,66502,1
NP_078993.4,Homo_sapiens,5,MCTP1,94707495,95284575,577080,-1
NP_001284706.1,Homo_sapiens,5,MCTP1,94707495,95081482,373987,-1
NP_001002796.1,Homo_sapiens,5,MCTP1,94707495,95081482,373987,-1
NP_689761.2,Homo_sapiens,5,FAM81B,95391389,95450282,58893,1
NP_055454.1,Homo_sapiens,5,TTC37,95464606,95547150,82544,-1
NP_937793.1,Homo_sapiens,5,ARSK,95555278,95603526,48248,1
NP_954713.1,Homo_sapiens,5,GPR150,95620275,95621580,1305,1
NP_001124537.1,Homo_sapiens,5,RFESD,95652271,95656309,4038,1
NP_001124538.1,Homo_sapiens,5,RFESD,95652271,95656309,4038,1
NP_775498.1,Homo_sapiens,5,RFESD,95654061,95656309,2248,1
NP_114158.2,Homo_sapiens,5,SPATA9,95658622,95682854,24232,-1
NP_055714.3,Homo_sapiens,5,RHOBTB3,95731682,95793174,61492,1
NP_001112362.1,Homo_sapiens,5,GLRX,95816512,95822662,6150,-1
NP_001230587.1,Homo_sapiens,5,GLRX,95816512,95822662,6150,-1
NP_001230588.1,Homo_sapiens,5,GLRX,95816512,95822662,6150,-1
NP_002055.1,Homo_sapiens,5,GLRX,95816512,95822662,6150,-1
NP_036213.2,Homo_sapiens,5,ELL2,95888870,95961721,72851,-1
NP_000430.3,Homo_sapiens,5,PCSK1,96393000,96433042,40042,-1
NP_001171346.1,Homo_sapiens,5,PCSK1,96393000,96432121,39121,-1
NP_001035905.1,Homo_sapiens,5,CAST,96662422,96771679,109257,1
NP_001177371.1,Homo_sapiens,5,CAST,96722677,96771679,49002,1
NP_775083.1,Homo_sapiens,5,CAST,96722677,96771679,49002,1
NP_001271142.1,Homo_sapiens,5,CAST,96722677,96771679,49002,1
NP_001271141.1,Homo_sapiens,5,CAST,96722677,96771679,49002,1
NP_057526.3,Homo_sapiens,5,ERAP1,96763199,96803926,40727,-1
NP_001185470.1,Homo_sapiens,5,ERAP1,96776395,96803926,27531,-1
NP_001035548.1,Homo_sapiens,5,ERAP1,96776395,96803926,27531,-1
NP_071745.1,Homo_sapiens,5,ERAP2,96879685,96917605,37920,1
NP_001123612.1,Homo_sapiens,5,ERAP2,96879685,96917605,37920,1
XP_005272207.1,Homo_sapiens,5,LOC101929747,96935370,96936075,705,-1
NP_005566.2,Homo_sapiens,5,LNPEP,96936155,97028533,92378,1
NP_787116.2,Homo_sapiens,5,LNPEP,96979160,97028533,49373,1
NP_694966.3,Homo_sapiens,5,LIX1,97094747,97142576,47829,-1
NP_060813.2,Homo_sapiens,5,RIOK2,97163060,97183191,20131,-1
NP_001153221.1,Homo_sapiens,5,RIOK2,97167438,97183191,15753,-1
NP_001012779.2,Homo_sapiens,5,RGMB,98770668,98793753,23085,1
NP_001261.2,Homo_sapiens,5,CHD1,98856379,98926386,70007,-1
NP_940909.1,Homo_sapiens,5,FAM174A,100535530,100586184,50654,1
NP_005659.1,Homo_sapiens,5,ST8SIA4,100811846,100902955,91109,-1
NP_778222.1,Homo_sapiens,5,ST8SIA4,100886338,100902955,16617,-1
NP_851322.3,Homo_sapiens,5,SLCO4C1,102236857,102296262,59405,-1
NP_001294943.1,Homo_sapiens,5,SLCO6A1,102373351,102498844,125493,-1
NP_001275933.1,Homo_sapiens,5,SLCO6A1,102373351,102498844,125493,-1
NP_001275931.1,Homo_sapiens,5,SLCO6A1,102373351,102498844,125493,-1
NP_775759.3,Homo_sapiens,5,SLCO6A1,102373351,102498844,125493,-1
NP_001306872.1,Homo_sapiens,5,PAM,102866195,103029065,162870,1
NP_000910.2,Homo_sapiens,5,PAM,102866195,103029065,162870,1
NP_001170777.1,Homo_sapiens,5,PAM,102866195,103029065,162870,1
NP_620121.1,Homo_sapiens,5,PAM,102866195,103029065,162870,1
NP_620177.1,Homo_sapiens,5,PAM,102866195,103029065,162870,1
NP_620176.1,Homo_sapiens,5,PAM,102866195,103029065,162870,1
NP_060146.2,Homo_sapiens,5,GIN1,103087897,103108707,20810,-1
NP_001304883.1,Homo_sapiens,5,GIN1,103087897,103104738,16841,-1
NP_001268400.1,Homo_sapiens,5,PPIP5K2,103129589,103201634,72045,1
NP_001263206.1,Homo_sapiens,5,PPIP5K2,103129589,103201634,72045,1
NP_056031.2,Homo_sapiens,5,PPIP5K2,103129589,103201634,72045,1
NP_149988.1,Homo_sapiens,5,C5orf30,103275919,103276540,621,1
NP_001303898.1,Homo_sapiens,5,C5orf30,103275919,103276540,621,1
NP_001303897.1,Homo_sapiens,5,C5orf30,103275919,103276540,621,1
NP_001287670.1,Homo_sapiens,5,NUDT12,103550860,103560248,9388,-1
NP_113626.1,Homo_sapiens,5,NUDT12,103550860,103560248,9388,-1
NP_001953.1,Homo_sapiens,5,EFNA5,107381254,107670613,289359,-1
NP_001156787.2,Homo_sapiens,5,FBXL17,107861719,108381691,519972,-1
NP_005237.2,Homo_sapiens,5,FER,108798182,109187575,389393,1
NP_001294967.1,Homo_sapiens,5,FER,108798182,108841841,43659,1
NP_001294957.1,Homo_sapiens,5,FER,108867810,109187575,319765,1
NP_001294960.1,Homo_sapiens,5,FER,108924660,109187575,262915,1
NP_055634.3,Homo_sapiens,5,PJA2,109337230,109383433,46203,-1
NP_002363.2,Homo_sapiens,5,MAN2A1,109690417,109866998,176581,1
NP_001034852.3,Homo_sapiens,5,TMEM232,110420579,110667352,246773,-1
NP_001290179.1,Homo_sapiens,5,SLC25A46,110738237,110761782,23545,1
NP_620128.1,Homo_sapiens,5,SLC25A46,110739119,110761782,22663,1
NP_001290178.1,Homo_sapiens,5,SLC25A46,110739119,110761782,22663,1
NP_149024.1,Homo_sapiens,5,TSLP,111071890,111076074,4184,1
NP_612561.2,Homo_sapiens,5,TSLP,111073582,111076074,2492,1
NP_644810.1,Homo_sapiens,5,WDR36,111092288,111126883,34595,1
NP_001310303.1,Homo_sapiens,5,CAMK4,111224483,111484466,259983,1
NP_001310304.1,Homo_sapiens,5,CAMK4,111224483,111484466,259983,1
NP_001735.1,Homo_sapiens,5,CAMK4,111224483,111484466,259983,1
NP_001310306.1,Homo_sapiens,5,CAMK4,111449169,111484466,35297,1
NP_001310305.1,Homo_sapiens,5,CAMK4,111449169,111484466,35297,1
NP_631903.1,Homo_sapiens,5,STARD4,111499885,111507433,7548,-1
NP_001294985.1,Homo_sapiens,5,STARD4,111499885,111507433,7548,-1
NP_001294990.1,Homo_sapiens,5,STARD4,111499885,111501997,2112,-1
NP_001294988.1,Homo_sapiens,5,STARD4,111499885,111501997,2112,-1
NP_001294989.1,Homo_sapiens,5,STARD4,111499885,111501104,1219,-1
NP_001294986.1,Homo_sapiens,5,STARD4,111500918,111507433,6515,-1
NP_001294987.1,Homo_sapiens,5,STARD4,111500918,111507433,6515,-1
NP_001135946.1,Homo_sapiens,5,NREP,111730920,111976739,245819,-1
NP_001135947.1,Homo_sapiens,5,NREP,111730920,111976739,245819,-1
NP_001135948.1,Homo_sapiens,5,NREP,111730920,111755772,24852,-1
NP_001135949.1,Homo_sapiens,5,NREP,111730920,111755772,24852,-1
NP_001135950.1,Homo_sapiens,5,NREP,111730920,111755772,24852,-1
NP_001135951.1,Homo_sapiens,5,NREP,111730920,111755772,24852,-1
NP_001135952.1,Homo_sapiens,5,NREP,111730920,111755772,24852,-1
NP_001135953.1,Homo_sapiens,5,NREP,111730920,111755772,24852,-1
NP_001135954.1,Homo_sapiens,5,NREP,111730920,111755772,24852,-1
NP_001135955.1,Homo_sapiens,5,NREP,111730920,111755772,24852,-1
NP_004763.1,Homo_sapiens,5,NREP,111730920,111755772,24852,-1
NP_071423.3,Homo_sapiens,5,EPB41L4A,112164989,112419039,254050,-1
NP_001120983.2,Homo_sapiens,5,APC,112707717,112844126,136409,1
NP_001120982.1,Homo_sapiens,5,APC,112754890,112844126,89236,1
NP_000029.2,Homo_sapiens,5,APC,112754890,112844126,89236,1
NP_001191128.1,Homo_sapiens,5,SRP19,112861376,112891607,30231,1
NP_003126.1,Homo_sapiens,5,SRP19,112861376,112867537,6161,1
NP_001191123.1,Homo_sapiens,5,SRP19,112861376,112867537,6161,1
NP_001191125.1,Homo_sapiens,5,SRP19,112861376,112867415,6039,1
NP_001191122.1,Homo_sapiens,5,SRP19,112861376,112867403,6027,1
NP_005660.4,Homo_sapiens,5,REEP5,112878785,112922190,43405,-1
NP_689837.2,Homo_sapiens,5,DCP2,112976933,113013484,36551,1
NP_001229306.1,Homo_sapiens,5,DCP2,112976933,113013484,36551,1
NP_001078846.1,Homo_sapiens,5,MCC,113027301,113488414,461113,-1
NP_002378.1,Homo_sapiens,5,MCC,113027301,113294385,267084,-1
NP_114417.1,Homo_sapiens,5,TSSK1B,113433735,113434839,1104,-1
NP_073739.3,Homo_sapiens,5,YTHDC2,113513895,113593383,79488,1
NP_067627.2,Homo_sapiens,5,KCNN2,114362775,114496182,133407,1
NP_740721.1,Homo_sapiens,5,KCNN2,114463091,114496182,33091,1
NP_001265133.1,Homo_sapiens,5,KCNN2,114463091,114496182,33091,1
NP_061170.2,Homo_sapiens,5,TRIM36,115126502,115180037,53535,-1
NP_001287688.1,Homo_sapiens,5,TRIM36,115126502,115169634,43132,-1
NP_001287681.1,Homo_sapiens,5,TRIM36,115126502,115147227,20725,-1
NP_001017397.1,Homo_sapiens,5,TRIM36,115171102,115180037,8935,-1
NP_001017398.1,Homo_sapiens,5,TRIM36,115177749,115180037,2288,-1
NP_005014.2,Homo_sapiens,5,PGGT1B,115212401,115262851,50450,-1
NP_001035530.1,Homo_sapiens,5,CCDC112,115267875,115296543,28668,-1
NP_689762.2,Homo_sapiens,5,CCDC112,115267875,115279758,11883,-1
NP_064562.1,Homo_sapiens,5,FEM1C,115524307,115543493,19186,-1
NP_001157940.1,Homo_sapiens,5,TMED7-TICAM2,115580548,115625792,45244,-1
NP_067681.1,Homo_sapiens,5,TICAM2,115580548,115581256,708,-1
NP_001157941.1,Homo_sapiens,5,TMED7-TICAM2,115581314,115625792,44478,-1
NP_861974.1,Homo_sapiens,5,TMED7,115616208,115625792,9584,-1
NP_001310495.1,Homo_sapiens,5,CDO1,115805432,115816397,10965,-1
NP_001792.2,Homo_sapiens,5,CDO1,115805432,115816397,10965,-1
NP_001310494.1,Homo_sapiens,5,CDO1,115805432,115816397,10965,-1
NP_001310496.1,Homo_sapiens,5,CDO1,115805432,115813212,7780,-1
NP_004698.3,Homo_sapiens,5,ATG12,115831803,115841552,9749,-1
NP_001264712.1,Homo_sapiens,5,ATG12,115832602,115841552,8950,-1
NP_001275.1,Homo_sapiens,5,AP3S1,115842037,115913490,71453,1
NP_001305023.1,Homo_sapiens,5,AP3S1,115842037,115913490,71453,1
NP_001305020.1,Homo_sapiens,5,AP3S1,115842037,115913490,71453,1
NP_001305019.1,Homo_sapiens,5,AP3S1,115842037,115913490,71453,1
NP_001305022.1,Homo_sapiens,5,AP3S1,115842037,115906856,64819,1
NP_001002924.2,Homo_sapiens,5,AP3S1,115853011,115913490,60479,1
NP_776161.3,Homo_sapiens,5,LVRN,115962617,116026118,63501,1
NP_001182510.1,Homo_sapiens,5,ARL14EPL,116051465,116058947,7482,1
NP_057228.1,Homo_sapiens,5,COMMD10,116085052,116292489,207437,1
NP_001295009.1,Homo_sapiens,5,COMMD10,116087497,116292489,204992,1
NP_065847.1,Homo_sapiens,5,SEMA6A,116446612,116504944,58332,-1
NP_001287709.1,Homo_sapiens,5,SEMA6A,116446612,116504944,58332,-1
NP_775937.1,Homo_sapiens,5,DTWD2,118840916,118988511,147595,-1
NP_001295010.1,Homo_sapiens,5,DTWD2,118840916,118988149,147233,-1
NP_001277250.1,Homo_sapiens,5,DMXL1,119071569,119247219,175650,1
NP_005500.4,Homo_sapiens,5,DMXL1,119071569,119247219,175650,1
NP_001277251.1,Homo_sapiens,5,DMXL1,119114496,119247219,132723,1
NP_001071122.1,Homo_sapiens,5,TNFAIP8,119268906,119393381,124475,1
NP_001273743.1,Homo_sapiens,5,TNFAIP8,119333564,119393381,59817,1
NP_055165.2,Homo_sapiens,5,TNFAIP8,119356090,119393381,37291,1
NP_001273742.1,Homo_sapiens,5,TNFAIP8,119356090,119393381,37291,1
NP_001273744.1,Homo_sapiens,5,TNFAIP8,119392880,119393381,501,1
NP_001273746.1,Homo_sapiens,5,TNFAIP8,119392880,119393381,501,1
NP_000405.1,Homo_sapiens,5,HSD17B4,119452575,119541994,89419,1
NP_001186221.1,Homo_sapiens,5,HSD17B4,119452575,119541994,89419,1
NP_001186220.1,Homo_sapiens,5,HSD17B4,119452753,119541994,89241,1
NP_001278956.1,Homo_sapiens,5,HSD17B4,119471660,119541994,70334,1
NP_001278957.1,Homo_sapiens,5,HSD17B4,119477478,119541994,64516,1
NP_877438.2,Homo_sapiens,5,FAM170A,119629768,119635034,5266,1
NP_001157463.1,Homo_sapiens,5,FAM170A,119629768,119635034,5266,1
NP_001287712.1,Homo_sapiens,5,PRR16,120464486,120686709,222223,1
NP_057728.1,Homo_sapiens,5,PRR16,120481203,120686709,205506,1
NP_001295017.1,Homo_sapiens,5,PRR16,120686004,120686709,705,1
NP_001295016.1,Homo_sapiens,5,PRR16,120686004,120686709,705,1
NP_803431.1,Homo_sapiens,5,FTMT,121851963,121852692,729,1
NP_689759.2,Homo_sapiens,5,SRFBP1,121962032,122027126,65094,1
NP_002308.2,Homo_sapiens,5,LOX,122066742,122077985,11243,-1
NP_001171573.1,Homo_sapiens,5,LOX,122066742,122076942,10200,-1
NP_001304002.1,Homo_sapiens,5,LOX,122066742,122074156,7414,-1
NP_997200.1,Homo_sapiens,5,ZNF474,122151990,122153085,1095,1
NP_001182464.1,Homo_sapiens,5,LOC100505841,122160229,122182642,22413,1
NP_001295029.1,Homo_sapiens,5,SNCAIP,122391134,122463575,72441,1
NP_005451.2,Homo_sapiens,5,SNCAIP,122391134,122463496,72362,1
NP_001295034.1,Homo_sapiens,5,SNCAIP,122391134,122463496,72362,1
NP_001229864.1,Homo_sapiens,5,SNCAIP,122391180,122463575,72395,1
NP_001295037.1,Homo_sapiens,5,SNCAIP,122391180,122463496,72316,1
NP_001295036.1,Homo_sapiens,5,SNCAIP,122391180,122463496,72316,1
NP_001295038.1,Homo_sapiens,5,SNCAIP,122391180,122463496,72316,1
NP_001295035.1,Homo_sapiens,5,SNCAIP,122401121,122463496,62375,1
NP_003091.2,Homo_sapiens,5,SNX2,122775103,122829648,54545,1
NP_001265128.1,Homo_sapiens,5,SNX2,122799816,122829648,29832,1
NP_054754.1,Homo_sapiens,5,SNX24,122845633,123007749,162116,1
NP_000934.1,Homo_sapiens,5,PPIC,123023874,123036625,12751,-1
NP_001129711.1,Homo_sapiens,5,PRDM6,123090014,123187201,97187,1
NP_694955.2,Homo_sapiens,5,CEP120,123346518,123422998,76480,-1
NP_001159698.1,Homo_sapiens,5,CEP120,123346518,123418486,71968,-1
NP_001257501.1,Homo_sapiens,5,CSNK1G3,123545663,123614396,68733,1
NP_001038188.1,Homo_sapiens,5,CSNK1G3,123545663,123614396,68733,1
NP_004375.2,Homo_sapiens,5,CSNK1G3,123545663,123614396,68733,1
NP_001026982.1,Homo_sapiens,5,CSNK1G3,123545663,123614396,68733,1
NP_001257502.1,Homo_sapiens,5,CSNK1G3,123557500,123614396,56896,1
NP_001257503.1,Homo_sapiens,5,CSNK1G3,123573442,123614396,40954,1
NP_065798.2,Homo_sapiens,5,ZNF608,124637899,124744989,107090,-1
NP_001139791.1,Homo_sapiens,5,GRAMD3,126360331,126492956,132625,1
NP_076416.2,Homo_sapiens,5,GRAMD3,126423606,126492956,69350,1
NP_001139793.1,Homo_sapiens,5,GRAMD3,126423625,126492956,69331,1
NP_001139794.1,Homo_sapiens,5,GRAMD3,126465390,126492956,27566,1
NP_001139792.1,Homo_sapiens,5,GRAMD3,126465542,126492956,27414,1
NP_001189333.2,Homo_sapiens,5,ALDH7A1,126544964,126595198,50234,-1
NP_001173.2,Homo_sapiens,5,ALDH7A1,126544964,126595198,50234,-1
NP_001188306.1,Homo_sapiens,5,ALDH7A1,126544964,126595114,50150,-1
NP_115553.2,Homo_sapiens,5,PHAX,126600962,126624844,23882,1
NP_997291.1,Homo_sapiens,5,TEX43,126631734,126636241,4507,1
NP_005564.1,Homo_sapiens,5,LMNB1,126777508,126836264,58756,1
NP_001185486.1,Homo_sapiens,5,LMNB1,126805684,126836264,30580,1
NP_848545.1,Homo_sapiens,5,MARCH3,126870632,126918171,47539,-1
NP_001157951.1,Homo_sapiens,5,C5orf63,127047669,127058995,11326,-1
NP_001157950.1,Homo_sapiens,5,C5orf63,127051770,127058995,7225,-1
XP_011542092.1,Homo_sapiens,5,LOC105379198,127218954,127229743,10789,-1
NP_115822.1,Homo_sapiens,5,MEGF10,127331308,127457318,126010,1
NP_001243474.1,Homo_sapiens,5,MEGF10,127331308,127457318,126010,1
NP_001295048.1,Homo_sapiens,5,MEGF10,127331308,127424349,93041,1
NP_001295050.1,Homo_sapiens,5,MEGF10,127331308,127424349,93041,1
NP_001273737.1,Homo_sapiens,5,PRRC1,127523479,127553885,30406,1
NP_570721.1,Homo_sapiens,5,PRRC1,127523479,127551916,28437,1
NP_001041717.1,Homo_sapiens,5,CTXN3,127657521,127657767,246,1
NP_001120857.1,Homo_sapiens,5,CTXN3,127657521,127657767,246,1
NP_001304867.1,Homo_sapiens,5,CCDC192,127703388,127941468,238080,1
NP_001037.1,Homo_sapiens,5,SLC12A2,128083954,128186631,102677,1
NP_001243390.1,Homo_sapiens,5,SLC12A2,128083954,128186631,102677,1
NP_001990.2,Homo_sapiens,5,FBN2,128259454,128537603,278149,-1
NP_054750.1,Homo_sapiens,5,SLC27A6,128966137,129033282,67145,1
NP_001017372.1,Homo_sapiens,5,SLC27A6,128966137,129033282,67145,1
NP_001304913.1,Homo_sapiens,5,SLC27A6,128966137,129033282,67145,1
NP_057132.2,Homo_sapiens,5,ISOC1,129094766,129113001,18235,1
NP_598377.3,Homo_sapiens,5,ADAMTS19,129460409,129737218,276809,1
NP_001244237.1,Homo_sapiens,5,KIAA1024L,129748190,129765063,16873,1
NP_787052.3,Homo_sapiens,5,CHSY3,129904829,130185791,280962,1
NP_005331.1,Homo_sapiens,5,HINT1,131159446,131165205,5759,-1
NP_859056.2,Homo_sapiens,5,LYRM7,131171020,131199601,28581,1
NP_001280664.1,Homo_sapiens,5,LYRM7,131171020,131199560,28540,1
NP_001033791.1,Homo_sapiens,5,CDC42SE2,131359493,131391091,31598,1
NP_064625.1,Homo_sapiens,5,CDC42SE2,131359493,131391091,31598,1
NP_057424.3,Homo_sapiens,5,RAPGEF6,131427265,131635030,207765,-1
NP_001157860.1,Homo_sapiens,5,RAPGEF6,131427265,131635030,207765,-1
NP_001157858.1,Homo_sapiens,5,RAPGEF6,131427265,131635030,207765,-1
NP_001157859.1,Homo_sapiens,5,RAPGEF6,131427265,131635030,207765,-1
NP_001157861.1,Homo_sapiens,5,RAPGEF6,131435950,131635030,199080,-1
NP_001157862.1,Homo_sapiens,5,RAPGEF6,131464036,131635030,170994,-1
NP_001008738.2,Homo_sapiens,5,FNIP1,131644684,131796921,152237,-1
NP_588613.2,Homo_sapiens,5,FNIP1,131644684,131796921,152237,-1
NP_001290551.1,Homo_sapiens,5,MEIKIN,131807235,131945505,138270,-1
NP_001192179.1,Homo_sapiens,5,ACSL6,131954233,132011920,57687,-1
NP_001192176.1,Homo_sapiens,5,ACSL6,131954233,132011553,57320,-1
NP_056071.2,Homo_sapiens,5,ACSL6,131954233,132011553,57320,-1
NP_001009185.1,Homo_sapiens,5,ACSL6,131954233,132011553,57320,-1
NP_001192180.1,Homo_sapiens,5,ACSL6,131954233,131994225,39992,-1
NP_001192177.1,Homo_sapiens,5,ACSL6,131954233,131994225,39992,-1
NP_000579.2,Homo_sapiens,5,IL3,132060706,132062791,2085,1
NP_000749.2,Homo_sapiens,5,CSF2,132073823,132075852,2029,1
NP_001136071.1,Homo_sapiens,5,P4HA2,132193009,132218626,25617,-1
NP_004190.1,Homo_sapiens,5,P4HA2,132193009,132218626,25617,-1
NP_001136070.1,Homo_sapiens,5,P4HA2,132193009,132218626,25617,-1
NP_001017973.1,Homo_sapiens,5,P4HA2,132193009,132218626,25617,-1
NP_001017974.1,Homo_sapiens,5,P4HA2,132193009,132218626,25617,-1
NP_003678.2,Homo_sapiens,5,PDLIM4,132257734,132272229,14495,1
NP_001124499.1,Homo_sapiens,5,PDLIM4,132257734,132272095,14361,1
NP_003050.2,Homo_sapiens,5,SLC22A4,132294616,132343835,49219,1
NP_001295051.1,Homo_sapiens,5,SLC22A5,132369972,132394272,24300,1
NP_003051.1,Homo_sapiens,5,SLC22A5,132369972,132394272,24300,1
NP_002189.1,Homo_sapiens,5,IRF1,132483950,132489478,5528,-1
NP_000870.1,Homo_sapiens,5,IL5,132541810,132543478,1668,-1
NP_005723.2,Homo_sapiens,5,RAD50,132557324,132642364,85040,1
NP_002179.2,Homo_sapiens,5,IL13,132658186,132660282,2096,1
NP_000580.1,Homo_sapiens,5,IL4,132674050,132682587,8537,1
NP_758858.1,Homo_sapiens,5,IL4,132674050,132682587,8537,1
NP_008985.3,Homo_sapiens,5,KIF3A,132696633,132737419,40786,-1
NP_001287721.1,Homo_sapiens,5,KIF3A,132696633,132737419,40786,-1
NP_001287720.1,Homo_sapiens,5,KIF3A,132696633,132737419,40786,-1
NP_001274182.1,Homo_sapiens,5,CCNI2,132747495,132752970,5475,1
NP_001274181.1,Homo_sapiens,5,CCNI2,132747495,132752970,5475,1
NP_001034869.1,Homo_sapiens,5,CCNI2,132747495,132752970,5475,1
NP_001092281.1,Homo_sapiens,5,SEPT8,132752015,132777137,25122,-1
NP_001287727.1,Homo_sapiens,5,SEPT8,132758513,132777137,18624,-1
NP_001092282.1,Homo_sapiens,5,SEPT8,132758513,132777137,18624,-1
NP_001287728.1,Homo_sapiens,5,SEPT8,132758820,132777137,18317,-1
NP_055961.1,Homo_sapiens,5,SEPT8,132758820,132777137,18317,-1
NP_001092283.1,Homo_sapiens,5,SEPT8,132758820,132764390,5570,-1
NP_787069.4,Homo_sapiens,5,SOWAHA,132813621,132815271,1650,1
NP_597713.2,Homo_sapiens,5,SHROOM1,132822795,132826140,3345,-1
NP_001166171.1,Homo_sapiens,5,SHROOM1,132822795,132826140,3345,-1
XP_016865598.1,Homo_sapiens,5,LOC107984115,132829606,132831365,1759,-1
NP_005251.1,Homo_sapiens,5,GDF9,132861588,132864533,2945,-1
NP_001275757.1,Homo_sapiens,5,GDF9,132861588,132864269,2681,-1
NP_001275755.1,Homo_sapiens,5,GDF9,132861588,132864269,2681,-1
NP_001275753.1,Homo_sapiens,5,GDF9,132861588,132864269,2681,-1
NP_001275754.1,Homo_sapiens,5,GDF9,132861588,132864269,2681,-1
NP_001275756.1,Homo_sapiens,5,GDF9,132861588,132864269,2681,-1
NP_055217.2,Homo_sapiens,5,UQCRQ,132866881,132867582,701,1
NP_443203.1,Homo_sapiens,5,LEAP2,132873694,132874446,752,1
NP_055238.1,Homo_sapiens,5,AFF4,132881058,132937189,56131,-1
XP_011542087.1,Homo_sapiens,5,LOC105379177,132960723,132961296,573,-1
NP_001295058.1,Homo_sapiens,5,ZCCHC10,132998582,133026537,27955,-1
NP_001295057.1,Homo_sapiens,5,ZCCHC10,132998582,133026537,27955,-1
NP_001287748.1,Homo_sapiens,5,ZCCHC10,132998582,133026537,27955,-1
NP_060135.1,Homo_sapiens,5,ZCCHC10,132998582,133026537,27955,-1
NP_001287747.1,Homo_sapiens,5,ZCCHC10,132998582,133026537,27955,-1
NP_001287746.1,Homo_sapiens,5,ZCCHC10,132998582,133026537,27955,-1
NP_001287745.1,Homo_sapiens,5,ZCCHC10,132998582,133026537,27955,-1
NP_001295056.1,Homo_sapiens,5,ZCCHC10,132998582,133026537,27955,-1
NP_001295059.1,Homo_sapiens,5,ZCCHC10,132998844,133026537,27693,-1
NP_001287751.1,Homo_sapiens,5,ZCCHC10,132998844,133026537,27693,-1
NP_002145.3,Homo_sapiens,5,HSPA4,133052250,133104436,52186,1
NP_055897.1,Homo_sapiens,5,FSTL4,133199094,133603983,404889,-1
NP_064584.1,Homo_sapiens,5,C5orf15,133956858,133968584,11726,-1
NP_003365.1,Homo_sapiens,5,VDAC1,133972770,133993012,20242,-1
XP_011542088.1,Homo_sapiens,5,LOC101060024,134081908,134082070,162,-1
NP_003193.2,Homo_sapiens,5,TCF7,134114906,134146303,31397,1
NP_963963.1,Homo_sapiens,5,TCF7,134115937,134146303,30366,1
NP_998813.1,Homo_sapiens,5,TCF7,134115937,134146303,30366,1
NP_963965.1,Homo_sapiens,5,TCF7,134115937,134146204,30267,1
NP_001128323.2,Homo_sapiens,5,TCF7,134115937,134145820,29883,1
NP_733779.1,Homo_sapiens,5,SKP1,134157732,134174022,16290,-1
NP_008861.2,Homo_sapiens,5,SKP1,134158427,134174022,15595,-1
NP_002706.1,Homo_sapiens,5,PPP2CA,134197771,134225861,28090,-1
NP_001107047.1,Homo_sapiens,5,CDKL3,134298650,134366523,67873,-1
NP_001287782.1,Homo_sapiens,5,CDKL3,134299696,134321875,22179,-1
NP_057592.2,Homo_sapiens,5,CDKL3,134308133,134366523,58390,-1
NP_003328.1,Homo_sapiens,5,UBE2B,134371595,134390353,18758,1
NP_542387.1,Homo_sapiens,5,CDKN2AIPNL,134402914,134411854,8940,-1
NP_001276914.1,Homo_sapiens,5,JADE2,134525694,134579317,53623,1
NP_001295072.1,Homo_sapiens,5,JADE2,134535857,134579317,43460,1
NP_001276913.1,Homo_sapiens,5,JADE2,134535857,134579317,43460,1
NP_056103.4,Homo_sapiens,5,JADE2,134535857,134579317,43460,1
NP_001028675.1,Homo_sapiens,5,SAR1B,134606949,134624019,17070,-1
NP_057187.1,Homo_sapiens,5,SAR1B,134606949,134624019,17070,-1
NP_068817.1,Homo_sapiens,5,SEC24A,134649076,134725094,76018,1
NP_001239160.1,Homo_sapiens,5,SEC24A,134649076,134693093,44017,1
NP_001736.1,Homo_sapiens,5,CAMLG,134738620,134750950,12330,1
NP_001287789.1,Homo_sapiens,5,DDX46,134758938,134828706,69768,1
NP_055644.2,Homo_sapiens,5,DDX46,134758938,134828706,69768,1
NP_001287823.1,Homo_sapiens,5,C5orf24,134854900,134857397,2497,1
NP_001129058.1,Homo_sapiens,5,C5orf24,134854900,134855467,567,1
NP_689622.2,Homo_sapiens,5,C5orf24,134854900,134855467,567,1
NP_078991.3,Homo_sapiens,5,TXNDC15,134874427,134899685,25258,1
NP_115527.3,Homo_sapiens,5,PCBD2,134905139,134960681,55542,1
NP_821138.1,Homo_sapiens,5,CATSPER3,134967991,135011623,43632,1
NP_002644.4,Homo_sapiens,5,PITX1,135028778,135033881,5103,-1
NP_001264277.1,Homo_sapiens,5,C5orf66,135334118,135343466,9348,1
NP_004884.1,Homo_sapiens,5,H2AFY,135334975,135389093,54118,-1
NP_001035248.1,Homo_sapiens,5,H2AFY,135334975,135389093,54118,-1
NP_613075.1,Homo_sapiens,5,H2AFY,135334975,135389093,54118,-1
NP_613258.2,Homo_sapiens,5,H2AFY,135334975,135389093,54118,-1
NP_570900.1,Homo_sapiens,5,DCANP1,135446373,135447108,735,-1
NP_001092691.1,Homo_sapiens,5,TIFAB,135449453,135449939,486,-1
NP_006152.2,Homo_sapiens,5,NEUROG1,135534976,135535690,714,-1
NP_004878.2,Homo_sapiens,5,CXCL14,135571852,135578814,6962,-1
NP_660325.4,Homo_sapiens,5,SLC25A48,135834847,135888084,53237,1
NP_000581.1,Homo_sapiens,5,IL9,135892390,135895816,3426,-1
NP_036291.2,Homo_sapiens,5,FBXL21,135936594,135941671,5077,1
NP_002293.2,Homo_sapiens,5,LECT2,135947330,135954833,7503,-1
NP_000349.1,Homo_sapiens,5,TGFBI,136029055,136063226,34171,1
NP_005894.3,Homo_sapiens,5,SMAD5,136153760,136177480,23720,1
NP_001001419.1,Homo_sapiens,5,SMAD5,136153760,136177480,23720,1
NP_001001420.1,Homo_sapiens,5,SMAD5,136153760,136177480,23720,1
NP_001161048.1,Homo_sapiens,5,TRPC7,136213434,136365254,151820,-1
NP_001161049.1,Homo_sapiens,5,TRPC7,136213434,136365254,151820,-1
NP_065122.1,Homo_sapiens,5,TRPC7,136213434,136365254,151820,-1
NP_004589.1,Homo_sapiens,5,SPOCK1,136978653,137498558,519905,-1
NP_059111.2,Homo_sapiens,5,KLHL3,137622097,137735646,113549,-1
NP_001244123.1,Homo_sapiens,5,KLHL3,137622097,137720502,98405,-1
NP_001244124.1,Homo_sapiens,5,KLHL3,137622097,137698403,76306,-1
NP_006796.1,Homo_sapiens,5,HNRNPA0,137753148,137754066,918,-1
NP_006781.1,Homo_sapiens,5,MYOT,137870651,137887385,16734,1
NP_001287840.1,Homo_sapiens,5,MYOT,137870996,137887385,16389,1
NP_001129412.1,Homo_sapiens,5,MYOT,137877540,137887385,9845,1
NP_055201.2,Homo_sapiens,5,PKD2L2,137889491,137940147,50656,1
NP_001287850.1,Homo_sapiens,5,PKD2L2,137889491,137936410,46919,1
NP_001245378.1,Homo_sapiens,5,PKD2L2,137889491,137936410,46919,1
NP_001245377.1,Homo_sapiens,5,PKD2L2,137889491,137936410,46919,1
NP_001095270.1,Homo_sapiens,5,FAM13B,137940224,138019111,78887,-1
NP_057687.2,Homo_sapiens,5,FAM13B,137940224,138019111,78887,-1
NP_001095271.1,Homo_sapiens,5,FAM13B,137940224,138018317,78093,-1
NP_490645.1,Homo_sapiens,5,WNT8A,138084089,138091073,6984,1
NP_001287867.1,Homo_sapiens,5,WNT8A,138084127,138091540,7413,1
NP_001287868.1,Homo_sapiens,5,WNT8A,138084127,138091073,6946,1
NP_003542.1,Homo_sapiens,5,NME5,138115680,138138780,23100,-1
NP_631938.1,Homo_sapiens,5,BRD8,138140073,138178614,38541,-1
NP_001157798.1,Homo_sapiens,5,BRD8,138157207,138178614,21407,-1
NP_006687.3,Homo_sapiens,5,BRD8,138157207,138178614,21407,-1
NP_001287891.1,Homo_sapiens,5,BRD8,138157207,138177633,20426,-1
NP_001287890.1,Homo_sapiens,5,BRD8,138157207,138177633,20426,-1
NP_001287895.1,Homo_sapiens,5,BRD8,138157207,138170856,13649,-1
NP_005724.1,Homo_sapiens,5,KIF20A,138179680,138187413,7733,1
NP_004652.2,Homo_sapiens,5,CDC23,138188977,138213312,24335,-1
NP_001487.2,Homo_sapiens,5,GFRA3,138252967,138274424,21457,-1
NP_001274512.1,Homo_sapiens,5,CDC25C,138285691,138338155,52464,-1
NP_001305027.1,Homo_sapiens,5,CDC25C,138285691,138337968,52277,-1
NP_073720.1,Homo_sapiens,5,CDC25C,138285691,138331180,45489,-1
NP_001781.2,Homo_sapiens,5,CDC25C,138285691,138331180,45489,-1
NP_001274511.1,Homo_sapiens,5,CDC25C,138285691,138331180,45489,-1
NP_001129119.1,Homo_sapiens,5,FAM53C,138341335,138346959,5624,1
NP_057689.1,Homo_sapiens,5,FAM53C,138341335,138346959,5624,1
NP_057688.2,Homo_sapiens,5,KDM3B,138352795,138435700,82905,1
NP_001258732.1,Homo_sapiens,5,REEP2,138439208,138445751,6543,1
NP_057690.2,Homo_sapiens,5,REEP2,138439208,138445751,6543,1
NP_001955.1,Homo_sapiens,5,EGR1,138465761,138468081,2320,1
NP_004721.1,Homo_sapiens,5,ETF1,138508304,138542918,34614,-1
NP_001269114.1,Homo_sapiens,5,ETF1,138508304,138541562,33258,-1
NP_001243231.1,Homo_sapiens,5,ETF1,138508304,138518854,10550,-1
NP_001278903.1,Homo_sapiens,5,ETF1,138508304,138518854,10550,-1
NP_001278904.1,Homo_sapiens,5,ETF1,138508304,138518854,10550,-1
NP_004125.3,Homo_sapiens,5,HSPA9,138556036,138575318,19282,-1
NP_001310912.1,Homo_sapiens,5,CTNNA1,138781924,138934089,152165,1
NP_001310913.1,Homo_sapiens,5,CTNNA1,138781924,138934089,152165,1
NP_001310911.1,Homo_sapiens,5,CTNNA1,138781924,138934089,152165,1
NP_001894.2,Homo_sapiens,5,CTNNA1,138781924,138934089,152165,1
NP_001310914.1,Homo_sapiens,5,CTNNA1,138781924,138934089,152165,1
NP_001310915.1,Homo_sapiens,5,CTNNA1,138781924,138934089,152165,1
NP_001277236.1,Homo_sapiens,5,CTNNA1,138781924,138933823,151899,1
NP_001277238.1,Homo_sapiens,5,CTNNA1,138810045,138934089,124044,1
NP_001277239.1,Homo_sapiens,5,CTNNA1,138810105,138934089,123984,1
NP_056379.1,Homo_sapiens,5,LRRTM2,138873009,138874911,1902,-1
NP_001310916.1,Homo_sapiens,5,CTNNA1,138886259,138934089,47830,1
NP_001310923.1,Homo_sapiens,5,CTNNA1,138886259,138934089,47830,1
NP_001310924.1,Homo_sapiens,5,CTNNA1,138886259,138934089,47830,1
NP_001310929.1,Homo_sapiens,5,CTNNA1,138886259,138934089,47830,1
NP_001310925.1,Homo_sapiens,5,CTNNA1,138886259,138934089,47830,1
NP_001310919.1,Homo_sapiens,5,CTNNA1,138886259,138934089,47830,1
NP_001310918.1,Homo_sapiens,5,CTNNA1,138886259,138934089,47830,1
NP_001310920.1,Homo_sapiens,5,CTNNA1,138886259,138934089,47830,1
NP_001310921.1,Homo_sapiens,5,CTNNA1,138886259,138934089,47830,1
NP_001310927.1,Homo_sapiens,5,CTNNA1,138886259,138934089,47830,1
NP_001310926.1,Homo_sapiens,5,CTNNA1,138886259,138934089,47830,1
NP_001310928.1,Homo_sapiens,5,CTNNA1,138886259,138934089,47830,1
NP_001310922.1,Homo_sapiens,5,CTNNA1,138886259,138934089,47830,1
NP_001310917.1,Homo_sapiens,5,CTNNA1,138886259,138934089,47830,1
NP_001277241.1,Homo_sapiens,5,CTNNA1,138886259,138934089,47830,1
NP_001310930.1,Homo_sapiens,5,CTNNA1,138886259,138934089,47830,1
NP_001310940.1,Homo_sapiens,5,CTNNA1,138886259,138934089,47830,1
NP_001310932.1,Homo_sapiens,5,CTNNA1,138886259,138933823,47564,1
NP_001310931.1,Homo_sapiens,5,CTNNA1,138886259,138933823,47564,1
NP_001310934.1,Homo_sapiens,5,CTNNA1,138886259,138933823,47564,1
NP_001310933.1,Homo_sapiens,5,CTNNA1,138886259,138933823,47564,1
NP_001310941.1,Homo_sapiens,5,CTNNA1,138904405,138934089,29684,1
NP_001310942.1,Homo_sapiens,5,CTNNA1,138904405,138934089,29684,1
NP_001310935.1,Homo_sapiens,5,CTNNA1,138917801,138934089,16288,1
NP_001310936.1,Homo_sapiens,5,CTNNA1,138917801,138934089,16288,1
NP_001310939.1,Homo_sapiens,5,CTNNA1,138917801,138934089,16288,1
NP_001310938.1,Homo_sapiens,5,CTNNA1,138917801,138934089,16288,1
NP_001310937.1,Homo_sapiens,5,CTNNA1,138917801,138934089,16288,1
NP_071909.1,Homo_sapiens,5,SIL1,138947116,139127843,180727,-1
NP_001032722.1,Homo_sapiens,5,SIL1,138947116,139127843,180727,-1
NP_001181885.1,Homo_sapiens,5,MATR3,139293980,139329395,35415,1
NP_061322.2,Homo_sapiens,5,MATR3,139307415,139329395,21980,1
NP_001181883.1,Homo_sapiens,5,MATR3,139307415,139329395,21980,1
NP_001181884.1,Homo_sapiens,5,MATR3,139307415,139329395,21980,1
NP_954659.1,Homo_sapiens,5,MATR3,139307415,139329395,21980,1
NP_001269207.1,Homo_sapiens,5,MATR3,139315736,139329395,13659,1
NP_057564.3,Homo_sapiens,5,PAIP2,139363784,139368798,5014,1
NP_001028284.1,Homo_sapiens,5,PAIP2,139363784,139368798,5014,1
NP_005838.3,Homo_sapiens,5,SLC23A1,139372005,139383253,11248,-1
NP_689898.2,Homo_sapiens,5,SLC23A1,139372005,139383253,11248,-1
NP_057543.2,Homo_sapiens,5,MZB1,139387764,139389856,2092,-1
NP_001155018.1,Homo_sapiens,5,PROB1,139392033,139395081,3048,-1
NP_919272.1,Homo_sapiens,5,SPATA24,139396799,139404060,7261,-1
NP_689899.1,Homo_sapiens,5,DNAJC18,139414147,139439445,25298,-1
NP_001280668.1,Homo_sapiens,5,ECSCR,139448764,139462670,13906,-1
NP_001071161.1,Homo_sapiens,5,ECSCR,139448899,139462670,13771,-1
NP_938023.1,Homo_sapiens,5,TMEM173,139476260,139481704,5444,-1
NP_001288667.1,Homo_sapiens,5,TMEM173,139476361,139481704,5343,-1
NP_003330.1,Homo_sapiens,5,UBE2D2,139561791,139626801,65010,1
NP_862821.1,Homo_sapiens,5,UBE2D2,139600434,139626801,26367,1
NP_057547.5,Homo_sapiens,5,CXXC5,139680523,139682907,2384,1
NP_001304128.1,Homo_sapiens,5,CXXC5,139680523,139682907,2384,1
NP_001304130.1,Homo_sapiens,5,CXXC5,139680523,139682907,2384,1
NP_001304129.1,Homo_sapiens,5,CXXC5,139680523,139682907,2384,1
NP_001304131.1,Homo_sapiens,5,CXXC5,139680523,139682907,2384,1
NP_001304132.1,Homo_sapiens,5,CXXC5,139680523,139682907,2384,1
NP_001304133.1,Homo_sapiens,5,CXXC5,139680523,139682907,2384,1
NP_001304134.1,Homo_sapiens,5,CXXC5,139680523,139682907,2384,1
NP_001304135.1,Homo_sapiens,5,CXXC5,139680523,139682907,2384,1
NP_001304136.1,Homo_sapiens,5,CXXC5,139680523,139682907,2384,1
NP_001304137.1,Homo_sapiens,5,CXXC5,139680523,139682907,2384,1
NP_001304138.1,Homo_sapiens,5,CXXC5,139680523,139682907,2384,1
NP_001304139.1,Homo_sapiens,5,CXXC5,139680523,139682907,2384,1
NP_001304140.1,Homo_sapiens,5,CXXC5,139680523,139682907,2384,1
NP_115665.1,Homo_sapiens,5,PSD2,139809440,139842474,33034,1
NP_001171864.1,Homo_sapiens,5,NRG2,139847916,140043069,195153,-1
NP_053584.1,Homo_sapiens,5,NRG2,139847916,140043069,195153,-1
NP_053586.1,Homo_sapiens,5,NRG2,139847916,140043069,195153,-1
NP_004874.1,Homo_sapiens,5,NRG2,139847916,140043069,195153,-1
NP_053585.1,Homo_sapiens,5,NRG2,139847916,140043069,195153,-1
NP_005850.1,Homo_sapiens,5,PURA,140114181,140115150,969,1
NP_001007190.1,Homo_sapiens,5,IGIP,140128476,140128638,162,1
NP_115788.1,Homo_sapiens,5,CYSTM1,140194465,140243411,48946,1
NP_002613.2,Homo_sapiens,5,PFDN1,140245973,140303073,57100,-1
NP_001936.1,Homo_sapiens,5,HBEGF,140334675,140346328,11653,-1
NP_001245357.1,Homo_sapiens,5,SLC4A9,140360236,140372798,12562,1
NP_113655.2,Homo_sapiens,5,SLC4A9,140360236,140372798,12562,1
NP_001245356.1,Homo_sapiens,5,SLC4A9,140360236,140372798,12562,1
NP_001245355.1,Homo_sapiens,5,SLC4A9,140360236,140372798,12562,1
NP_065741.3,Homo_sapiens,5,ANKHD1-EIF4EBP3,140401967,140549237,147270,1
NP_060217.1,Homo_sapiens,5,ANKHD1,140401967,140539418,137451,1
NP_078944.2,Homo_sapiens,5,ANKHD1,140401967,140472340,70373,1
NP_060448.1,Homo_sapiens,5,ANKHD1,140401967,140472340,70373,1
NP_001183959.1,Homo_sapiens,5,ANKHD1,140401967,140472312,70345,1
NP_003723.1,Homo_sapiens,5,EIF4EBP3,140547737,140549262,1525,1
NP_001030312.2,Homo_sapiens,5,SRA1,140550699,140557488,6789,-1
NP_001240693.1,Homo_sapiens,5,SRA1,140550699,140557452,6753,-1
NP_573420.2,Homo_sapiens,5,APBB3,140558584,140564245,5661,-1
NP_573418.2,Homo_sapiens,5,APBB3,140558584,140564245,5661,-1
NP_573419.2,Homo_sapiens,5,APBB3,140558584,140564245,5661,-1
NP_006042.3,Homo_sapiens,5,APBB3,140558584,140564245,5661,-1
NP_542401.1,Homo_sapiens,5,SLC35A4,140567169,140568144,975,1
NP_001167575.1,Homo_sapiens,5,CD14,140631855,140633071,1216,-1
NP_001167576.1,Homo_sapiens,5,CD14,140631855,140633071,1216,-1
NP_000582.1,Homo_sapiens,5,CD14,140631855,140633071,1216,-1
NP_001035110.1,Homo_sapiens,5,CD14,140631855,140633071,1216,-1
NP_001287909.1,Homo_sapiens,5,TMCO6,140639527,140645098,5571,1
NP_060972.3,Homo_sapiens,5,TMCO6,140639527,140645098,5571,1
NP_001287911.1,Homo_sapiens,5,TMCO6,140642955,140645098,2143,1
NP_002479.1,Homo_sapiens,5,NDUFA2,140645586,140647583,1997,-1
NP_001171941.1,Homo_sapiens,5,NDUFA2,140645702,140647583,1881,-1
NP_006074.2,Homo_sapiens,5,IK,140647908,140662329,14421,1
NP_060176.2,Homo_sapiens,5,WDR55,140664912,140669654,4742,1
NP_919225.1,Homo_sapiens,5,DND1,140671292,140673542,2250,-1
NP_001276023.1,Homo_sapiens,5,HARS,140674256,140691304,17048,-1
NP_001276022.1,Homo_sapiens,5,HARS,140674256,140691304,17048,-1
NP_001244971.1,Homo_sapiens,5,HARS,140674256,140691304,17048,-1
NP_001244969.1,Homo_sapiens,5,HARS,140674256,140691304,17048,-1
NP_001276021.1,Homo_sapiens,5,HARS,140674256,140691304,17048,-1
NP_001244970.1,Homo_sapiens,5,HARS,140674256,140691304,17048,-1
NP_002100.2,Homo_sapiens,5,HARS,140674256,140691304,17048,-1
NP_036340.1,Homo_sapiens,5,HARS2,140691648,140698552,6904,1
NP_001265660.1,Homo_sapiens,5,HARS2,140691648,140698552,6904,1
NP_001265661.1,Homo_sapiens,5,HARS2,140693961,140698552,4591,1
NP_653324.1,Homo_sapiens,5,ZMAT2,140700460,140705756,5296,1
NP_061723.1,Homo_sapiens,5,PCDHA1,140786290,141009937,223647,1
NP_113599.1,Homo_sapiens,5,PCDHA1,140786290,141009937,223647,1
NP_113598.1,Homo_sapiens,5,PCDHA1,140786290,140788714,2424,1
NP_061728.1,Homo_sapiens,5,PCDHA2,140794964,141009937,214973,1
NP_113684.1,Homo_sapiens,5,PCDHA2,140794964,140805098,10134,1
NP_113683.1,Homo_sapiens,5,PCDHA2,140794964,140797439,2475,1
NP_061729.1,Homo_sapiens,5,PCDHA3,140801197,141009937,208740,1
NP_113685.1,Homo_sapiens,5,PCDHA3,140801197,140803672,2475,1
NP_061730.1,Homo_sapiens,5,PCDHA4,140807187,141009937,202750,1
NP_113688.1,Homo_sapiens,5,PCDHA4,140807187,140809584,2397,1
NP_061731.1,Homo_sapiens,5,PCDHA5,140821775,141009937,188162,1
NP_113689.1,Homo_sapiens,5,PCDHA5,140821775,140824226,2451,1
NP_061732.1,Homo_sapiens,5,PCDHA6,140828091,141009937,181846,1
NP_114037.1,Homo_sapiens,5,PCDHA6,140828091,141009937,181846,1
NP_114036.1,Homo_sapiens,5,PCDHA6,140828091,140830503,2412,1
NP_061733.1,Homo_sapiens,5,PCDHA7,140834383,141009937,175554,1
NP_114040.1,Homo_sapiens,5,PCDHA7,140834383,140836753,2370,1
NP_061734.1,Homo_sapiens,5,PCDHA8,140841321,141009937,168616,1
NP_114062.1,Homo_sapiens,5,PCDHA8,140841321,140843766,2445,1
NP_114063.1,Homo_sapiens,5,PCDHA9,140848495,141009937,161442,1
NP_054724.1,Homo_sapiens,5,PCDHA9,140848495,140851024,2529,1
NP_061724.1,Homo_sapiens,5,PCDHA10,140856048,141009937,153889,1
NP_114066.1,Homo_sapiens,5,PCDHA10,140856048,141009937,153889,1
NP_114065.1,Homo_sapiens,5,PCDHA10,140856048,140858583,2535,1
NP_061725.1,Homo_sapiens,5,PCDHA11,140869103,141009937,140834,1
NP_114067.1,Homo_sapiens,5,PCDHA11,140869103,140871536,2433,1
NP_061726.1,Homo_sapiens,5,PCDHA12,140875472,141009937,134465,1
NP_114070.1,Homo_sapiens,5,PCDHA12,140875472,140877851,2379,1
NP_061727.1,Homo_sapiens,5,PCDHA13,140882268,141009937,127669,1
NP_114071.1,Homo_sapiens,5,PCDHA13,140882268,140884692,2424,1
NP_061721.2,Homo_sapiens,5,PCDHAC1,140926892,141009937,83045,1
NP_114088.2,Homo_sapiens,5,PCDHAC1,140926892,140929349,2457,1
NP_061722.1,Homo_sapiens,5,PCDHAC2,140966766,141009937,43171,1
NP_114089.1,Homo_sapiens,5,PCDHAC2,140966766,140969421,2655,1
NP_037472.2,Homo_sapiens,5,PCDHB1,141051470,141053927,2457,1
NP_061759.1,Homo_sapiens,5,PCDHB2,141094790,141097187,2397,1
NP_061760.1,Homo_sapiens,5,PCDHB3,141100649,141103040,2391,1
NP_061761.1,Homo_sapiens,5,PCDHB4,141121998,141124386,2388,1
NP_056484.2,Homo_sapiens,5,PCDHB5,141135434,141137822,2388,1
NP_061762.2,Homo_sapiens,5,PCDHB6,141150257,141152642,2385,1
NP_001290074.1,Homo_sapiens,5,PCDHB6,141150665,141152642,1977,1
NP_061763.1,Homo_sapiens,5,PCDHB7,141172835,141175217,2382,1
NP_061993.3,Homo_sapiens,5,PCDHB8,141178034,141180440,2406,1
NP_066008.2,Homo_sapiens,5,PCDHB16,141182559,141184890,2331,1
NP_061992.3,Homo_sapiens,5,PCDHB9,141187318,141189712,2394,1
NP_061753.1,Homo_sapiens,5,PCDHB10,141192552,141194955,2403,1
NP_061754.1,Homo_sapiens,5,PCDHB11,141199774,141202168,2394,1
NP_061755.1,Homo_sapiens,5,PCDHB12,141208907,141211295,2388,1
NP_061756.1,Homo_sapiens,5,PCDHB13,141214123,141216520,2397,1
NP_061757.1,Homo_sapiens,5,PCDHB14,141223505,141225902,2397,1
NP_061758.1,Homo_sapiens,5,PCDHB15,141245578,141247942,2364,1
NP_114153.1,Homo_sapiens,5,SLC25A2,141302959,141303865,906,-1
NP_005633.2,Homo_sapiens,5,TAF7,141318994,141320044,1050,-1
NP_061735.1,Homo_sapiens,5,PCDHGA1,141330684,141511173,180489,1
NP_114382.1,Homo_sapiens,5,PCDHGA1,141330684,141333156,2472,1
NP_061738.1,Homo_sapiens,5,PCDHGA2,141338971,141511173,172202,1
NP_114398.1,Homo_sapiens,5,PCDHGA2,141338971,141341443,2472,1
NP_061739.2,Homo_sapiens,5,PCDHGA3,141344033,141511173,167140,1
NP_114400.1,Homo_sapiens,5,PCDHGA3,141344033,141346523,2490,1
NP_061745.1,Homo_sapiens,5,PCDHGB1,141350260,141511173,160913,1
NP_115266.1,Homo_sapiens,5,PCDHGB1,141350260,141352693,2433,1
NP_061740.2,Homo_sapiens,5,PCDHGA4,141355107,141511173,156066,1
NP_114442.2,Homo_sapiens,5,PCDHGA4,141355107,141357663,2556,1
NP_061746.1,Homo_sapiens,5,PCDHGB2,141360135,141511173,151038,1
NP_115267.1,Homo_sapiens,5,PCDHGB2,141360135,141362571,2436,1
NP_061741.1,Homo_sapiens,5,PCDHGA5,141364330,141511173,146843,1
NP_114443.1,Homo_sapiens,5,PCDHGA5,141364330,141366772,2442,1
NP_061747.2,Homo_sapiens,5,PCDHGB3,141370394,141511173,140779,1
NP_115268.2,Homo_sapiens,5,PCDHGB3,141370394,141372839,2445,1
NP_061742.1,Homo_sapiens,5,PCDHGA6,141374083,141511173,137090,1
NP_114475.1,Homo_sapiens,5,PCDHGA6,141374083,141376540,2457,1
NP_061743.1,Homo_sapiens,5,PCDHGA7,141382899,141511173,128274,1
NP_114476.1,Homo_sapiens,5,PCDHGA7,141382899,141385353,2454,1
NP_003727.1,Homo_sapiens,5,PCDHGB4,141387884,141511173,123289,1
NP_115269.1,Homo_sapiens,5,PCDHGB4,141387884,141390296,2412,1
NP_114477.1,Homo_sapiens,5,PCDHGA8,141392813,141511173,118360,1
NP_054723.1,Homo_sapiens,5,PCDHGA8,141392813,141395276,2463,1
NP_061748.1,Homo_sapiens,5,PCDHGB5,141398127,141511173,113046,1
NP_115270.1,Homo_sapiens,5,PCDHGB5,141398127,141400584,2457,1
NP_061744.1,Homo_sapiens,5,PCDHGA9,141402952,141511173,108221,1
NP_114478.1,Homo_sapiens,5,PCDHGA9,141402952,141405439,2487,1
NP_061749.1,Homo_sapiens,5,PCDHGB6,141408202,141511173,102971,1
NP_115271.1,Homo_sapiens,5,PCDHGB6,141408202,141410665,2463,1
NP_061736.1,Homo_sapiens,5,PCDHGA10,141413175,141511173,97998,1
NP_114479.1,Homo_sapiens,5,PCDHGA10,141413175,141415728,2553,1
NP_061750.1,Homo_sapiens,5,PCDHGB7,141417859,141511173,93314,1
NP_115272.1,Homo_sapiens,5,PCDHGB7,141417859,141420286,2427,1
NP_061737.1,Homo_sapiens,5,PCDHGA11,141421227,141511173,89946,1
NP_114481.1,Homo_sapiens,5,PCDHGA11,141421227,141511173,89946,1
NP_114480.1,Homo_sapiens,5,PCDHGA11,141421227,141423741,2514,1
NP_003726.1,Homo_sapiens,5,PCDHGA12,141430759,141511173,80414,1
NP_115265.1,Homo_sapiens,5,PCDHGA12,141430759,141433222,2463,1
NP_002579.2,Homo_sapiens,5,PCDHGC3,141476116,141511173,35057,1
NP_115779.1,Homo_sapiens,5,PCDHGC3,141476116,141511173,35057,1
NP_115778.1,Homo_sapiens,5,PCDHGC3,141476116,141478708,2592,1
NP_061751.1,Homo_sapiens,5,PCDHGC4,141485173,141511173,26000,1
NP_115782.1,Homo_sapiens,5,PCDHGC4,141485173,141487789,2616,1
NP_061752.1,Homo_sapiens,5,PCDHGC5,141489240,141511173,21933,1
NP_115783.1,Homo_sapiens,5,PCDHGC5,141489240,141491877,2637,1
NP_001073280.1,Homo_sapiens,5,DIAPH1,141516850,141618914,102064,-1
NP_005210.3,Homo_sapiens,5,DIAPH1,141516850,141618914,102064,-1
NP_001300936.1,Homo_sapiens,5,DIAPH1,141516969,141618914,101945,-1
NP_003874.2,Homo_sapiens,5,HDAC3,141621467,141636790,15323,-1
NP_776189.3,Homo_sapiens,5,RELL2,141638225,141640444,2219,1
NP_001123501.1,Homo_sapiens,5,RELL2,141638225,141640444,2219,1
NP_258260.1,Homo_sapiens,5,FCHSD1,141641497,141651368,9871,-1
NP_071926.4,Homo_sapiens,5,ARAP3,141653949,141680486,26537,-1
NP_115796.2,Homo_sapiens,5,PCDH1,141854041,141878262,24221,-1
NP_002578.2,Homo_sapiens,5,PCDH1,141863147,141878262,15115,-1
NP_001265542.1,Homo_sapiens,5,PCDH1,141863147,141869604,6457,-1
NP_001265544.1,Homo_sapiens,5,PCDH1,141863147,141865193,2046,-1
NP_055588.3,Homo_sapiens,5,KIAA0141,141923941,141938759,14818,1
NP_001136075.1,Homo_sapiens,5,KIAA0141,141923941,141938759,14818,1
NP_057664.1,Homo_sapiens,5,PCDH12,141945380,141957851,12471,-1
NP_001188294.1,Homo_sapiens,5,RNF14,141973588,141987790,14202,1
NP_899646.1,Homo_sapiens,5,RNF14,141973588,141987790,14202,1
NP_899647.1,Homo_sapiens,5,RNF14,141973588,141987790,14202,1
NP_899648.1,Homo_sapiens,5,RNF14,141973588,141987790,14202,1
NP_004281.1,Homo_sapiens,5,RNF14,141973588,141987790,14202,1
NP_899645.1,Homo_sapiens,5,RNF14,141978374,141987790,9416,1
NP_005462.1,Homo_sapiens,5,GNPDA1,142002028,142012035,10007,-1
NP_085048.1,Homo_sapiens,5,NDFIP1,142108974,142144674,35700,1
NP_112226.2,Homo_sapiens,5,SPRY4,142314208,142319765,5557,-1
NP_001120968.1,Homo_sapiens,5,SPRY4,142314208,142315108,900,-1
NP_001280218.1,Homo_sapiens,5,SPRY4,142314208,142315108,900,-1
NP_001280219.1,Homo_sapiens,5,SPRY4,142314208,142315108,900,-1
NP_001244135.1,Homo_sapiens,5,FGF1,142595289,142614127,18838,-1
NP_001244140.1,Homo_sapiens,5,FGF1,142595289,142614127,18838,-1
NP_001244141.1,Homo_sapiens,5,FGF1,142595289,142614127,18838,-1
NP_001138364.1,Homo_sapiens,5,FGF1,142595289,142614127,18838,-1
NP_001138406.1,Homo_sapiens,5,FGF1,142595289,142614127,18838,-1
NP_001138407.1,Homo_sapiens,5,FGF1,142595289,142614127,18838,-1
NP_001244134.1,Homo_sapiens,5,FGF1,142595289,142614127,18838,-1
NP_001244136.1,Homo_sapiens,5,FGF1,142595289,142614127,18838,-1
NP_001244137.1,Homo_sapiens,5,FGF1,142595289,142614127,18838,-1
NP_001244138.1,Homo_sapiens,5,FGF1,142595289,142614127,18838,-1
NP_001244139.1,Homo_sapiens,5,FGF1,142595289,142614127,18838,-1
NP_000791.1,Homo_sapiens,5,FGF1,142595289,142614127,18838,-1
NP_149128.1,Homo_sapiens,5,FGF1,142595470,142614127,18657,-1
NP_149127.1,Homo_sapiens,5,FGF1,142595470,142614127,18657,-1
NP_055886.1,Homo_sapiens,5,ARHGAP26,142770761,143222446,451685,1
NP_001129080.1,Homo_sapiens,5,ARHGAP26,142770761,143222446,451685,1
NP_001018661.1,Homo_sapiens,5,NR3C1,143279363,143400839,121476,-1
NP_000167.1,Homo_sapiens,5,NR3C1,143281888,143400839,118951,-1
NP_001018084.1,Homo_sapiens,5,NR3C1,143281888,143400839,118951,-1
NP_001018085.1,Homo_sapiens,5,NR3C1,143281888,143400839,118951,-1
NP_001018086.1,Homo_sapiens,5,NR3C1,143281888,143400839,118951,-1
NP_001018087.1,Homo_sapiens,5,NR3C1,143281888,143400839,118951,-1
NP_001019265.1,Homo_sapiens,5,NR3C1,143281888,143400839,118951,-1
NP_001191187.1,Homo_sapiens,5,NR3C1,143281888,143400761,118873,-1
NP_001191188.1,Homo_sapiens,5,NR3C1,143281888,143400584,118696,-1
NP_001191189.1,Homo_sapiens,5,NR3C1,143281888,143400572,118684,-1
NP_001191190.1,Homo_sapiens,5,NR3C1,143281888,143400548,118660,-1
NP_001191191.1,Homo_sapiens,5,NR3C1,143281888,143399894,118006,-1
NP_001191192.1,Homo_sapiens,5,NR3C1,143281888,143399849,117961,-1
NP_001191193.1,Homo_sapiens,5,NR3C1,143281888,143399834,117946,-1
NP_001191194.1,Homo_sapiens,5,NR3C1,143295451,143400839,105388,-1
NP_067005.1,Homo_sapiens,5,HMHB1,143812267,143820568,8301,1
NP_110426.4,Homo_sapiens,5,YIPF5,144160396,144169955,9559,-1
NP_001020118.1,Homo_sapiens,5,YIPF5,144160396,144169955,9559,-1
NP_001258661.1,Homo_sapiens,5,YIPF5,144160396,144165552,5156,-1
NP_065819.1,Homo_sapiens,5,KCTD16,144206714,144474114,267400,1
NP_995318.1,Homo_sapiens,5,PRELID2,145764940,145835251,70311,-1
NP_892005.1,Homo_sapiens,5,PRELID2,145764940,145835251,70311,-1
NP_612501.3,Homo_sapiens,5,PRELID2,145764940,145823122,58182,-1
NP_001073985.1,Homo_sapiens,5,GRXCR2,145859732,145872968,13236,-1
NP_689763.3,Homo_sapiens,5,SH3RF2,145937928,146062701,124773,1
NP_001025040.1,Homo_sapiens,5,PLAC8L1,146084431,146104311,19880,-1
NP_057544.2,Homo_sapiens,5,LARS,146114105,146182493,68388,-1
NP_001304893.1,Homo_sapiens,5,LARS,146114105,146182493,68388,-1
NP_064502.9,Homo_sapiens,5,LARS,146114105,146182493,68388,-1
NP_001304894.1,Homo_sapiens,5,LARS,146114105,146172737,58632,-1
NP_061862.1,Homo_sapiens,5,RBM27,146203765,146286030,82265,1
NP_002691.1,Homo_sapiens,5,POU4F3,146339112,146340444,1332,1
NP_006697.2,Homo_sapiens,5,TCERG1,146447349,146510642,63293,1
NP_001035095.1,Homo_sapiens,5,TCERG1,146447349,146510642,63293,1
NP_919227.2,Homo_sapiens,5,GPR151,146514853,146516113,1260,-1
NP_001258828.1,Homo_sapiens,5,PPP2R2B,146589946,147081266,491320,-1
NP_001258829.1,Homo_sapiens,5,PPP2R2B,146589946,147081108,491162,-1
NP_858062.1,Homo_sapiens,5,PPP2R2B,146589946,147055743,465797,-1
NP_858060.2,Homo_sapiens,5,PPP2R2B,146589946,147055738,465792,-1
NP_858063.1,Homo_sapiens,5,PPP2R2B,146589946,147035178,445232,-1
NP_858061.2,Homo_sapiens,5,PPP2R2B,146589946,146878784,288838,-1
NP_858064.1,Homo_sapiens,5,PPP2R2B,146589946,146856535,266589,-1
NP_001258877.1,Homo_sapiens,5,PPP2R2B,146589946,146856535,266589,-1
NP_001274669.1,Homo_sapiens,5,STK32A,147239634,147384436,144802,1
NP_001106195.1,Homo_sapiens,5,STK32A,147239634,147383983,144349,1
NP_659438.1,Homo_sapiens,5,STK32A,147239634,147348723,109089,1
NP_001184223.1,Homo_sapiens,5,DPYSL3,147394034,147509858,115824,-1
NP_001378.1,Homo_sapiens,5,DPYSL3,147394034,147453587,59553,-1
NP_055605.2,Homo_sapiens,5,JAKMIP2,147591665,147671806,80141,-1
NP_001269211.1,Homo_sapiens,5,JAKMIP2,147601760,147782458,180698,-1
NP_001257863.1,Homo_sapiens,5,JAKMIP2,147601760,147671806,70046,-1
NP_001257870.1,Homo_sapiens,5,JAKMIP2,147601760,147671806,70046,-1
NP_003113.2,Homo_sapiens,5,SPINK1,147824660,147831577,6917,-1
NP_473364.1,Homo_sapiens,5,SCGB3A2,147878803,147882050,3247,1
NP_996849.2,Homo_sapiens,5,C5orf46,147896992,147906501,9509,-1
NP_001121170.1,Homo_sapiens,5,SPINK5,148064044,148136991,72947,1
NP_006837.2,Homo_sapiens,5,SPINK5,148064044,148136991,72947,1
NP_001121171.1,Homo_sapiens,5,SPINK5,148064044,148124849,60805,1
NP_001001325.1,Homo_sapiens,5,SPINK14,148169732,148175398,5666,1
NP_001182219.1,Homo_sapiens,5,SPINK6,148203096,148214950,11854,1
NP_995313.2,Homo_sapiens,5,SPINK6,148203096,148214950,11854,1
XP_011536019.1,Homo_sapiens,5,LOC105378220,148238597,148243254,4657,1
NP_001035218.1,Homo_sapiens,5,SPINK13,148270072,148286048,15976,1
NP_115955.1,Homo_sapiens,5,SPINK7,148312483,148315684,3201,1
NP_001035523.1,Homo_sapiens,5,SPINK9,148335613,148339712,4099,1
NP_110420.3,Homo_sapiens,5,FBXO38,148394776,148442147,47371,1
NP_001258652.1,Homo_sapiens,5,FBXO38,148394776,148442147,47371,1
NP_001035259.1,Homo_sapiens,5,HTR4,148451184,148637014,185830,-1
NP_955525.1,Homo_sapiens,5,HTR4,148465864,148637014,171150,-1
NP_001035262.2,Homo_sapiens,5,HTR4,148476738,148637014,160276,-1
NP_001273339.1,Homo_sapiens,5,HTR4,148481469,148637014,155545,-1
NP_000861.1,Homo_sapiens,5,HTR4,148483202,148637014,153812,-1
NP_001035263.1,Homo_sapiens,5,HTR4,148483202,148637014,153812,-1
NP_000015.1,Homo_sapiens,5,ADRB2,148826831,148828073,1242,1
NP_078853.2,Homo_sapiens,5,SH3TC2,149004710,149063022,58312,-1
NP_001287957.1,Homo_sapiens,5,ABLIM3,149142095,149259575,117480,1
NP_001287944.1,Homo_sapiens,5,ABLIM3,149142095,149258404,116309,1
NP_055760.1,Homo_sapiens,5,ABLIM3,149142095,149258404,116309,1
NP_001287947.1,Homo_sapiens,5,ABLIM3,149142095,149258404,116309,1
NP_001287956.1,Homo_sapiens,5,ABLIM3,149183493,149258404,74911,1
NP_689619.1,Homo_sapiens,5,AFAP1L1,149271968,149340030,68062,1
NP_001139809.1,Homo_sapiens,5,AFAP1L1,149271968,149340030,68062,1
NP_001309991.1,Homo_sapiens,5,AFAP1L1,149271968,149340030,68062,1
NP_001309992.1,Homo_sapiens,5,AFAP1L1,149271968,149312318,40350,1
NP_689620.2,Homo_sapiens,5,GRPEL2,149345539,149351282,5743,1
NP_076933.3,Homo_sapiens,5,PCYOX1L,149358068,149368654,10586,1
NP_001287983.1,Homo_sapiens,5,PCYOX1L,149358135,149368654,10519,1
NP_001287986.1,Homo_sapiens,5,PCYOX1L,149358135,149368654,10519,1
NP_055258.1,Homo_sapiens,5,IL17B,149374368,149379225,4857,-1
NP_001304916.1,Homo_sapiens,5,IL17B,149374368,149376890,2522,-1
NP_001258670.1,Homo_sapiens,5,CSNK1A1,149496852,149550964,54112,-1
NP_001883.4,Homo_sapiens,5,CSNK1A1,149496852,149550964,54112,-1
NP_001020276.1,Homo_sapiens,5,CSNK1A1,149496852,149550964,54112,-1
NP_001258671.1,Homo_sapiens,5,CSNK1A1,149496852,149525134,28282,-1
NP_001001669.2,Homo_sapiens,5,ARHGEF37,149597769,149632191,34422,1
NP_573570.3,Homo_sapiens,5,PPARGC1B,149730342,149847558,117216,1
NP_001166169.1,Homo_sapiens,5,PPARGC1B,149730342,149847558,117216,1
NP_001166170.1,Homo_sapiens,5,PPARGC1B,149772136,149847558,75422,1
NP_000431.2,Homo_sapiens,5,PDE6A,149860894,149944673,83779,-1
NP_000103.2,Homo_sapiens,5,SLC26A2,149977652,149981813,4161,1
NP_112215.1,Homo_sapiens,5,TIGD6,149994782,149996348,1566,-1
NP_001230182.1,Homo_sapiens,5,TIGD6,149994782,149996348,1566,-1
NP_055798.2,Homo_sapiens,5,HMGXB3,150004852,150052192,47340,1
NP_005202.2,Homo_sapiens,5,CSF1R,150054068,150086427,32359,-1
NP_001275634.1,Homo_sapiens,5,CSF1R,150054068,150086427,32359,-1
NP_002600.1,Homo_sapiens,5,PDGFRB,150115762,150137047,21285,-1
NP_001795.2,Homo_sapiens,5,CDX1,150166876,150183680,16804,1
NP_055043.2,Homo_sapiens,5,SLC6A7,150190327,150209615,19288,1
NP_741960.1,Homo_sapiens,5,CAMK2A,150222709,150289625,66916,-1
NP_057065.2,Homo_sapiens,5,CAMK2A,150222709,150289625,66916,-1
NP_001012301.1,Homo_sapiens,5,ARSI,150297213,150302373,5160,-1
NP_001128715.1,Homo_sapiens,5,TCOF1,150357746,150399048,41302,1
NP_001128716.1,Homo_sapiens,5,TCOF1,150357746,150399048,41302,1
NP_001182070.1,Homo_sapiens,5,TCOF1,150357746,150399048,41302,1
NP_001128717.1,Homo_sapiens,5,TCOF1,150357746,150399048,41302,1
NP_000347.2,Homo_sapiens,5,TCOF1,150357746,150399048,41302,1
NP_001008657.1,Homo_sapiens,5,TCOF1,150357746,150383755,26009,1
NP_004346.1,Homo_sapiens,5,CD74,150402239,150412749,10510,-1
NP_001020330.1,Homo_sapiens,5,CD74,150402239,150412749,10510,-1
NP_001020329.1,Homo_sapiens,5,CD74,150402583,150412749,10166,-1
NP_005608.1,Homo_sapiens,5,RPS14,150444285,150447733,3448,-1
NP_001020241.1,Homo_sapiens,5,RPS14,150444285,150447733,3448,-1
NP_001020242.1,Homo_sapiens,5,RPS14,150444285,150447733,3448,-1
NP_001534.1,Homo_sapiens,5,NDST1,150521254,150553332,32078,1
NP_001287992.1,Homo_sapiens,5,NDST1,150521254,150553332,32078,1
NP_001159680.1,Homo_sapiens,5,SYNPO,150618367,150650333,31966,1
NP_001159681.1,Homo_sapiens,5,SYNPO,150618367,150650333,31966,1
NP_009217.3,Homo_sapiens,5,SYNPO,150648275,150657087,8812,1
NP_001103444.1,Homo_sapiens,5,SYNPO,150648275,150650333,2058,1
NP_588612.2,Homo_sapiens,5,MYOZ3,150662941,150676875,13934,1
NP_001116325.1,Homo_sapiens,5,MYOZ3,150662941,150676875,13934,1
NP_060517.1,Homo_sapiens,5,RBM22,150691750,150700985,9235,-1
NP_057305.1,Homo_sapiens,5,DCTN4,150711148,150758993,47845,-1
NP_001129115.1,Homo_sapiens,5,DCTN4,150711148,150758993,47845,-1
NP_001129116.1,Homo_sapiens,5,DCTN4,150711148,150756451,45303,-1
NP_116565.3,Homo_sapiens,5,SMIM3,150795440,150795623,183,1
NP_001139277.1,Homo_sapiens,5,IRGM,150848123,150848669,546,1
NP_001166302.1,Homo_sapiens,5,ZNF300,150895423,150903349,7926,-1
NP_443092.1,Homo_sapiens,5,ZNF300,150895423,150903155,7732,-1
NP_001166303.1,Homo_sapiens,5,ZNF300,150895423,150898461,3038,-1
NP_002075.2,Homo_sapiens,5,GPX3,151020654,151028130,7476,1
NP_001239321.1,Homo_sapiens,5,TNIP1,151030641,151065095,34454,-1
NP_001239322.1,Homo_sapiens,5,TNIP1,151030641,151065095,34454,-1
NP_001245385.1,Homo_sapiens,5,TNIP1,151030663,151065095,34432,-1
NP_001245384.1,Homo_sapiens,5,TNIP1,151030712,151065095,34383,-1
NP_006049.3,Homo_sapiens,5,TNIP1,151030712,151065095,34383,-1
NP_001239319.1,Homo_sapiens,5,TNIP1,151030712,151065095,34383,-1
NP_001239320.1,Homo_sapiens,5,TNIP1,151030712,151065095,34383,-1
NP_001245383.1,Homo_sapiens,5,TNIP1,151030712,151065095,34383,-1
NP_001239315.1,Homo_sapiens,5,TNIP1,151030712,151063724,33012,-1
NP_001239314.1,Homo_sapiens,5,TNIP1,151032319,151065095,32776,-1
NP_001146.2,Homo_sapiens,5,ANXA6,151101447,151147901,46454,-1
NP_001180473.1,Homo_sapiens,5,ANXA6,151101447,151140165,38718,-1
NP_056436.2,Homo_sapiens,5,CCDC69,151183436,151223970,40534,-1
XP_016865624.1,Homo_sapiens,5,LOC105378230,151212763,151224114,11351,1
XP_016865625.1,Homo_sapiens,5,LOC105378230,151212763,151224114,11351,1
NP_001161079.1,Homo_sapiens,5,GM2A,151253216,151267640,14424,1
NP_000396.2,Homo_sapiens,5,GM2A,151253216,151267451,14235,1
NP_861439.3,Homo_sapiens,5,SLC36A3,151277392,151303354,25962,-1
NP_001138489.1,Homo_sapiens,5,SLC36A3,151277392,151303354,25962,-1
NP_861441.2,Homo_sapiens,5,SLC36A2,151316816,151347460,30644,-1
NP_510968.2,Homo_sapiens,5,SLC36A1,151458792,151488254,29462,1
NP_001295079.1,Homo_sapiens,5,SLC36A1,151458792,151480058,21266,1
NP_001295080.1,Homo_sapiens,5,SLC36A1,151458792,151469254,10462,1
NP_001438.1,Homo_sapiens,5,FAT2,151505564,151568931,63367,-1
NP_001296373.1,Homo_sapiens,5,SPARC,151663454,151676188,12734,-1
NP_001296372.1,Homo_sapiens,5,SPARC,151663570,151676188,12618,-1
NP_003109.1,Homo_sapiens,5,SPARC,151663570,151676188,12618,-1
NP_004036.1,Homo_sapiens,5,ATOX1,151746324,151758551,12227,-1
NP_938405.1,Homo_sapiens,5,G3BP1,151786620,151804091,17471,1
NP_005745.1,Homo_sapiens,5,G3BP1,151786620,151804091,17471,1
NP_000162.2,Homo_sapiens,5,GLRA1,151822672,151924549,101877,-1
NP_001139512.1,Homo_sapiens,5,GLRA1,151822672,151924549,101877,-1
NP_001278929.1,Homo_sapiens,5,GLRA1,151822672,151886723,64051,-1
NP_064552.3,Homo_sapiens,5,NMUR2,152392190,152405113,12923,-1
NP_000818.2,Homo_sapiens,5,GRIA1,153490888,153811225,320337,1
NP_001107655.1,Homo_sapiens,5,GRIA1,153490888,153811225,320337,1
NP_001244948.1,Homo_sapiens,5,GRIA1,153490888,153811225,320337,1
NP_001244950.1,Homo_sapiens,5,GRIA1,153492198,153811225,319027,1
NP_001244951.1,Homo_sapiens,5,GRIA1,153492198,153811225,319027,1
NP_001244952.1,Homo_sapiens,5,GRIA1,153494052,153811225,317173,1
NP_001244949.1,Homo_sapiens,5,GRIA1,153646992,153811225,164233,1
NP_001304924.1,Homo_sapiens,5,FAM114A2,153992975,154034953,41978,-1
NP_061161.2,Homo_sapiens,5,FAM114A2,153992975,154034953,41978,-1
NP_001304923.1,Homo_sapiens,5,FAM114A2,153992975,154034953,41978,-1
NP_001304922.1,Homo_sapiens,5,FAM114A2,153992975,154034953,41978,-1
NP_001229265.1,Homo_sapiens,5,MFAP3,154049722,154053713,3991,1
NP_005918.1,Homo_sapiens,5,MFAP3,154049722,154053713,3991,1
NP_001128509.1,Homo_sapiens,5,MFAP3,154053062,154053713,651,1
NP_938080.1,Homo_sapiens,5,GALNT10,154190866,154416972,226106,1
NP_078908.1,Homo_sapiens,5,SAP30L,154446604,154456028,9424,1
NP_001124534.1,Homo_sapiens,5,SAP30L,154446604,154456028,9424,1
NP_001124535.1,Homo_sapiens,5,SAP30L,154446604,154456028,9424,1
NP_004812.1,Homo_sapiens,5,HAND1,154475805,154478008,2203,-1
NP_056130.2,Homo_sapiens,5,LARP1,154712925,154814096,101171,1
NP_115761.2,Homo_sapiens,5,FAXDC2,154820315,154838178,17863,-1
NP_004770.4,Homo_sapiens,5,CNOT8,154863278,154875439,12161,1
NP_001288002.1,Homo_sapiens,5,CNOT8,154863278,154875439,12161,1
NP_001288003.1,Homo_sapiens,5,CNOT8,154863278,154875439,12161,1
NP_001288009.1,Homo_sapiens,5,CNOT8,154870667,154875439,4772,1
NP_001288006.1,Homo_sapiens,5,CNOT8,154870667,154875439,4772,1
NP_001288011.1,Homo_sapiens,5,CNOT8,154870667,154875439,4772,1
NP_001288004.1,Homo_sapiens,5,CNOT8,154870667,154875439,4772,1
NP_001288012.1,Homo_sapiens,5,CNOT8,154870667,154875439,4772,1
NP_001288015.1,Homo_sapiens,5,CNOT8,154871748,154875439,3691,1
NP_001239085.1,Homo_sapiens,5,GEMIN5,154888209,154938133,49924,-1
NP_056280.2,Homo_sapiens,5,GEMIN5,154888209,154938133,49924,-1
NP_054899.2,Homo_sapiens,5,MRPL22,154941110,154966897,25787,1
NP_001014990.1,Homo_sapiens,5,MRPL22,154956415,154966897,10482,1
NP_001092763.1,Homo_sapiens,5,KIF4B,155013859,155017564,3705,1
NP_000328.2,Homo_sapiens,5,SGCD,156329576,156759390,429814,1
NP_758447.1,Homo_sapiens,5,SGCD,156329576,156757776,428200,1
NP_001121681.1,Homo_sapiens,5,SGCD,156344488,156759390,414902,1
NP_001140198.1,Homo_sapiens,5,TIMD4,156919456,156963198,43742,-1
NP_612388.2,Homo_sapiens,5,TIMD4,156919456,156963198,43742,-1
NP_001295085.1,Homo_sapiens,5,HAVCR1,157029587,157057943,28356,-1
NP_036338.2,Homo_sapiens,5,HAVCR1,157029732,157057943,28211,-1
NP_001166864.1,Homo_sapiens,5,HAVCR1,157029732,157057943,28211,-1
NP_116171.3,Homo_sapiens,5,HAVCR2,157087101,157108983,21882,-1
NP_001094286.1,Homo_sapiens,5,MED7,157138729,157139431,702,-1
NP_004261.1,Homo_sapiens,5,MED7,157138729,157139431,702,-1
NP_570969.2,Homo_sapiens,5,FAM71B,157162446,157166168,3722,-1
NP_005537.3,Homo_sapiens,5,ITK,157180977,157252678,71701,1
NP_001278651.1,Homo_sapiens,5,CYFIP2,157285361,157393000,107639,1
NP_055191.2,Homo_sapiens,5,CYFIP2,157285361,157393000,107639,1
NP_001032410.1,Homo_sapiens,5,CYFIP2,157285361,157393000,107639,1
NP_001278650.1,Homo_sapiens,5,CYFIP2,157285361,157393000,107639,1
NP_001001343.2,Homo_sapiens,5,FNDC9,157342861,157343536,675,-1
NP_001092757.1,Homo_sapiens,5,NIPAL4,157460134,157472960,12826,1
NP_001165763.1,Homo_sapiens,5,NIPAL4,157460134,157472960,12826,1
NP_150377.1,Homo_sapiens,5,ADAM19,157480948,157575696,94748,-1
NP_001295094.1,Homo_sapiens,5,SOX30,157626339,157667849,41510,-1
NP_848511.1,Homo_sapiens,5,SOX30,157626339,157652078,25739,-1
NP_008948.1,Homo_sapiens,5,SOX30,157626602,157652078,25476,-1
NP_001138604.1,Homo_sapiens,5,C5orf52,157671614,157679999,8385,1
NP_060342.2,Homo_sapiens,5,THG1L,157731440,157739482,8042,1
NP_001304755.1,Homo_sapiens,5,THG1L,157732610,157739482,6872,1
NP_001304753.1,Homo_sapiens,5,THG1L,157732977,157739482,6505,1
NP_001304754.1,Homo_sapiens,5,THG1L,157734582,157739482,4900,1
NP_775762.1,Homo_sapiens,5,LSM11,157743750,157755264,11514,1
NP_055481.1,Homo_sapiens,5,CLINT1,157787645,157858970,71325,-1
NP_001182484.1,Homo_sapiens,5,CLINT1,157787645,157858970,71325,-1
NP_001182485.1,Homo_sapiens,5,CLINT1,157787645,157817534,29889,-1
NP_874367.1,Homo_sapiens,5,EBF1,158699110,159099478,400368,-1
NP_001311037.1,Homo_sapiens,5,EBF1,158699110,159099478,400368,-1
NP_001311036.1,Homo_sapiens,5,EBF1,158699110,159099478,400368,-1
NP_076870.1,Homo_sapiens,5,EBF1,158699110,159099478,400368,-1
NP_001277289.1,Homo_sapiens,5,EBF1,158699110,159099478,400368,-1
NP_001311040.1,Homo_sapiens,5,EBF1,158699110,159095631,396521,-1
NP_001311035.1,Homo_sapiens,5,EBF1,158707568,159099478,391910,-1
NP_001311032.1,Homo_sapiens,5,EBF1,158707568,159099478,391910,-1
NP_001311038.1,Homo_sapiens,5,EBF1,158707568,159099478,391910,-1
NP_001311030.1,Homo_sapiens,5,EBF1,158707568,159099478,391910,-1
NP_001186309.1,Homo_sapiens,5,RNF145,159158669,159209903,51234,-1
NP_001186310.1,Homo_sapiens,5,RNF145,159158669,159207896,49227,-1
NP_653327.1,Homo_sapiens,5,RNF145,159158669,159207799,49130,-1
NP_001186311.1,Homo_sapiens,5,RNF145,159158669,159207477,48808,-1
NP_001186312.1,Homo_sapiens,5,RNF145,159158669,159203617,44948,-1
NP_659486.2,Homo_sapiens,5,UBLCP1,159268915,159284931,16016,1
NP_002178.2,Homo_sapiens,5,IL12B,159316684,159326782,10098,-1
NP_000670.1,Homo_sapiens,5,ADRA1B,159916905,159972492,55587,1
NP_003305.1,Homo_sapiens,5,TTC1,160010528,160065065,54537,1
NP_001269429.1,Homo_sapiens,5,TTC1,160010528,160065065,54537,1
NP_001253964.1,Homo_sapiens,5,PWWP2A,160078154,160119388,41234,-1
NP_443159.1,Homo_sapiens,5,PWWP2A,160078154,160119388,41234,-1
NP_001124336.1,Homo_sapiens,5,PWWP2A,160092381,160119388,27007,-1
NP_001124430.1,Homo_sapiens,5,FABP6,160199106,160238659,39553,1
NP_001035532.1,Homo_sapiens,5,FABP6,160199106,160238659,39553,1
NP_001436.1,Homo_sapiens,5,FABP6,160229557,160238659,9102,1
NP_001295102.1,Homo_sapiens,5,CCNJL,160253377,160311923,58546,-1
NP_078841.3,Homo_sapiens,5,CCNJL,160253377,160311923,58546,-1
NP_114114.2,Homo_sapiens,5,C1QTNF2,160349167,160370637,21470,-1
NP_071373.2,Homo_sapiens,5,ZBED8,160393705,160395490,1785,-1
NP_001290180.1,Homo_sapiens,5,ZBED8,160393705,160395490,1785,-1
NP_006416.3,Homo_sapiens,5,SLU7,160403284,160415294,12010,-1
NP_004210.1,Homo_sapiens,5,PTTG1,160422312,160428681,6369,1
NP_001269311.1,Homo_sapiens,5,PTTG1,160422312,160428681,6369,1
NP_001269312.1,Homo_sapiens,5,PTTG1,160422312,160428681,6369,1
NP_079429.2,Homo_sapiens,5,ATP10B,160565452,160688074,122622,-1
NP_000804.1,Homo_sapiens,5,GABRB2,161294080,161546643,252563,-1
NP_068711.1,Homo_sapiens,5,GABRB2,161294080,161546643,252563,-1
NP_000802.2,Homo_sapiens,5,GABRA6,161685989,161701773,15784,1
NP_001121115.1,Homo_sapiens,5,GABRA1,161850810,161897422,46612,1
NP_001121116.1,Homo_sapiens,5,GABRA1,161850810,161897422,46612,1
NP_001121117.1,Homo_sapiens,5,GABRA1,161850810,161897422,46612,1
NP_001121120.1,Homo_sapiens,5,GABRA1,161850810,161897422,46612,1
NP_000797.2,Homo_sapiens,5,GABRA1,161850810,161897422,46612,1
NP_944493.2,Homo_sapiens,5,GABRG2,162067999,162153368,85369,1
NP_944494.1,Homo_sapiens,5,GABRG2,162067999,162153368,85369,1
NP_000807.2,Homo_sapiens,5,GABRG2,162067999,162153368,85369,1
NP_954854.1,Homo_sapiens,5,CCNG1,163439256,163442565,3309,1
NP_004051.1,Homo_sapiens,5,CCNG1,163439256,163442565,3309,1
NP_660309.1,Homo_sapiens,5,NUDCD2,163453966,163460050,6084,-1
NP_001136028.1,Homo_sapiens,5,HMMR,163460692,163491164,30472,1
NP_036616.2,Homo_sapiens,5,HMMR,163460692,163491164,30472,1
NP_036617.2,Homo_sapiens,5,HMMR,163460692,163491164,30472,1
NP_001136029.1,Homo_sapiens,5,HMMR,163460726,163491164,30438,1
NP_877725.1,Homo_sapiens,5,MAT2B,163503394,163518363,14969,1
NP_037415.1,Homo_sapiens,5,MAT2B,163505686,163518363,12677,1
NP_001116151.1,Homo_sapiens,5,TENM2,167284837,168262810,977973,1
NP_001073897.2,Homo_sapiens,5,TENM2,167755053,168262810,507757,1
NP_001155133.1,Homo_sapiens,5,WWC1,168292152,168469017,176865,1
NP_001155134.1,Homo_sapiens,5,WWC1,168292152,168469017,176865,1
NP_056053.1,Homo_sapiens,5,WWC1,168292152,168469017,176865,1
NP_002878.2,Homo_sapiens,5,RARS,168486498,168519190,32692,1
NP_078870.1,Homo_sapiens,5,PANK3,168557570,168579283,21713,-1
NP_003053.1,Homo_sapiens,5,SLIT3,168666453,169300709,634256,-1
NP_001258875.1,Homo_sapiens,5,SLIT3,168666453,169300709,634256,-1
NP_060255.3,Homo_sapiens,5,SPDL1,169588416,169604207,15791,1
NP_004937.1,Homo_sapiens,5,DOCK2,169637326,170082858,445532,1
NP_001123363.1,Homo_sapiens,5,FAM196B,169864272,169883898,19626,-1
NP_036320.2,Homo_sapiens,5,FOXI1,170105957,170108611,2654,1
NP_658982.1,Homo_sapiens,5,FOXI1,170105957,170108611,2654,1
NP_001096079.1,Homo_sapiens,5,C5orf58,170234135,170246113,11978,1
NP_001292323.1,Homo_sapiens,5,C5orf58,170234135,170246113,11978,1
NP_001292322.1,Homo_sapiens,5,C5orf58,170234135,170246113,11978,1
NP_001292324.1,Homo_sapiens,5,C5orf58,170234135,170236210,2075,1
NP_001292325.1,Homo_sapiens,5,C5orf58,170234135,170236210,2075,1
NP_001292326.1,Homo_sapiens,5,C5orf58,170234135,170236210,2075,1
NP_005556.1,Homo_sapiens,5,LCP2,170248696,170297611,48915,-1
NP_001030010.1,Homo_sapiens,5,KCNIP1,170353876,170735806,381930,1
NP_004128.1,Homo_sapiens,5,KCNMB1,170378703,170385447,6744,-1
NP_001030009.1,Homo_sapiens,5,KCNIP1,170504572,170735806,231234,1
NP_001265268.1,Homo_sapiens,5,KCNIP1,170504572,170735806,231234,1
NP_055407.1,Homo_sapiens,5,KCNIP1,170504572,170735806,231234,1
NP_001265269.1,Homo_sapiens,5,KCNIP1,170718780,170735806,17026,1
NP_055026.1,Homo_sapiens,5,GABRP,170788615,170812258,23643,1
NP_001278914.1,Homo_sapiens,5,GABRP,170788615,170811993,23378,1
NP_075048.1,Homo_sapiens,5,RANBP17,170862033,171298858,436825,1
NP_066305.2,Homo_sapiens,5,TLX3,171309365,171311599,2234,1
NP_002511.1,Homo_sapiens,5,NPM1,171387948,171410565,22617,1
NP_954654.1,Homo_sapiens,5,NPM1,171387948,171410565,22617,1
NP_001032827.1,Homo_sapiens,5,NPM1,171387948,171406405,18457,1
NP_003853.1,Homo_sapiens,5,FGF18,171420199,171456805,36606,1
NP_001276899.1,Homo_sapiens,5,SMIM23,171785871,171791088,5217,1
NP_387449.2,Homo_sapiens,5,FBXW11,171868634,172006502,137868,-1
NP_387448.2,Homo_sapiens,5,FBXW11,171868634,172006502,137868,-1
NP_036432.2,Homo_sapiens,5,FBXW11,171868634,172006502,137868,-1
NP_005981.3,Homo_sapiens,5,STK10,172044881,172188042,143161,-1
NP_001164654.1,Homo_sapiens,5,EFCAB9,172194172,172203345,9173,1
NP_689490.2,Homo_sapiens,5,UBTD2,172211829,172283665,71836,-1
NP_001295104.1,Homo_sapiens,5,SH3PXD2B,172325275,172454352,129077,-1
NP_001017995.1,Homo_sapiens,5,SH3PXD2B,172338368,172454352,115984,-1
NP_001136123.1,Homo_sapiens,5,NEURL1B,172641406,172686925,45519,1
NP_001295107.1,Homo_sapiens,5,NEURL1B,172641406,172686925,45519,1
NP_001295106.1,Homo_sapiens,5,NEURL1B,172641406,172686925,45519,1
NP_001274741.1,Homo_sapiens,5,LOC101928093,172758262,172762517,4255,1
NP_004408.1,Homo_sapiens,5,DUSP1,172768761,172770952,2191,-1
NP_001026881.1,Homo_sapiens,5,ERGIC1,172834413,172950816,116403,1
NP_057177.1,Homo_sapiens,5,RPL26L1,172959873,172969541,9668,1
NP_001304909.1,Homo_sapiens,5,RPL26L1,172959873,172969541,9668,1
NP_001304910.1,Homo_sapiens,5,RPL26L1,172959873,172969541,9668,1
NP_001304911.1,Homo_sapiens,5,RPL26L1,172959873,172969541,9668,1
NP_003936.1,Homo_sapiens,5,ATP6V0E1,172983860,173020331,36471,1
NP_705835.2,Homo_sapiens,5,CREBRF,173080775,173133745,52970,1
NP_001161865.1,Homo_sapiens,5,CREBRF,173080775,173091433,10658,1
NP_001161866.1,Homo_sapiens,5,CREBRF,173080775,173091433,10658,1
NP_053582.2,Homo_sapiens,5,BNIP1,173144545,173163921,19376,1
NP_053583.2,Homo_sapiens,5,BNIP1,173144545,173163921,19376,1
NP_001196.2,Homo_sapiens,5,BNIP1,173144545,173163921,19376,1
NP_053581.2,Homo_sapiens,5,BNIP1,173144545,173163921,19376,1
NP_004378.1,Homo_sapiens,5,NKX2-5,173232568,173235083,2515,-1
NP_001159648.1,Homo_sapiens,5,NKX2-5,173233342,173235083,1741,-1
NP_001159647.1,Homo_sapiens,5,NKX2-5,173233496,173235083,1587,-1
NP_003705.1,Homo_sapiens,5,STC2,173317846,173328193,10347,-1
NP_001153123.1,Homo_sapiens,5,BOD1,173608264,173616436,8172,-1
NP_612378.1,Homo_sapiens,5,BOD1,173609238,173616436,7198,-1
NP_085130.2,Homo_sapiens,5,CPEB4,173889733,173956137,66404,1
NP_001295118.1,Homo_sapiens,5,CPEB4,173889733,173956137,66404,1
NP_001295120.1,Homo_sapiens,5,CPEB4,173889733,173956137,66404,1
NP_001295121.1,Homo_sapiens,5,CPEB4,173910543,173956137,45594,1
NP_001295122.1,Homo_sapiens,5,CPEB4,173910543,173956137,45594,1
NP_001138426.1,Homo_sapiens,5,C5orf47,173989263,174001215,11952,1
NP_057064.1,Homo_sapiens,5,HMP19,174046755,174107505,60750,1
NP_002440.2,Homo_sapiens,5,MSX2,174724659,174729583,4924,1
NP_000785.1,Homo_sapiens,5,DRD1,175441758,175443099,1341,-1
NP_001309906.1,Homo_sapiens,5,SFXN1,175492103,175526734,34631,1
NP_073591.2,Homo_sapiens,5,SFXN1,175492103,175526734,34631,1
NP_001309909.1,Homo_sapiens,5,SFXN1,175492103,175526679,34576,1
NP_001309910.1,Homo_sapiens,5,SFXN1,175492103,175526679,34576,1
NP_001309912.1,Homo_sapiens,5,SFXN1,175492103,175513595,21492,1
NP_001309907.1,Homo_sapiens,5,SFXN1,175492257,175526734,34477,1
NP_001309911.1,Homo_sapiens,5,SFXN1,175492257,175526734,34477,1
NP_001124527.1,Homo_sapiens,5,HRH2,175683233,175685526,2293,1
NP_071640.1,Homo_sapiens,5,HRH2,175683233,175684313,1080,1
NP_001008221.1,Homo_sapiens,5,CPLX2,175878739,175880045,1306,1
NP_006641.1,Homo_sapiens,5,CPLX2,175878739,175880045,1306,1
NP_115737.1,Homo_sapiens,5,THOC3,175959968,175968208,8240,-1
XP_011533011.1,Homo_sapiens,5,LOC105377746,176034233,176035127,894,1
NP_001252544.1,Homo_sapiens,5,FAM153B,176089518,176114049,24531,1
NP_001295124.1,Homo_sapiens,5,SIMC1,176238508,176345445,106937,1
NP_940969.3,Homo_sapiens,5,SIMC1,176238508,176345445,106937,1
NP_001295125.1,Homo_sapiens,5,SIMC1,176263430,176345445,82015,1
NP_001295129.1,Homo_sapiens,5,SIMC1,176313424,176345445,32021,1
NP_001073153.1,Homo_sapiens,5,KIAA1191,176347599,176359508,11909,-1
NP_065177.2,Homo_sapiens,5,KIAA1191,176347599,176359508,11909,-1
NP_001073152.1,Homo_sapiens,5,KIAA1191,176347599,176355720,8121,-1
NP_001274265.1,Homo_sapiens,5,KIAA1191,176347599,176355720,8121,-1
NP_001274264.1,Homo_sapiens,5,KIAA1191,176347599,176352712,5113,-1
NP_775935.1,Homo_sapiens,5,ARL10,176365563,176371895,6332,1
NP_001304877.1,Homo_sapiens,5,ARL10,176365563,176369252,3689,1
NP_001243469.2,Homo_sapiens,5,NOP16,176383980,176388539,4559,-1
NP_001243468.2,Homo_sapiens,5,NOP16,176383980,176388539,4559,-1
NP_001278234.1,Homo_sapiens,5,NOP16,176383980,176388466,4486,-1
NP_001278236.1,Homo_sapiens,5,NOP16,176384230,176388539,4309,-1
NP_057475.2,Homo_sapiens,5,NOP16,176384230,176388539,4309,-1
NP_001304904.1,Homo_sapiens,5,NOP16,176384230,176388435,4205,-1
NP_001278237.1,Homo_sapiens,5,NOP16,176385243,176388539,3296,-1
NP_620175.1,Homo_sapiens,5,HIGD2A,176388819,176389497,678,1
NP_001825.1,Homo_sapiens,5,CLTB,176392773,176416363,23590,-1
NP_009028.1,Homo_sapiens,5,CLTB,176392773,176416363,23590,-1
NP_055428.1,Homo_sapiens,5,FAF2,176448407,176506950,58543,1
NP_055716.1,Homo_sapiens,5,RNF44,176529027,176532472,3445,-1
NP_001165447.1,Homo_sapiens,5,CDHR2,176565352,176595672,30320,1
NP_060145.3,Homo_sapiens,5,CDHR2,176565352,176595672,30320,1
NP_443131.2,Homo_sapiens,5,GPRIN1,176596807,176599834,3027,-1
NP_001304963.1,Homo_sapiens,5,SNCB,176620810,176629654,8844,-1
NP_001304965.1,Homo_sapiens,5,SNCB,176620810,176629654,8844,-1
NP_001304964.1,Homo_sapiens,5,SNCB,176620810,176629654,8844,-1
NP_001304966.1,Homo_sapiens,5,SNCB,176620810,176629654,8844,-1
NP_003076.1,Homo_sapiens,5,SNCB,176620810,176629654,8844,-1
NP_001001502.1,Homo_sapiens,5,SNCB,176620810,176629654,8844,-1
NP_001092878.1,Homo_sapiens,5,EIF4E1B,176642787,176645980,3193,1
NP_036303.1,Homo_sapiens,5,TSPAN17,176647615,176657698,10083,1
NP_569732.2,Homo_sapiens,5,TSPAN17,176647615,176657698,10083,1
NP_001006617.2,Homo_sapiens,5,TSPAN17,176647615,176657532,9917,1
NP_588610.2,Homo_sapiens,5,UNC5A,176810750,176879886,69136,1
NP_002106.2,Homo_sapiens,5,HK3,176881072,176896159,15087,-1
NP_001304890.1,Homo_sapiens,5,UIMC1,176905281,176982615,77334,-1
NP_001186226.1,Homo_sapiens,5,UIMC1,176905281,176982615,77334,-1
NP_001186227.1,Homo_sapiens,5,UIMC1,176905281,176982615,77334,-1
NP_057374.3,Homo_sapiens,5,UIMC1,176905281,176982615,77334,-1
NP_001295148.1,Homo_sapiens,5,ZNF346,177022738,177079504,56766,1
NP_001295145.1,Homo_sapiens,5,ZNF346,177022738,177064757,42019,1
NP_001295142.1,Homo_sapiens,5,ZNF346,177022738,177064599,41861,1
NP_036411.1,Homo_sapiens,5,ZNF346,177022738,177064599,41861,1
NP_001295144.1,Homo_sapiens,5,ZNF346,177022738,177064599,41861,1
NP_001295143.1,Homo_sapiens,5,ZNF346,177022738,177064599,41861,1
NP_001295147.1,Homo_sapiens,5,ZNF346,177022738,177064599,41861,1
NP_001295150.1,Homo_sapiens,5,ZNF346,177022738,177064599,41861,1
NP_001295152.1,Homo_sapiens,5,ZNF346,177022738,177064599,41861,1
NP_002002.3,Homo_sapiens,5,FGFR4,177089602,177097676,8074,1
NP_998812.1,Homo_sapiens,5,FGFR4,177089602,177097676,8074,1
NP_001278909.1,Homo_sapiens,5,FGFR4,177089602,177097676,8074,1
NP_075252.2,Homo_sapiens,5,FGFR4,177089602,177097676,8074,1
NP_071900.2,Homo_sapiens,5,NSD1,177135103,177295459,160356,1
NP_758859.1,Homo_sapiens,5,NSD1,177135170,177295459,160289,1
NP_001026847.1,Homo_sapiens,5,RAB24,177301742,177303288,1546,-1
NP_570137.2,Homo_sapiens,5,RAB24,177301742,177303288,1546,-1
NP_037369.1,Homo_sapiens,5,PRELID1,177303985,177306570,2585,1
NP_001258757.1,Homo_sapiens,5,PRELID1,177303985,177306570,2585,1
NP_001136407.1,Homo_sapiens,5,MXD3,177307118,177311830,4712,-1
NP_112590.1,Homo_sapiens,5,MXD3,177307587,177311830,4243,-1
NP_006807.1,Homo_sapiens,5,LMAN2,177332085,177351647,19562,-1
NP_006471.2,Homo_sapiens,5,RGS14,177358024,177372075,14051,1
NP_003043.3,Homo_sapiens,5,SLC34A1,177385741,177398286,12545,1
NP_001161051.1,Homo_sapiens,5,SLC34A1,177385741,177389725,3984,1
NP_001025057.1,Homo_sapiens,5,PFN3,177400162,177400576,414,-1
NP_000496.2,Homo_sapiens,5,F12,177402291,177409527,7236,-1
NP_002073.2,Homo_sapiens,5,GRK6,177426845,177441827,14982,1
NP_001004106.1,Homo_sapiens,5,GRK6,177426845,177441790,14945,1
NP_001004105.1,Homo_sapiens,5,GRK6,177426845,177441250,14405,1
NP_085044.2,Homo_sapiens,5,PRR7,177455067,177456121,1054,1
NP_001167572.1,Homo_sapiens,5,PRR7,177455067,177456121,1054,1
NP_001167573.1,Homo_sapiens,5,PRR7,177455067,177456121,1054,1
NP_004386.2,Homo_sapiens,5,DBN1,177457432,177473521,16089,-1
NP_543157.1,Homo_sapiens,5,DBN1,177457432,177472210,14778,-1
NP_976227.1,Homo_sapiens,5,PDLIM7,177483643,177496512,12869,-1
NP_005442.2,Homo_sapiens,5,PDLIM7,177483643,177496512,12869,-1
NP_998801.1,Homo_sapiens,5,PDLIM7,177490496,177496512,6016,-1
NP_001138348.1,Homo_sapiens,5,DOK3,177503044,177509540,6496,-1
NP_001138347.1,Homo_sapiens,5,DOK3,177503044,177509540,6496,-1
NP_079148.2,Homo_sapiens,5,DOK3,177503982,177509852,5870,-1
NP_001295164.1,Homo_sapiens,5,DOK3,177503982,177509540,5558,-1
NP_001295165.1,Homo_sapiens,5,DOK3,177503982,177509540,5558,-1
NP_057306.2,Homo_sapiens,5,DDX41,177511790,177516945,5155,-1
NP_001308661.1,Homo_sapiens,5,DDX41,177511790,177515984,4194,-1
NP_001308759.1,Homo_sapiens,5,DDX41,177511790,177515984,4194,-1
NP_001177875.1,Homo_sapiens,5,FAM193B,177521974,177554458,32484,-1
NP_059980.2,Homo_sapiens,5,TMED9,177592214,177595416,3202,1
NP_009186.1,Homo_sapiens,5,B4GALT7,177600210,177609695,9485,1
NP_775934.3,Homo_sapiens,5,FAM153A,177724112,177748643,24531,-1
XP_016865626.1,Homo_sapiens,5,LOC105377752,177801234,177803643,2409,-1
NP_006252.3,Homo_sapiens,5,PROP1,177992708,177995933,3225,-1
NP_055926.1,Homo_sapiens,5,N4BP3,178119583,178122001,2418,1
NP_001275724.1,Homo_sapiens,5,RMND5B,178135212,178148032,12820,1
NP_073599.2,Homo_sapiens,5,RMND5B,178138119,178148032,9913,1
NP_001275723.1,Homo_sapiens,5,RMND5B,178138119,178148032,9913,1
NP_060308.1,Homo_sapiens,5,NHP2,178149712,178153817,4105,-1
NP_001030005.1,Homo_sapiens,5,NHP2,178149795,178153817,4022,-1
NP_112556.2,Homo_sapiens,5,HNRNPAB,178204837,178210623,5786,1
NP_004490.2,Homo_sapiens,5,HNRNPAB,178204837,178210623,5786,1
NP_699204.1,Homo_sapiens,5,PHYKPL,178211920,178232550,20630,-1
NP_001265275.1,Homo_sapiens,5,PHYKPL,178211920,178231459,19539,-1
NP_775736.2,Homo_sapiens,5,COL23A1,178238697,178590197,351500,-1
NP_065717.1,Homo_sapiens,5,CLK4,178603616,178623416,19800,-1
NP_005640.2,Homo_sapiens,5,ZNF354A,178712059,178729022,16963,-1
NP_001311268.1,Homo_sapiens,5,ZNF354A,178712059,178727032,14973,-1
NP_478137.1,Homo_sapiens,5,ZNF354B,178861047,178884291,23244,1
XP_016865629.1,Homo_sapiens,5,LOC107984119,178895770,178916650,20880,1
NP_085116.2,Homo_sapiens,5,ZFP2,178931313,178932699,1386,1
NP_001310235.1,Homo_sapiens,5,ZNF454,178942791,178965973,23182,1
NP_872400.2,Homo_sapiens,5,ZNF454,178942791,178965973,23182,1
NP_001171560.1,Homo_sapiens,5,ZNF454,178942791,178965973,23182,1
NP_001171561.1,Homo_sapiens,5,ZNF454,178942791,178965973,23182,1
NP_001310237.1,Homo_sapiens,5,ZNF454,178942791,178957165,14374,1
NP_001310238.1,Homo_sapiens,5,ZNF454,178942791,178957165,14374,1
NP_001310239.1,Homo_sapiens,5,ZNF454,178942791,178957165,14374,1
NP_001310236.1,Homo_sapiens,5,ZNF454,178942791,178957165,14374,1
NP_000834.2,Homo_sapiens,5,GRM6,178981656,178994944,13288,-1
NP_001129588.1,Homo_sapiens,5,ZNF879,179025004,179033640,8636,1
NP_055409.1,Homo_sapiens,5,ZNF354C,179062068,179080097,18029,1
NP_055059.2,Homo_sapiens,5,ADAMTS2,179113866,179345328,231462,-1
NP_067610.1,Homo_sapiens,5,ADAMTS2,179151128,179345328,194200,-1
NP_079434.3,Homo_sapiens,5,RUFY1,179550569,179609519,58950,1
NP_001035542.1,Homo_sapiens,5,RUFY1,179560038,179609519,49481,1
NP_001035541.1,Homo_sapiens,5,RUFY1,179560038,179609519,49481,1
NP_001244222.1,Homo_sapiens,5,HNRNPH1,179615545,179623133,7588,-1
NP_005511.1,Homo_sapiens,5,HNRNPH1,179615545,179623133,7588,-1
NP_001135778.1,Homo_sapiens,5,C5orf60,179642338,179645020,2682,-1
NP_001292317.1,Homo_sapiens,5,C5orf60,179642338,179645020,2682,-1
NP_001157916.1,Homo_sapiens,5,CBY3,179678582,179680918,2336,-1
NP_001737.1,Homo_sapiens,5,CANX,179705681,179728644,22963,1
NP_001019820.1,Homo_sapiens,5,CANX,179705681,179728644,22963,1
NP_055572.1,Homo_sapiens,5,MAML1,179733112,179774877,41765,1
NP_665874.1,Homo_sapiens,5,LTC4S,179794080,179796394,2314,1
NP_055090.1,Homo_sapiens,5,MGAT4B,179798044,179806583,8539,-1
NP_463459.1,Homo_sapiens,5,MGAT4B,179798044,179802111,4067,-1
NP_003891.1,Homo_sapiens,5,SQSTM1,179820936,179836593,15657,1
NP_001135770.1,Homo_sapiens,5,SQSTM1,179823004,179836593,13589,1
NP_001135771.1,Homo_sapiens,5,SQSTM1,179823004,179836593,13589,1
NP_001017987.1,Homo_sapiens,5,C5orf45,179837390,179858796,21406,-1
NP_057259.2,Homo_sapiens,5,C5orf45,179837390,179858796,21406,-1
NP_055858.2,Homo_sapiens,5,TBC1D9B,179863447,179907821,44374,-1
NP_942568.2,Homo_sapiens,5,TBC1D9B,179863447,179907821,44374,-1
NP_060904.2,Homo_sapiens,5,RNF130,179955653,180071702,116049,-1
NP_001267730.1,Homo_sapiens,5,RNF130,179955664,180071702,116038,-1
NP_778232.2,Homo_sapiens,5,RASGEF1C,180101500,180138052,36552,-1
NP_002743.3,Homo_sapiens,5,MAPK9,180236383,180280561,44178,-1
NP_620709.1,Homo_sapiens,5,MAPK9,180236383,180280561,44178,-1
NP_620707.1,Homo_sapiens,5,MAPK9,180236514,180280561,44047,-1
NP_620708.1,Homo_sapiens,5,MAPK9,180236514,180280561,44047,-1
NP_001128516.1,Homo_sapiens,5,MAPK9,180247397,180280561,33164,-1
NP_001295173.1,Homo_sapiens,5,MAPK9,180247699,180280561,32862,-1
NP_005101.1,Homo_sapiens,5,GFPT2,180301563,180353217,51654,-1
NP_001290170.1,Homo_sapiens,5,CNOT6,180529276,180574200,44924,1
NP_443095.2,Homo_sapiens,5,SCGB3A1,180590230,180591462,1232,-1
NP_891555.2,Homo_sapiens,5,FLT4,180603191,180649545,46354,-1
NP_002011.2,Homo_sapiens,5,FLT4,180608280,180649545,41265,-1
NP_001001657.1,Homo_sapiens,5,OR2Y1,180739122,180740058,936,-1
NP_002397.2,Homo_sapiens,5,MGAT1,180791633,180792971,1338,-1
NP_001108089.1,Homo_sapiens,5,MGAT1,180791633,180792971,1338,-1
NP_001108090.1,Homo_sapiens,5,MGAT1,180791633,180792971,1338,-1
NP_001108091.1,Homo_sapiens,5,MGAT1,180791633,180792971,1338,-1
NP_001108092.1,Homo_sapiens,5,MGAT1,180791633,180792971,1338,-1
NP_001166109.1,Homo_sapiens,5,ZFP62,180848791,180861219,12428,-1
NP_689496.4,Homo_sapiens,5,ZFP62,180848791,180851395,2604,-1
NP_001035552.1,Homo_sapiens,5,BTNL8,180899310,180950544,51234,1
NP_001153179.1,Homo_sapiens,5,BTNL8,180899310,180950544,51234,1
NP_079126.1,Homo_sapiens,5,BTNL8,180899310,180949955,50645,1
NP_001153180.1,Homo_sapiens,5,BTNL8,180899310,180949955,50645,1
NP_001153181.1,Homo_sapiens,5,BTNL8,180902374,180950544,48170,1
NP_001153182.1,Homo_sapiens,5,BTNL8,180911493,180950544,39051,1
NP_932079.1,Homo_sapiens,5,BTNL3,180989028,181005872,16844,1
NP_689760.2,Homo_sapiens,5,BTNL9,181045489,181059862,14373,1
NP_001295174.1,Homo_sapiens,5,BTNL9,181045489,181056617,11128,1
NP_001245212.1,Homo_sapiens,5,OR2V1,181124356,181125304,948,-1
NP_996763.1,Homo_sapiens,5,OR2V2,181154942,181155890,948,1
NP_976038.1,Homo_sapiens,5,TRIM7,181195165,181205110,9945,-1
NP_976042.1,Homo_sapiens,5,TRIM7,181195165,181200153,4988,-1
NP_976039.1,Homo_sapiens,5,TRIM7,181195165,181200075,4910,-1
NP_976040.1,Homo_sapiens,5,TRIM7,181195165,181200075,4910,-1
NP_976041.1,Homo_sapiens,5,TRIM7,181195165,181200075,4910,-1
NP_203128.1,Homo_sapiens,5,TRIM7,181203496,181205110,1614,-1
NP_963921.1,Homo_sapiens,5,TRIM41,181223999,181235379,11380,1
NP_291027.3,Homo_sapiens,5,TRIM41,181223999,181234775,10776,1
NP_006089.1,Homo_sapiens,5,RACK1,181236976,181243800,6824,-1
NP_116154.1,Homo_sapiens,5,TRIM52,181257413,181260813,3400,-1
NP_001005224.1,Homo_sapiens,5,OR4F3,181367286,181368225,939,1
NP_032138.3,Mus_musculus,13,Gdi2,3538298,3565142,26844,1
NP_598824.3,Mus_musculus,13,Fam208b,3566663,3599964,33301,-1
NP_840068.1,Mus_musculus,13,Asb13,3634132,3650307,16175,1
NP_001254653.1,Mus_musculus,13,Asb13,3634132,3650215,16083,1
NP_081692.1,Mus_musculus,13,Calml3,3803753,3804203,450,-1
NP_064420.2,Mus_musculus,13,Calm4,3837895,3838342,447,1
NP_001008706.1,Mus_musculus,13,Calm5,3854267,3854730,463,1
NP_062645.2,Mus_musculus,13,Net1,3884069,3918065,33996,-1
NP_001040624.1,Mus_musculus,13,Net1,3884069,3893385,9316,-1
NP_001029051.2,Mus_musculus,13,Tubal3,3924734,3933562,8828,1
NP_112540.2,Mus_musculus,13,Ucn3,3941155,3941650,495,-1
NP_598833.1,Mus_musculus,13,Akr1c14,4059631,4088990,29359,1
NP_598827.1,Mus_musculus,13,Akr1c18,4132793,4150598,17805,-1
NP_038806.2,Mus_musculus,13,Akr1c13,4191226,4205383,14157,1
NP_001013807.2,Mus_musculus,13,Akr1c19,4233770,4248120,14350,1
NP_038805.2,Mus_musculus,13,Akr1c12,4268387,4279356,10969,-1
NP_085114.1,Mus_musculus,13,Akr1c6,4434390,4457191,22801,1
NP_001298061.1,Mus_musculus,13,Akr1c20,4487182,4523314,36132,-1
NP_473421.1,Mus_musculus,13,Akr1c20,4507656,4523314,15658,-1
NP_084177.2,Mus_musculus,13,Akr1c21,4574148,4586380,12232,1
NP_061347.2,Mus_musculus,13,Akr1e1,4593255,4609123,15868,-1
NP_035933.2,Mus_musculus,13,Klf6,5861638,5867283,5645,1
NP_660113.1,Mus_musculus,13,Pitrm1,6548173,6579743,31570,1
NP_001278000.1,Mus_musculus,13,Pfkp,6581459,6648679,67220,-1
NP_062677.1,Mus_musculus,13,Pfkp,6581459,6648679,67220,-1
NP_443209.2,Mus_musculus,13,Adarb2,8203220,8757402,554182,1
NP_001276459.1,Mus_musculus,13,Adarb2,8203220,8757275,554055,1
NP_766033.1,Mus_musculus,13,Wdr37,8805814,8861225,55411,-1
NP_001034477.1,Mus_musculus,13,Wdr37,8805814,8861225,55411,-1
NP_001034478.1,Mus_musculus,13,Wdr37,8853552,8861225,7673,-1
NP_663335.2,Mus_musculus,13,Idi1,8885859,8890635,4776,1
NP_796171.1,Mus_musculus,13,Idi2,8956810,8959432,2622,1
NP_081276.2,Mus_musculus,13,Gtpbp4,8973121,8995996,22875,-1
NP_766173.1,Mus_musculus,13,Larp4b,9122145,9170942,48797,1
NP_001298046.1,Mus_musculus,13,Larp4b,9122145,9170942,48797,1
NP_001074895.2,Mus_musculus,13,Dip2c,9276981,9666030,389049,1
NP_653099.2,Mus_musculus,13,Zmynd11,9686861,9735447,48586,-1
NP_001186070.1,Mus_musculus,13,Zmynd11,9686861,9735447,48586,-1
NP_150372.1,Mus_musculus,13,Chrm3,9877228,9878998,1770,-1
NP_076357.2,Mus_musculus,13,Ryr2,11554515,12106446,551931,-1
NP_001074597.1,Mus_musculus,13,Mtr,12187004,12253973,66969,-1
NP_150371.4,Mus_musculus,13,Actn2,12269493,12340500,71007,-1
NP_659084.3,Mus_musculus,13,Heatr1,12395771,12438677,42906,1
NP_001185972.1,Mus_musculus,13,Lgals8,12440844,12459215,18371,-1
NP_061374.1,Mus_musculus,13,Lgals8,12440844,12459215,18371,-1
NP_001277984.1,Mus_musculus,13,Lgals8,12440844,12459215,18371,-1
NP_001277986.1,Mus_musculus,13,Lgals8,12440844,12454797,13953,-1
NP_001277989.1,Mus_musculus,13,Lgals8,12440844,12454797,13953,-1
NP_598398.3,Mus_musculus,13,Edaradd,12478182,12519948,41766,-1
NP_080460.2,Mus_musculus,13,Ero1lb,12566076,12606887,40811,1
NP_035248.2,Mus_musculus,13,Prl2c3,12790930,12800012,9082,-1
NP_112468.1,Mus_musculus,13,Prl2c2,12996234,13005326,9092,-1
NP_862900.1,Mus_musculus,13,Prl2c5,13182781,13191815,9034,1
NP_001298058.1,Mus_musculus,13,Prl2c5,13183004,13191815,8811,1
XP_006516887.1,Mus_musculus,13,Gm7040,13320937,13322532,1595,-1
NP_114388.2,Mus_musculus,13,Gpr137b,13359311,13393493,34182,-1
NP_035047.2,Mus_musculus,13,Nid1,13437701,13510067,72366,1
NP_034878.2,Mus_musculus,13,Lyst,13616553,13777179,160626,1
NP_034447.1,Mus_musculus,13,Gng4,13806071,13825375,19304,1
NP_001289926.1,Mus_musculus,13,Gng4,13806071,13825375,19304,1
NP_848755.1,Mus_musculus,13,B3galnt2,13954804,13997033,42229,1
NP_848027.1,Mus_musculus,13,Tbce,13998088,14029375,31287,-1
NP_034412.1,Mus_musculus,13,Ggps1,14053693,14057865,4172,-1
NP_919238.1,Mus_musculus,13,Arid4b,14064873,14197733,132860,1
NP_937755.1,Mus_musculus,13,Arid4b,14064873,14197733,132860,1
NP_001074817.3,Mus_musculus,13,Hecw1,14230648,14434460,203812,-1
NP_083547.1,Mus_musculus,13,Mrpl32,14610485,14613018,2533,-1
NP_032970.2,Mus_musculus,13,Psma2,14613274,14625465,12191,1
NP_598828.3,Mus_musculus,13,AW209491,14636563,14637829,1266,1
NP_001098116.1,Mus_musculus,13,AW209491,14636563,14637829,1266,1
NP_032156.2,Mus_musculus,13,Gli3,15478040,15726781,248741,1
NP_032406.1,Mus_musculus,13,Inhba,16017295,16027129,9834,1
NP_619595.3,Mus_musculus,13,Sugct,16857854,17694732,836878,-1
NP_079755.1,Mus_musculus,13,Mplkip,17695484,17697042,1558,1
NP_081394.1,Mus_musculus,13,Cdk13,17718060,17804651,86591,-1
NP_001074527.1,Mus_musculus,13,Cdk13,17718060,17804651,86591,-1
NP_062364.3,Mus_musculus,13,Rala,17882378,17897066,14688,-1
NP_080180.1,Mus_musculus,13,Yae1d1,17989379,17993306,3927,-1
NP_778171.2,Mus_musculus,13,Pou6f2,18125161,18382044,256883,-1
NP_742118.3,Mus_musculus,13,Vps41,18717315,18866200,148885,1
NP_001276475.1,Mus_musculus,13,Amph,18948432,19149843,201411,1
NP_778172.1,Mus_musculus,13,Amph,18948432,19149843,201411,1
NP_077232.2,Mus_musculus,13,Stard3nl,19358992,19376603,17611,-1
NP_598826.3,Mus_musculus,13,Epdr1,19593151,19619562,26411,-1
NP_057896.1,Mus_musculus,13,Sfrp4,19623432,19632379,8947,1
NP_001161381.1,Mus_musculus,13,Nme8,19645219,19697036,51817,-1
NP_853622.2,Mus_musculus,13,Nme8,19650753,19697036,46283,-1
NP_783619.2,Mus_musculus,13,A530099J19Rik,19728980,19729880,900,-1
NP_861419.3,Mus_musculus,13,Gpr141,19751685,19752603,918,-1
NP_525027.1,Mus_musculus,13,Elmo1,20185426,20605299,419873,1
NP_932761.1,Mus_musculus,13,Elmo1,20564426,20605299,40873,1
NP_036184.1,Mus_musculus,13,Aoah,20794393,21023337,228944,1
NP_001268783.1,Mus_musculus,13,Aoah,20794393,20851690,57297,1
NP_666746.1,Mus_musculus,13,Olfr1370,21072348,21073299,951,-1
NP_035114.1,Mus_musculus,13,Olfr263,21132776,21133730,954,1
NP_666745.1,Mus_musculus,13,Olfr1368,21142110,21143055,945,-1
NP_033080.2,Mus_musculus,13,Trim27,21180494,21192625,12131,1
NP_034473.2,Mus_musculus,13,Gpx5,21287365,21292660,5295,-1
NP_663426.2,Mus_musculus,13,Gpx6,21312257,21319083,6826,1
NP_666744.1,Mus_musculus,13,Olfr1367,21346929,21347880,951,1
NP_057893.2,Mus_musculus,13,Zscan12,21363649,21369513,5864,1
NP_076174.3,Mus_musculus,13,Zkscan3,21387798,21396516,8718,-1
NP_001139250.1,Mus_musculus,13,Zkscan3,21387798,21396516,8718,-1
NP_001012311.2,Mus_musculus,13,Pgbd1,21422774,21434485,11711,-1
NP_001156391.1,Mus_musculus,13,Pgbd1,21422774,21434485,11711,-1
NP_001156392.1,Mus_musculus,13,Pgbd1,21422774,21434485,11711,-1
NP_001013808.2,Mus_musculus,13,Zscan26,21444930,21449455,4525,-1
NP_079995.2,Mus_musculus,13,Nkapl,21467253,21468441,1188,-1
NP_001034204.1,Mus_musculus,13,Zkscan4,21479092,21484736,5644,1
NP_001238762.1,Mus_musculus,13,Zkscan8,21520000,21526938,6938,-1
NP_631880.2,Mus_musculus,13,Zkscan8,21520000,21526938,6938,-1
NP_001238763.1,Mus_musculus,13,Zkscan8,21526491,21526938,447,-1
NP_666395.2,Mus_musculus,13,Olfr1366,21537016,21538003,987,-1
NP_997455.1,Mus_musculus,13,Olfr1535,21555039,21556020,981,-1
NP_666751.2,Mus_musculus,13,Olfr1364,21573509,21574454,945,-1
NP_666955.2,Mus_musculus,13,Olfr1362,21611040,21611967,927,-1
NP_666753.2,Mus_musculus,13,Olfr11,21638579,21639521,942,-1
NP_666752.1,Mus_musculus,13,Olfr1361,21658367,21659321,954,-1
NP_666754.2,Mus_musculus,13,Olfr1360,21674000,21674942,942,-1
NP_001011820.1,Mus_musculus,13,Olfr1359,21703002,21703944,942,1
NP_835506.1,Mus_musculus,13,Hist1h2bl,21715762,21716143,381,-1
NP_835489.1,Mus_musculus,13,Hist1h2ai,21716421,21716814,393,1
NP_835513.1,Mus_musculus,13,Hist1h3h,21717658,21718069,411,1
NP_835507.1,Mus_musculus,13,Hist1h2bm,21722097,21722478,381,1
NP_835582.1,Mus_musculus,13,Hist1h4j,21735095,21735407,312,1
NP_835583.1,Mus_musculus,13,Hist1h4k,21750193,21750505,312,-1
NP_835490.1,Mus_musculus,13,Hist1h2ak,21753434,21753827,393,-1
NP_835508.1,Mus_musculus,13,Hist1h2bn,21754122,21754503,381,1
NP_064418.1,Mus_musculus,13,Hist1h1b,21779882,21780554,672,-1
NP_835514.1,Mus_musculus,13,Hist1h3i,21782959,21783370,411,-1
NP_835491.1,Mus_musculus,13,Hist1h2an,21786825,21787218,393,-1
NP_835509.2,Mus_musculus,13,Hist1h2bp,21787514,21789063,1549,1
NP_001277395.1,Mus_musculus,13,Hist1h2bp,21787514,21787895,381,1
NP_001091448.2,Mus_musculus,13,Hist1h2bq,21808099,21810171,2072,-1
NP_001300809.1,Mus_musculus,13,Hist1h2bq,21809790,21810171,381,-1
NP_001171015.1,Mus_musculus,13,Hist1h2ao,21810466,21810859,393,1
NP_001182350.1,Mus_musculus,13,Hist1h4m,21811783,21812095,312,1
NP_783588.1,Mus_musculus,13,Hist1h4n,21831846,21832158,312,-1
NP_835492.1,Mus_musculus,13,Hist1h2ap,21833082,21833475,393,-1
NP_001104025.1,Mus_musculus,13,Hist1h2br,21833770,21835842,2072,1
NP_001300807.1,Mus_musculus,13,Hist1h2br,21833770,21834151,381,1
NP_898835.1,Mus_musculus,13,Zfp184,21945792,21960339,14547,1
NP_001156401.1,Mus_musculus,13,Pom121l2,21981560,21988568,7008,1
NP_001156400.1,Mus_musculus,13,Pom121l2,21981560,21984479,2919,1
NP_062302.1,Mus_musculus,13,Prss16,22002753,22009697,6944,-1
NP_783590.1,Mus_musculus,13,Hist1h2ah,22035165,22035552,387,-1
NP_783596.1,Mus_musculus,13,Hist1h2bk,22035886,22036267,381,1
NP_783587.1,Mus_musculus,13,Hist1h4i,22041011,22041323,312,-1
NP_835493.1,Mus_musculus,13,Hist1h2ag,22042534,22042927,393,-1
NP_835505.1,Mus_musculus,13,Hist1h2bj,22043229,22043610,381,1
NP_665849.1,Mus_musculus,13,Vmn1r188,22087877,22088804,927,1
NP_665843.1,Mus_musculus,13,Vmn1r189,22101726,22102665,939,-1
NP_665848.1,Mus_musculus,13,Vmn1r191,22178685,22179582,897,-1
NP_665844.1,Mus_musculus,13,Vmn1r192,22187145,22188048,903,-1
NP_598986.1,Mus_musculus,13,Vmn1r193,22218860,22219820,960,-1
NP_001074441.1,Mus_musculus,13,Vmn1r194,22244214,22245105,891,1
NP_598984.2,Mus_musculus,13,Vmn1r195,22278361,22279312,951,1
NP_001161013.1,Mus_musculus,13,Vmn1r196,22293192,22294098,906,1
NP_599005.1,Mus_musculus,13,Vmn1r197,22327910,22328807,897,1
NP_598981.1,Mus_musculus,13,Vmn1r198,22354345,22355248,903,1
NP_598974.1,Mus_musculus,13,Vmn1r199,22382537,22383641,1104,1
NP_598973.1,Mus_musculus,13,Vmn1r200,22395028,22395967,939,1
NP_598972.2,Mus_musculus,13,Vmn1r-ps103,22441271,22442243,972,1
NP_598982.1,Mus_musculus,13,Vmn1r201,22474617,22475520,903,1
NP_598985.1,Mus_musculus,13,Vmn1r202,22501336,22502245,909,-1
NP_598997.1,Mus_musculus,13,Vmn1r203,22524050,22524986,936,1
NP_001039009.1,Mus_musculus,13,Vmn1r204,22556200,22557109,909,1
NP_598978.1,Mus_musculus,13,Vmn1r205,22591979,22592930,951,-1
NP_598977.1,Mus_musculus,13,Vmn1r206,22620096,22621035,939,-1
NP_001160181.1,Mus_musculus,13,Vmn1r207-ps,22725683,22726622,939,-1
NP_598979.1,Mus_musculus,13,Vmn1r208,22772398,22773325,927,-1
NP_001013809.1,Mus_musculus,13,Vmn1r209,22805579,22806518,939,-1
NP_598996.1,Mus_musculus,13,Vmn1r210,22827193,22828114,921,-1
NP_599004.1,Mus_musculus,13,Vmn1r211,22851598,22852495,897,-1
NP_599002.1,Mus_musculus,13,Vmn1r212,22883087,22884161,1074,-1
NP_598976.1,Mus_musculus,13,Vmn1r213,23011248,23012403,1155,1
NP_598975.1,Mus_musculus,13,Vmn1r214,23034337,23035441,1104,1
NP_598980.1,Mus_musculus,13,Vmn1r215,23075791,23076694,903,1
NP_599006.1,Mus_musculus,13,Vmn1r216,23099148,23100045,897,1
NP_599000.1,Mus_musculus,13,Vmn1r217,23113833,23114730,897,-1
NP_598983.1,Mus_musculus,13,Vmn1r218,23136484,23137381,897,1
NP_598999.1,Mus_musculus,13,Vmn1r219,23162642,23163581,939,1
NP_598998.1,Mus_musculus,13,Vmn1r220,23183627,23184524,897,-1
NP_001161014.1,Mus_musculus,13,Vmn1r221,23217372,23218311,939,1
NP_599001.1,Mus_musculus,13,Vmn1r222,23232114,23233041,927,-1
NP_001076780.1,Mus_musculus,13,Vmn1r223,23249237,23250323,1086,1
NP_001104577.1,Mus_musculus,13,Zfp322a,23356337,23357570,1233,-1
NP_766174.1,Mus_musculus,13,Zfp322a,23356337,23357570,1233,-1
NP_001273084.1,Mus_musculus,13,Zfp322a,23356337,23357570,1233,-1
NP_001273085.1,Mus_musculus,13,Zfp322a,23356337,23357570,1233,-1
NP_038952.1,Mus_musculus,13,Abt1,23421972,23423832,1860,-1
NP_038511.1,Mus_musculus,13,Btn1a1,23458702,23465180,6478,-1
NP_001276543.1,Mus_musculus,13,Btn2a2,23478233,23487917,9684,-1
NP_787952.2,Mus_musculus,13,Btn2a2,23478233,23487917,9684,-1
NP_001276544.1,Mus_musculus,13,Btn2a2,23478233,23487917,9684,-1
NP_694813.1,Mus_musculus,13,Hist1h4h,23531114,23531426,312,1
NP_783592.1,Mus_musculus,13,Hist1h2af,23533910,23534303,393,1
NP_659539.1,Mus_musculus,13,Hist1h3g,23535445,23535856,411,1
NP_835504.1,Mus_musculus,13,Hist1h2bh,23542971,23543352,381,-1
NP_038576.1,Mus_musculus,13,Hist1h3f,23544484,23544895,411,1
NP_783586.1,Mus_musculus,13,Hist1h4f,23551331,23551643,312,-1
NP_663759.3,Mus_musculus,13,Hist1h1d,23555089,23555755,666,1
NP_835512.1,Mus_musculus,13,Hist1h3e,23561954,23562365,411,-1
NP_835494.1,Mus_musculus,13,Hist1h2ae,23570715,23571108,393,-1
NP_835503.1,Mus_musculus,13,Hist1h2bg,23571432,23571813,381,1
NP_835502.1,Mus_musculus,13,Hist1h2bf,23573809,23574190,381,-1
NP_835495.1,Mus_musculus,13,Hist1h2ad,23574470,23574863,393,1
NP_835511.1,Mus_musculus,13,Hist1h3d,23575801,23576212,411,1
NP_783585.1,Mus_musculus,13,Hist1h4d,23581601,23581913,312,1
NP_001171124.1,Mus_musculus,13,Hist1h2be,23585575,23585956,381,-1
NP_835501.1,Mus_musculus,13,Hist1h2be,23585575,23585956,381,-1
NP_001277459.1,Mus_musculus,13,Hist1h2be,23585575,23585956,381,-1
NP_056602.1,Mus_musculus,13,Hist1h1e,23621837,23622497,660,-1
NP_835496.1,Mus_musculus,13,Hist1h2ac,23683524,23683917,393,-1
NP_001277309.1,Mus_musculus,13,Hist1h2bc,23684231,23684612,381,1
NP_075911.2,Mus_musculus,13,Hist1h2bc,23684231,23684612,381,1
NP_034507.2,Mus_musculus,13,Hist1h1t,23695865,23696495,630,1
NP_835515.1,Mus_musculus,13,Hist1h4c,23698137,23698449,312,-1
NP_034554.2,Mus_musculus,13,Hfe,23704385,23710714,6329,-1
NP_056601.1,Mus_musculus,13,Hist1h1c,23738848,23739487,639,1
NP_783584.1,Mus_musculus,13,Hist1h3c,23745086,23745497,411,-1
NP_783595.1,Mus_musculus,13,Hist1h2bb,23746794,23747175,381,1
NP_783591.2,Mus_musculus,13,Hist1h2ab,23751132,23751525,393,1
NP_835510.1,Mus_musculus,13,Hist1h3b,23752379,23752790,411,1
NP_835500.1,Mus_musculus,13,Hist1h4b,23757020,23757332,312,1
NP_835499.1,Mus_musculus,13,Hist1h4a,23760845,23761157,312,-1
NP_038578.2,Mus_musculus,13,Hist1h3a,23761942,23762353,411,-1
NP_085112.1,Mus_musculus,13,Hist1h1a,23763716,23764358,642,1
NP_001025106.1,Mus_musculus,13,Trim38,23782571,23791495,8924,1
NP_659085.1,Mus_musculus,13,Slc17a2,23810799,23822302,11503,1
NP_598830.2,Mus_musculus,13,Slc17a3,23842449,23858113,15664,1
NP_001158215.1,Mus_musculus,13,Slc17a3,23845353,23858113,12760,1
NP_001164109.1,Mus_musculus,13,Slc17a1,23872599,23892669,20070,1
NP_033224.3,Mus_musculus,13,Slc17a1,23872599,23892669,20070,1
NP_795990.2,Mus_musculus,13,Slc17a4,23898774,23908847,10073,-1
NP_783594.1,Mus_musculus,13,Hist1h2ba,23933772,23934156,384,-1
NP_783589.1,Mus_musculus,13,Hist1h2aa,23934461,23934851,390,1
NP_663374.1,Mus_musculus,13,Scgn,23953855,23991033,37178,-1
NP_081101.3,Mus_musculus,13,Lrrc16a,24013326,24280600,267274,-1
NP_001298051.1,Mus_musculus,13,Lrrc16a,24020051,24280600,260549,-1
NP_031743.3,Mus_musculus,13,Cmah,24416999,24468622,51623,1
NP_001104580.1,Mus_musculus,13,Cmah,24416999,24468622,51623,1
NP_001271448.1,Mus_musculus,13,Cmah,24416999,24468622,51623,1
NP_001271449.1,Mus_musculus,13,Cmah,24416999,24468622,51623,1
NP_848773.3,Mus_musculus,13,Fam65b,24614689,24704841,90152,1
NP_083955.1,Mus_musculus,13,Fam65b,24638887,24731685,92798,1
NP_001073850.1,Mus_musculus,13,Fam65b,24638887,24704841,65954,1
NP_001273029.1,Mus_musculus,13,Fam65b,24669985,24731685,61700,1
NP_001273030.1,Mus_musculus,13,Fam65b,24669985,24704841,34856,1
XP_011242665.1,Mus_musculus,13,1700016G14Rik,24741274,24746489,5215,1
NP_065592.1,Mus_musculus,13,Gmnn,24752068,24760210,8142,-1
NP_077793.1,Mus_musculus,13,BC005537,24803380,24812762,9382,1
NP_080066.1,Mus_musculus,13,Acot13,24818034,24831306,13272,-1
NP_062424.1,Mus_musculus,13,Tdp2,24831731,24841362,9631,1
NP_001074520.1,Mus_musculus,13,D130043K22Rik,24854500,24899799,45299,1
NP_766120.1,Mus_musculus,13,Aldh5a1,24911560,24937568,26008,-1
NP_032182.2,Mus_musculus,13,Gpld1,24943616,24990122,46506,1
NP_001013407.2,Mus_musculus,13,Mrs2,24993077,25020244,27167,-1
NP_808245.2,Mus_musculus,13,Dcdc2a,25056270,25205518,149248,1
NP_001182546.1,Mus_musculus,13,Dcdc2a,25056270,25120552,64282,1
NP_033539.1,Mus_musculus,13,Nrsn1,25253352,25262391,9039,-1
NP_032258.2,Mus_musculus,13,Hdgfl1,26769236,26770088,852,-1
NP_035294.2,Mus_musculus,13,Prl,27057623,27065050,7427,1
NP_001157002.1,Mus_musculus,13,Prl,27057623,27065050,7427,1
NP_001192251.1,Mus_musculus,13,Prl3d1,27094252,27100121,5869,1
NP_032890.2,Mus_musculus,13,Prl3d1,27094252,27100121,5869,1
NP_742167.1,Mus_musculus,13,Prl3d2,27121741,27127418,5677,1
NP_742168.1,Mus_musculus,13,Prl3d3,27156836,27162456,5620,1
NP_038794.1,Mus_musculus,13,Prl3c1,27196705,27203612,6907,1
NP_001156690.1,Mus_musculus,13,Prl3c1,27199352,27203612,4260,1
NP_032891.1,Mus_musculus,13,Prl3b1,27242488,27249532,7044,1
NP_080172.1,Mus_musculus,13,Prl3a1,27259644,27276218,16574,1
NP_035296.1,Mus_musculus,13,Prl6a1,27312664,27319115,6451,1
NP_034218.1,Mus_musculus,13,Prl8a2,27345736,27354064,8328,1
NP_001276848.1,Mus_musculus,13,Prl8a2,27345736,27354064,8328,1
NP_079808.1,Mus_musculus,13,Prl2b1,27383451,27390776,7325,-1
NP_035297.1,Mus_musculus,13,Prl8a6,27432982,27438588,5606,-1
NP_001258308.1,Mus_musculus,13,Prl8a6,27432982,27438588,5606,-1
NP_001258307.1,Mus_musculus,13,Prl8a6,27432982,27438588,5606,-1
NP_076230.1,Mus_musculus,13,Prl8a8,27507181,27513154,5973,-1
NP_001298054.1,Mus_musculus,13,Prl8a8,27507181,27513154,5973,-1
NP_001303650.1,Mus_musculus,13,Prl8a9,27558150,27564546,6396,-1
NP_075821.1,Mus_musculus,13,Prl8a9,27558150,27564546,6396,-1
NP_082753.1,Mus_musculus,13,Prl8a1,27574001,27582110,8109,-1
NP_083631.1,Mus_musculus,13,Prl7b1,27601927,27610522,8595,-1
NP_032956.1,Mus_musculus,13,Prl7a1,27633478,27642450,8972,-1
NP_001157530.1,Mus_musculus,13,Prl7a1,27633478,27642450,8972,-1
NP_035298.1,Mus_musculus,13,Prl7a2,27659056,27667994,8938,-1
NP_035250.1,Mus_musculus,13,Prl7d1,27709191,27716669,7478,-1
NP_080482.1,Mus_musculus,13,Prl7c1,27773699,27780749,7050,-1
NP_064375.1,Mus_musculus,13,Prl2a1,27801702,27808581,6879,1
NP_001038997.1,Mus_musculus,13,Prl2c1,27849401,27857683,8282,1
NP_035295.1,Mus_musculus,13,Prl4a1,28016272,28023428,7156,1
NP_076235.1,Mus_musculus,13,Prl5a1,28142542,28151302,8760,1
NP_033264.2,Mus_musculus,13,Sox4,28951698,28953021,1323,-1
NP_653119.1,Mus_musculus,13,Cdkal1,29326036,29850108,524072,-1
NP_001295415.1,Mus_musculus,13,Cdkal1,29804311,29850108,45797,-1
NP_034223.1,Mus_musculus,13,E2f3,29909902,29985668,75766,-1
NP_001276849.1,Mus_musculus,13,E2f3,29909902,29984145,74243,-1
NP_705774.1,Mus_musculus,13,Mboat1,30136666,30245469,108803,1
NP_796296.1,Mus_musculus,13,Agtr1a,30380953,30382033,1080,1
NP_079986.1,Mus_musculus,13,Uqcrfs1,30540730,30545247,4517,-1
NP_598829.1,Mus_musculus,13,Dusp22,30660125,30710752,50627,1
NP_001033044.1,Mus_musculus,13,Dusp22,30660125,30708859,48734,1
NP_038702.1,Mus_musculus,13,Irf4,30750579,30763667,13088,1
NP_079864.1,Mus_musculus,13,Exoc2,30815297,30940727,125430,-1
NP_694712.1,Mus_musculus,13,Hus1b,30946843,30947674,831,-1
NP_032265.3,Mus_musculus,13,Foxq1,31558916,31560119,1203,1
NP_034355.2,Mus_musculus,13,Foxf2,31626079,31630645,4566,1
NP_032618.2,Mus_musculus,13,Foxc1,31807207,31808869,1662,1
NP_666153.1,Mus_musculus,13,Gmds,31819915,32338483,518568,-1
NP_001159502.1,Mus_musculus,13,Mylk4,32708904,32781716,72812,-1
NP_084491.3,Mus_musculus,13,Wrnip1,32802237,32822159,19922,1
NP_079705.2,Mus_musculus,13,Serpinb1a,32842817,32850406,7589,-1
NP_766639.2,Mus_musculus,13,Serpinb1c,32881832,32897098,15266,-1
NP_035584.1,Mus_musculus,13,Serpinb6b,32968509,32978353,9844,1
NP_033282.1,Mus_musculus,13,Serpinb9,33006542,33015848,9306,1
NP_035582.1,Mus_musculus,13,Serpinb9b,33029461,33039960,10499,1
NP_766640.1,Mus_musculus,13,Serpinb1b,33085285,33093934,8649,1
NP_001157996.1,Mus_musculus,13,Serpinb9c,33149977,33159707,9730,-1
NP_035583.1,Mus_musculus,13,Serpinb9c,33149977,33157824,7847,-1
NP_035590.1,Mus_musculus,13,Serpinb9d,33194572,33203084,8512,1
NP_035586.1,Mus_musculus,13,Serpinb9e,33251585,33260132,8547,1
NP_899020.1,Mus_musculus,13,Serpinb9f,33325826,33334652,8826,1
XP_619089.4,Mus_musculus,13,Gm11397,33395770,33404567,8797,1
NP_035585.2,Mus_musculus,13,Serpinb9g,33486530,33495282,8752,1
NP_001070258.1,Mus_musculus,13,Serpinb6d,33664054,33671472,7418,1
NP_001287821.1,Mus_musculus,13,Serpinb6d,33664054,33671472,7418,1
NP_001039000.2,Mus_musculus,13,Serpinb6e,33832458,33841306,8848,-1
NP_683744.2,Mus_musculus,13,Serpinb6c,33879930,33899429,19499,-1
NP_001157589.1,Mus_musculus,13,Serpinb6a,33918040,33935679,17639,-1
NP_001157590.1,Mus_musculus,13,Serpinb6a,33918040,33931636,13596,-1
NP_001230121.1,Mus_musculus,13,Serpinb6a,33918040,33931636,13596,-1
NP_033280.1,Mus_musculus,13,Serpinb6a,33918040,33931636,13596,-1
NP_001156713.1,Mus_musculus,13,Nqo2,33968270,33985492,17222,1
NP_001156714.1,Mus_musculus,13,Nqo2,33968270,33985492,17222,1
NP_064678.1,Mus_musculus,13,Nqo2,33968270,33985492,17222,1
NP_001156711.1,Mus_musculus,13,Nqo2,33972436,33985492,13056,1
NP_033094.3,Mus_musculus,13,Ripk1,34009656,34032782,23126,1
NP_080788.1,Mus_musculus,13,Bphl,34037662,34073763,36101,1
NP_033476.1,Mus_musculus,13,Tubb2a,34074467,34077929,3462,-1
NP_076205.1,Mus_musculus,13,Tubb2b,34127470,34130233,2763,-1
NP_001094900.1,Mus_musculus,13,Psmg4,34163075,34178102,15027,1
NP_001103985.1,Mus_musculus,13,Psmg4,34163075,34178055,14980,1
NP_001028339.1,Mus_musculus,13,Slc22a23,34182953,34344797,161844,-1
NP_080107.3,Mus_musculus,13,Pxdc1,34628770,34652435,23665,-1
NP_620085.2,Mus_musculus,13,Fam50b,34746542,34747547,1005,1
NP_038858.2,Mus_musculus,13,Prpf4b,34875653,34901596,25943,1
NP_082243.1,Mus_musculus,13,Fam217a,34910241,34915716,5475,-1
NP_080026.2,Mus_musculus,13,4933417A18Rik,34924536,34952964,28428,1
NP_081223.1,Mus_musculus,13,Eci3,34946928,34960478,13550,-1
NP_001103801.1,Mus_musculus,13,Eci2,34977910,34994057,16147,-1
NP_035998.2,Mus_musculus,13,Eci2,34977910,34993175,15265,-1
NP_034011.1,Mus_musculus,13,Cdyl,35669945,35872670,202725,1
NP_001116858.1,Mus_musculus,13,Cdyl,35741864,35872670,130806,1
NP_666050.3,Mus_musculus,13,Rpp40,35896726,35906326,9600,-1
NP_083904.1,Mus_musculus,13,Ppp1r3g,35968598,35969642,1044,1
NP_958746.1,Mus_musculus,13,Lyrm4,35979838,36117160,137322,-1
NP_077236.1,Mus_musculus,13,Fars2,36204529,36537439,332910,1
NP_001034278.1,Mus_musculus,13,Fars2,36232205,36537439,305234,1
NP_705757.1,Mus_musculus,13,Nrn1,36726627,36734290,7663,-1
NP_001159863.1,Mus_musculus,13,F13a1,36868764,37047486,178722,-1
NP_083060.2,Mus_musculus,13,F13a1,36868764,37047486,178722,-1
NP_034875.1,Mus_musculus,13,Ly86,37345438,37418622,73184,1
NP_001171340.1,Mus_musculus,13,Rreb1,37893813,37949115,55302,1
NP_001171339.1,Mus_musculus,13,Rreb1,37893813,37932542,38729,1
NP_001034277.1,Mus_musculus,13,Rreb1,37893813,37932542,38729,1
NP_081106.1,Mus_musculus,13,Rreb1,37893813,37932542,38729,1
NP_080241.3,Mus_musculus,13,Ssr1,37979738,37994083,14345,-1
NP_082000.2,Mus_musculus,13,Cage1,38006088,38032472,26384,-1
NP_077204.2,Mus_musculus,13,Riok1,38037460,38060865,23405,1
NP_076331.2,Mus_musculus,13,Dsp,38151588,38197932,46344,1
NP_080658.2,Mus_musculus,13,Snrnp48,38204972,38226922,21950,1
NP_031582.1,Mus_musculus,13,Bmp6,38345932,38499068,153136,1
NP_663342.3,Mus_musculus,13,Txndc5,38501585,38528408,26823,-1
NP_001276528.1,Mus_musculus,13,Txndc5,38501585,38527676,26091,-1
NP_001276527.1,Mus_musculus,13,Txndc5,38501585,38523417,21832,-1
NP_620702.1,Mus_musculus,13,Bloc1s5,38603848,38635041,31193,-1
NP_079656.1,Mus_musculus,13,Eef1e1,38646169,38658993,12824,-1
NP_001163902.1,Mus_musculus,13,Slc35b3,38932765,38960657,27892,-1
NP_598821.1,Mus_musculus,13,Slc35b3,38932765,38955849,23084,-1
NP_001163901.1,Mus_musculus,13,Slc35b3,38932765,38955849,23084,-1
NP_742155.2,Mus_musculus,13,Ofcc1,40001888,40287983,286095,-1
NP_035677.2,Mus_musculus,13,Tfap2a,40717114,40733714,16600,-1
NP_001288603.1,Mus_musculus,13,Tfap2a,40717114,40733714,16600,-1
NP_001116420.1,Mus_musculus,13,Tfap2a,40717114,40730065,12951,-1
XP_017171142.1,Mus_musculus,13,Gm35160,40846732,40852426,5694,1
NP_076376.3,Mus_musculus,13,Gcnt2,40860354,40958342,97988,1
NP_032131.2,Mus_musculus,13,Gcnt2,40887366,40958342,70976,1
NP_573482.1,Mus_musculus,13,Gcnt2,40917882,40958342,40460,1
NP_080826.2,Mus_musculus,13,Pak1ip1,41001329,41012749,11420,1
NP_079663.1,Mus_musculus,13,Tmem14c,41017150,41022160,5010,1
NP_001139274.1,Mus_musculus,13,Mak,41026407,41070237,43830,-1
NP_032573.2,Mus_musculus,13,Mak,41026407,41070237,43830,-1
NP_001139275.1,Mus_musculus,13,Mak,41026407,41070237,43830,-1
NP_032130.2,Mus_musculus,13,Gcm2,41102756,41109954,7198,-1
NP_001311454.1,Mus_musculus,13,Sycp2l,41114418,41174351,59933,1
NP_062296.1,Mus_musculus,13,Elovl2,41185293,41220357,35064,-1
NP_001298050.1,Mus_musculus,13,Elovl2,41185293,41197150,11857,-1
NP_001129049.1,Mus_musculus,13,Smim13,41250238,41272756,22518,1
NP_001104794.1,Mus_musculus,13,Nedd9,41311660,41425872,114212,-1
NP_059492.3,Mus_musculus,13,Nedd9,41311660,41358864,47204,-1
NP_001157044.1,Mus_musculus,13,Tmem170b,41606215,41634586,28371,1
NP_808476.2,Mus_musculus,13,Gm5082,41656011,41656428,417,1
NP_001139350.1,Mus_musculus,13,Gm5082,41656011,41656428,417,1
NP_780626.1,Mus_musculus,13,Adtrp,41764757,41847447,82690,-1
NP_001139347.1,Mus_musculus,13,Adtrp,41764757,41828295,63538,-1
NP_031798.2,Mus_musculus,13,Hivep1,42055502,42184513,129011,1
NP_034234.1,Mus_musculus,13,Edn1,42301894,42306879,4985,1
NP_001289564.1,Mus_musculus,13,Phactr1,42682697,43135189,452492,1
NP_001005740.1,Mus_musculus,13,Phactr1,42709621,43135189,425568,1
NP_001289565.1,Mus_musculus,13,Phactr1,42956642,43135189,178547,1
NP_001005748.1,Mus_musculus,13,Phactr1,43122915,43135189,12274,1
NP_001239569.1,Mus_musculus,13,Tbc1d7,43151893,43169913,18020,-1
NP_080211.1,Mus_musculus,13,Tbc1d7,43151893,43169913,18020,-1
NP_001239568.1,Mus_musculus,13,Tbc1d7,43151893,43169913,18020,-1
NP_001028571.1,Mus_musculus,13,Gfod1,43200324,43303497,103173,-1
NP_849179.1,Mus_musculus,13,Sirt5,43370753,43394812,24059,1
NP_076043.2,Mus_musculus,13,Nol7,43398404,43401841,3437,1
NP_064314.2,Mus_musculus,13,Ranbp9,43403558,43480928,77370,-1
NP_001074528.1,Mus_musculus,13,Mcur1,43541673,43560126,18453,-1
NP_899027.1,Mus_musculus,13,Rnf182,43667974,43668718,744,1
NP_033986.1,Mus_musculus,13,Cd83,43785213,43801685,16472,1
NP_001276844.1,Mus_musculus,13,Cd83,43785213,43799688,14475,1
NP_068678.1,Mus_musculus,13,Jarid2,44731871,44919952,188081,1
NP_001191972.1,Mus_musculus,13,Jarid2,44731871,44919952,188081,1
NP_001191973.1,Mus_musculus,13,Jarid2,44731871,44919952,188081,1
NP_080048.2,Mus_musculus,13,Dtnbp1,44922206,45001972,79766,-1
NP_722484.2,Mus_musculus,13,Mylip,45389956,45410510,20554,1
NP_079784.1,Mus_musculus,13,Gmpr,45507656,45546053,38397,1
NP_001186233.1,Mus_musculus,13,Atxn1,45557054,45568417,11363,-1
NP_033150.2,Mus_musculus,13,Atxn1,45557054,45568417,11363,-1
NP_001186234.1,Mus_musculus,13,Atxn1,45557054,45568417,11363,-1
NP_001005422.1,Mus_musculus,13,Stmnd1,46273817,46299689,25872,1
NP_001074894.1,Mus_musculus,13,Rbm24,46419030,46429317,10287,1
NP_080332.1,Mus_musculus,13,Cap2,46525415,46648364,122949,1
NP_001028364.1,Mus_musculus,13,Fam8a1,46669585,46675656,6071,1
NP_786925.2,Mus_musculus,13,Nup153,46681157,46727473,46316,-1
NP_034747.2,Mus_musculus,13,Kif13a,46750605,46929621,179016,-1
NP_780549.1,Mus_musculus,13,Nhlrc1,47013573,47014779,1206,-1
NP_058065.2,Mus_musculus,13,Tpmt,47025364,47041523,16159,-1
NP_758466.1,Mus_musculus,13,Kdm1b,47047915,47082958,35043,1
NP_080176.2,Mus_musculus,13,Dek,47086067,47105728,19661,-1
NP_666154.3,Mus_musculus,13,Rnf144b,47207385,47244501,37116,1
NP_001164114.1,Mus_musculus,13,Rnf144b,47207385,47244501,37116,1
NP_112443.1,Mus_musculus,13,Id4,48261497,48262329,832,1
NP_001158048.1,Mus_musculus,13,Zfp169,48489201,48506939,17738,-1
NP_080726.3,Mus_musculus,13,Zfp169,48489453,48506939,17486,-1
NP_001158047.1,Mus_musculus,13,Zfp169,48489453,48506939,17486,-1
XP_001473814.1,Mus_musculus,13,A830005F24Rik,48514223,48514727,504,1
NP_997115.1,Mus_musculus,13,Ptpdc1,48579735,48606354,26619,-1
NP_001288710.1,Mus_musculus,13,Ptpdc1,48579735,48606354,26619,-1
NP_031552.2,Mus_musculus,13,Barx1,48663116,48665992,2876,1
NP_035208.2,Mus_musculus,13,Phf2,48803598,48870765,67167,-1
NP_001028440.2,Mus_musculus,13,Fam120a,48880795,48967828,87033,-1
NP_083637.2,Mus_musculus,13,Wnk2,49036479,49147232,110753,-1
NP_001277242.1,Mus_musculus,13,Wnk2,49036479,49147232,110753,-1
NP_001277240.1,Mus_musculus,13,Wnk2,49038873,49147232,108359,-1
NP_038638.1,Mus_musculus,13,Ninj1,49187562,49195048,7486,1
NP_081014.1,Mus_musculus,13,Card19,49203119,49215943,12824,-1
NP_082616.1,Mus_musculus,13,Susd3,49231135,49248470,17335,-1
NP_079767.2,Mus_musculus,13,Susd3,49231135,49248132,16997,-1
NP_056574.2,Mus_musculus,13,Fgd3,49263783,49296771,32988,-1
NP_084067.1,Mus_musculus,13,Bicd2,49341670,49384976,43306,1
NP_001034268.1,Mus_musculus,13,Bicd2,49341670,49383352,41682,1
NP_001034269.1,Mus_musculus,13,Bicd2,49341892,49384976,43084,1
NP_951011.1,Mus_musculus,13,Ippk,49421385,49461759,40374,1
NP_001263328.1,Mus_musculus,13,Ippk,49421710,49461759,40049,1
NP_079771.1,Mus_musculus,13,Cenpp,49464209,49652689,188480,-1
NP_001012324.1,Mus_musculus,13,Ecm2,49514822,49531431,16609,1
NP_079987.2,Mus_musculus,13,Aspn,49551663,49566631,14968,1
NP_001165952.1,Mus_musculus,13,Aspn,49551663,49566631,14968,1
NP_036180.1,Mus_musculus,13,Omd,49589475,49592387,2912,1
NP_032786.1,Mus_musculus,13,Ogn,49609183,49622983,13800,1
NP_001258326.1,Mus_musculus,13,Nol8,49653645,49678436,24791,1
NP_742012.2,Mus_musculus,13,Iars,49687392,49733741,46349,1
XP_011242736.2,Mus_musculus,13,Gm19334,49750605,49752536,1931,1
XP_006517059.1,Mus_musculus,13,Gm30302,49784899,49790200,5301,-1
XP_006517055.1,Mus_musculus,13,LOC102631805,49820662,49828950,8288,1
XP_006517056.1,Mus_musculus,13,LOC102631805,49820662,49828950,8288,1
XP_006517058.1,Mus_musculus,13,LOC102631805,49820662,49828950,8288,1
XP_011242732.1,Mus_musculus,13,LOC102631805,49820662,49828950,8288,1
XP_006517054.1,Mus_musculus,13,Gm8672,49858763,49864130,5367,-1
XP_017171148.1,Mus_musculus,13,Gm8674,49899188,49902212,3024,-1
XP_017171143.1,Mus_musculus,13,Gm19470,50162321,50163398,1077,-1
NP_001028610.1,Mus_musculus,13,Gm906,50245234,50250264,5030,-1
XP_006517068.1,Mus_musculus,13,Gm19536,50399484,50400423,939,-1
NP_780610.2,Mus_musculus,13,Fbxw17,50417897,50433406,15509,1
NP_001028572.1,Mus_musculus,13,Nutm2,50467400,50475103,7703,1
NP_001028942.1,Mus_musculus,13,Gm904,50643271,50645542,2271,1
NP_001231578.1,Mus_musculus,13,Gm8765,50698355,50703381,5026,1
XP_017171159.1,Mus_musculus,13,Gm8777,50885886,50891283,5397,1
NP_666155.1,Mus_musculus,13,Spin1,51123236,51149161,25925,1
NP_001269958.1,Mus_musculus,13,Spin1,51123236,51149161,25925,1
NP_001269957.1,Mus_musculus,13,Spin1,51123236,51149161,25925,1
NP_001269959.1,Mus_musculus,13,Spin1,51127947,51149161,21214,1
NP_035592.1,Mus_musculus,13,Spin1,51132826,51149161,16335,1
NP_083449.1,Mus_musculus,13,Nxnl2,51171322,51174793,3471,1
NP_034231.1,Mus_musculus,13,S1pr3,51418784,51419921,1137,1
NP_033193.2,Mus_musculus,13,Shc3,51431152,51567084,135932,-1
NP_079691.1,Mus_musculus,13,Cks2,51645412,51650389,4977,1
NP_083555.1,Mus_musculus,13,Secisbp2,51651784,51683381,31597,1
NP_001295377.1,Mus_musculus,13,Secisbp2,51654392,51683381,28989,1
NP_038688.2,Mus_musculus,13,Sema4d,51702608,51725329,22721,-1
NP_001268809.1,Mus_musculus,13,Sema4d,51702608,51725329,22721,-1
NP_035947.2,Mus_musculus,13,Gadd45g,51846779,51847979,1200,1
NP_001019645.1,Mus_musculus,13,Diras2,52507669,52508269,600,-1
NP_001185906.1,Mus_musculus,13,Syk,52610838,52645795,34957,1
NP_035648.2,Mus_musculus,13,Syk,52610838,52645795,34957,1
NP_057918.2,Mus_musculus,13,Auh,52835473,52929641,94168,-1
NP_059069.1,Mus_musculus,13,Nfil3,52967477,52968866,1389,-1
NP_038874.3,Mus_musculus,13,Ror2,53110219,53285877,175658,-1
NP_033295.2,Mus_musculus,13,Sptlc1,53333883,53377349,43466,-1
XP_011242734.1,Mus_musculus,13,Gm38564,53415983,53419007,3024,-1
NP_038629.2,Mus_musculus,13,Msx2,53468168,53472710,4542,-1
NP_034206.1,Mus_musculus,13,Drd1,54052852,54054193,1341,-1
NP_001278730.1,Mus_musculus,13,Drd1,54052852,54054193,1341,-1
NP_081600.1,Mus_musculus,13,Sfxn1,54085459,54106603,21144,1
NP_001010973.1,Mus_musculus,13,Hrh2,54214006,54221340,7334,1
NP_032312.2,Mus_musculus,13,Hrh2,54214006,54215083,1077,1
NP_034076.1,Mus_musculus,13,Cplx2,54378668,54379709,1041,1
NP_082873.2,Mus_musculus,13,Thoc3,54460073,54468807,8734,-1
NP_795961.3,Mus_musculus,13,Simc1,54503875,54550633,46758,1
NP_598558.1,Mus_musculus,13,4833439L19Rik,54552611,54564212,11601,-1
NP_001239574.1,Mus_musculus,13,4833439L19Rik,54552611,54561842,9231,-1
NP_001239575.1,Mus_musculus,13,4833439L19Rik,54552611,54561842,9231,-1
NP_001239576.1,Mus_musculus,13,4833439L19Rik,54552611,54559216,6605,-1
NP_001239577.1,Mus_musculus,13,4833439L19Rik,54552611,54552982,371,-1
NP_064352.2,Mus_musculus,13,Arl10,54575094,54580894,5800,1
NP_848720.1,Mus_musculus,13,Nop16,54585280,54589967,4687,-1
NP_080209.1,Mus_musculus,13,Higd2a,54590265,54590890,625,1
NP_083146.1,Mus_musculus,13,Cltb,54593870,54611264,17394,-1
NP_848484.2,Mus_musculus,13,Faf2,54621840,54661136,39296,1
NP_001139498.1,Mus_musculus,13,Rnf44,54681748,54684444,2696,-1
NP_001139497.1,Mus_musculus,13,Rnf44,54681748,54684444,2696,-1
NP_598825.2,Mus_musculus,13,Rnf44,54681748,54684014,2266,-1
NP_001139499.1,Mus_musculus,13,Rnf44,54681748,54684014,2266,-1
NP_001028536.2,Mus_musculus,13,Cdhr2,54712627,54736580,23953,1
NP_036144.2,Mus_musculus,13,Gprin1,54737660,54740459,2799,-1
NP_001303639.1,Mus_musculus,13,Gprin1,54737660,54740459,2799,-1
NP_291088.1,Mus_musculus,13,Sncb,54759508,54765683,6175,-1
NP_001273108.1,Mus_musculus,13,Eif4e1b,54784015,54787396,3381,1
NP_001273107.1,Mus_musculus,13,Eif4e1b,54784015,54787396,3381,1
NP_001273109.1,Mus_musculus,13,Eif4e1b,54784015,54786955,2940,1
NP_001028441.1,Mus_musculus,13,Eif4e1b,54784353,54787396,3043,1
NP_001034772.1,Mus_musculus,13,Eif4e1b,54784353,54786955,2602,1
NP_083117.2,Mus_musculus,13,Tspan17,54789594,54796222,6628,1
NP_694771.1,Mus_musculus,13,Unc5a,54949661,55004971,55310,1
NP_001298057.1,Mus_musculus,13,Unc5a,54949661,55004971,55310,1
NP_001193320.1,Mus_musculus,13,Hk3,55006170,55019423,13253,-1
NP_001193319.1,Mus_musculus,13,Hk3,55006170,55019423,13253,-1
NP_001028417.1,Mus_musculus,13,Hk3,55006170,55019423,13253,-1
NP_001193321.1,Mus_musculus,13,Hk3,55006170,55015060,8890,-1
NP_001280589.1,Mus_musculus,13,Uimc1,55028519,55093273,64754,-1
NP_035437.1,Mus_musculus,13,Uimc1,55028519,55093273,64754,-1
NP_036147.1,Mus_musculus,13,Zfp346,55105343,55132394,27051,1
XP_017171160.1,Mus_musculus,13,LOC108168084,55127775,55128183,408,-1
NP_032037.2,Mus_musculus,13,Fgfr4,55155489,55168175,12686,1
NP_032765.3,Mus_musculus,13,Nsd1,55213220,55313728,100508,1
NP_033026.1,Mus_musculus,13,Rab24,55320149,55321654,1505,-1
NP_079872.4,Mus_musculus,13,Prelid1,55322189,55324972,2783,1
NP_057871.2,Mus_musculus,13,Mxd3,55325782,55329667,3885,-1
NP_080104.2,Mus_musculus,13,Lman2,55346876,55362589,15713,-1
NP_058038.2,Mus_musculus,13,Rgs14,55369891,55384135,14244,1
NP_035522.2,Mus_musculus,13,Slc34a1,55400457,55413637,13180,1
NP_083579.1,Mus_musculus,13,Pfn3,55414752,55415166,414,-1
NP_067464.2,Mus_musculus,13,F12,55418098,55426768,8670,-1
NP_001033107.1,Mus_musculus,13,Grk6,55445508,55459874,14366,1
NP_001272993.1,Mus_musculus,13,Grk6,55445508,55459874,14366,1
NP_001106182.1,Mus_musculus,13,Grk6,55445508,55459837,14329,1
NP_001272994.1,Mus_musculus,13,Grk6,55445508,55459837,14329,1
NP_036068.2,Mus_musculus,13,Grk6,55445508,55459338,13830,1
NP_001272992.1,Mus_musculus,13,Grk6,55449351,55459874,10523,1
NP_001272995.1,Mus_musculus,13,Grk6,55452191,55459338,7147,1
NP_001025467.1,Mus_musculus,13,Prr7,55472024,55472990,966,1
NP_062787.2,Mus_musculus,13,Dbn1,55474222,55487948,13726,-1
NP_001170843.1,Mus_musculus,13,Dbn1,55474222,55487948,13726,-1
NP_001170842.1,Mus_musculus,13,Dbn1,55474222,55487948,13726,-1
NP_001107560.1,Mus_musculus,13,Pdlim7,55498647,55512407,13760,-1
NP_080407.3,Mus_musculus,13,Pdlim7,55507026,55512407,5381,-1
NP_001107559.1,Mus_musculus,13,Pdlim7,55507026,55512407,5381,-1
NP_038767.1,Mus_musculus,13,Dok3,55523421,55528514,5093,-1
NP_598820.2,Mus_musculus,13,Ddx41,55530594,55536507,5913,-1
NP_663357.2,Mus_musculus,13,Fam193b,55541624,55556096,14472,-1
NP_080487.2,Mus_musculus,13,Tmed9,55593173,55596990,3817,1
NP_666157.1,Mus_musculus,13,B4galt7,55600142,55609374,9232,1
NP_001298066.1,Mus_musculus,13,B4galt7,55600142,55609374,9232,1
NP_031622.2,Mus_musculus,13,Caml,55623090,55632000,8910,1
NP_001268984.1,Mus_musculus,13,Ddx46,55635178,55678831,43653,1
NP_851795.1,Mus_musculus,13,B230219D22Rik,55699075,55699642,567,1
NP_780359.2,Mus_musculus,13,Txndc15,55714777,55725863,11086,1
NP_082557.1,Mus_musculus,13,Pcbd2,55727372,55776700,49328,1
NP_001239416.1,Mus_musculus,13,Catsper3,55784661,55808919,24258,1
NP_084048.1,Mus_musculus,13,Catsper3,55784661,55808919,24258,1
NP_001239417.1,Mus_musculus,13,Catsper3,55784661,55808919,24258,1
NP_035227.1,Mus_musculus,13,Pitx1,55826068,55830940,4872,-1
NP_001152987.1,Mus_musculus,13,H2afy,56074226,56128448,54222,-1
NP_001152985.1,Mus_musculus,13,H2afy,56074226,56128448,54222,-1
NP_001152986.1,Mus_musculus,13,H2afy,56074226,56128448,54222,-1
NP_036145.1,Mus_musculus,13,H2afy,56074226,56128448,54222,-1
NP_666088.1,Mus_musculus,13,Tifab,56176184,56176628,444,-1
NP_001162086.1,Mus_musculus,13,Tifab,56176184,56176628,444,-1
NP_035026.1,Mus_musculus,13,Neurog1,56251197,56251932,735,-1
NP_062514.2,Mus_musculus,13,Cxcl14,56289791,56296173,6382,-1
NP_808477.2,Mus_musculus,13,Slc25a48,56438489,56470472,31983,1
NP_032399.1,Mus_musculus,13,Il9,56479362,56482231,2869,-1
NP_848789.2,Mus_musculus,13,Fbxl21,56526915,56537467,10552,1
NP_034832.2,Mus_musculus,13,Lect2,56542704,56548362,5658,-1
NP_033395.1,Mus_musculus,13,Tgfbi,56609646,56638757,29111,1
NP_001157513.1,Mus_musculus,13,Smad5,56723593,56737478,13885,1
NP_001157514.1,Mus_musculus,13,Smad5,56723593,56737478,13885,1
NP_032567.1,Mus_musculus,13,Smad5,56723593,56737478,13885,1
NP_001289301.1,Mus_musculus,13,Trpc7,56773763,56895494,121731,-1
NP_036165.1,Mus_musculus,13,Trpc7,56773763,56895494,121731,-1
NP_001289302.1,Mus_musculus,13,Trpc7,56773763,56822614,48851,-1
NP_001159937.1,Mus_musculus,13,Spock1,57423089,57907587,484498,-1
NP_001159936.1,Mus_musculus,13,Spock1,57423089,57907587,484498,-1
NP_001159935.1,Mus_musculus,13,Spock1,57429294,57907587,478293,-1
NP_001159938.1,Mus_musculus,13,Spock1,57429294,57907587,478293,-1
NP_033288.2,Mus_musculus,13,Spock1,57429294,57907587,478293,-1
NP_001182004.1,Mus_musculus,13,Klhl3,58005175,58102428,97253,-1
NP_084148.1,Mus_musculus,13,Hnrnpa0,58127395,58128313,918,-1
NP_932121.2,Mus_musculus,13,Idnk,58157686,58163775,6089,1
NP_001041525.1,Mus_musculus,13,Idnk,58157686,58163519,5833,1
NP_689420.1,Mus_musculus,13,Ubqln1,58177875,58215436,37561,-1
NP_081118.4,Mus_musculus,13,Ubqln1,58177875,58215436,37561,-1
NP_062806.1,Mus_musculus,13,Gkap1,58233610,58264157,30547,-1
NP_780423.2,Mus_musculus,13,Kif27,58287792,58354862,67070,-1
NP_081611.1,Mus_musculus,13,2210016F16Rik,58381779,58385154,3375,-1
NP_001288274.1,Mus_musculus,13,Hnrnpk,58392385,58400390,8005,-1
NP_079555.1,Mus_musculus,13,Hnrnpk,58392385,58400390,8005,-1
NP_001288273.1,Mus_musculus,13,Hnrnpk,58392442,58400390,7948,-1
NP_001288270.1,Mus_musculus,13,Hnrnpk,58392442,58400390,7948,-1
NP_001288269.1,Mus_musculus,13,Hnrnpk,58392442,58400390,7948,-1
NP_001288272.1,Mus_musculus,13,Hnrnpk,58392442,58400390,7948,-1
NP_083180.3,Mus_musculus,13,Rmi1,58407938,58409789,1851,1
NP_001161720.1,Mus_musculus,13,Rmi1,58407938,58409789,1851,1
NP_071712.3,Mus_musculus,13,Slc28a3,58555689,58610807,55118,-1
NP_001269890.1,Mus_musculus,13,Ntrk2,58808728,59128353,319625,1
NP_001020245.1,Mus_musculus,13,Ntrk2,58808728,59128353,319625,1
NP_032771.1,Mus_musculus,13,Ntrk2,58808728,58932060,123332,1
NP_075817.2,Mus_musculus,13,Agtpbp1,59450136,59544418,94282,-1
NP_001271148.1,Mus_musculus,13,Agtpbp1,59450136,59514200,64064,-1
NP_001271150.1,Mus_musculus,13,Agtpbp1,59454634,59544418,89784,-1
NP_001041473.1,Mus_musculus,13,Agtpbp1,59493811,59544418,50607,-1
NP_001271147.1,Mus_musculus,13,Agtpbp1,59493811,59544418,50607,-1
NP_084429.2,Mus_musculus,13,Naa35,59586157,59634477,48320,1
NP_001030294.1,Mus_musculus,13,Golm1,59637291,59665655,28364,-1
NP_081583.3,Mus_musculus,13,Golm1,59637291,59665655,28364,-1
NP_899113.1,Mus_musculus,13,4921517D22Rik,59689459,59691629,2170,-1
NP_082433.2,Mus_musculus,13,Spata31d1a,59700301,59706150,5849,-1
NP_001161065.1,Mus_musculus,13,Spata31d1b,59712314,59719125,6811,1
NP_808379.2,Mus_musculus,13,Spata31d1d,59725975,59731720,5745,-1
XP_017171161.1,Mus_musculus,13,LOC102638268,59741052,59744004,2952,-1
XP_017171162.1,Mus_musculus,13,LOC102638268,59741052,59744004,2952,-1
NP_081197.1,Mus_musculus,13,Isca1,59756854,59769704,12850,-1
NP_705766.3,Mus_musculus,13,Zcchc6,59778798,59822079,43281,-1
NP_032112.1,Mus_musculus,13,Gas1,60175786,60176941,1155,-1
NP_001272846.1,Mus_musculus,13,Dapk1,60602534,60762396,159862,1
NP_598823.1,Mus_musculus,13,Dapk1,60602534,60761867,159333,1
NP_083929.2,Mus_musculus,13,Dapk1,60602534,60761867,159333,1
NP_954599.2,Mus_musculus,13,BC051665,60782154,60785145,2991,-1
NP_081620.2,Mus_musculus,13,Ctsll3,60798499,60801415,2916,-1
NP_835199.1,Mus_musculus,13,4930486L24Rik,60842876,60854938,12062,-1
NP_031823.1,Mus_musculus,13,Ctla2b,60895710,60896714,1004,-1
NP_001139273.1,Mus_musculus,13,Ctla2b,60896014,60896714,700,-1
NP_080705.1,Mus_musculus,13,Tpbpb,60901554,60902635,1081,-1
NP_031822.2,Mus_musculus,13,Ctla2a,60935019,60936531,1512,-1
NP_001139271.1,Mus_musculus,13,Ctla2a,60935019,60936044,1025,-1
NP_033437.2,Mus_musculus,13,Tpbpa,60939605,60940688,1083,-1
NP_036137.1,Mus_musculus,13,Ctsj,61000476,61004550,4074,-1
NP_083912.2,Mus_musculus,13,Ctsq,61035294,61039552,4258,-1
NP_064680.1,Mus_musculus,13,Ctsr,61159475,61163230,3755,-1
NP_067420.1,Mus_musculus,13,Cts6,61195400,61202265,6865,-1
NP_062414.3,Mus_musculus,13,Cts8,61248153,61254081,5928,-1
NP_062412.1,Mus_musculus,13,Cts7,61352735,61357036,4301,-1
NP_071721.2,Mus_musculus,13,Ctsm,61536554,61540313,3759,-1
NP_081182.2,Mus_musculus,13,Cts3,61564905,61568820,3915,-1
NP_473433.2,Mus_musculus,13,Cts3,61564905,61568820,3915,-1
XP_017171149.1,Mus_musculus,13,LOC108168055,61630022,61636282,6260,1
NP_001034328.2,Mus_musculus,13,Zfp808,62130025,62173220,43195,1
NP_001156382.1,Mus_musculus,13,Gm3604,62368862,62383082,14220,-1
NP_849206.2,Mus_musculus,13,Zfp935,62454322,62466709,12387,-1
NP_001129968.1,Mus_musculus,13,Zfp935,62454870,62466709,11839,-1
NP_001156383.1,Mus_musculus,13,Zfp934,62517499,62558489,40990,-1
NP_780461.2,Mus_musculus,13,Zfp934,62517499,62520451,2952,-1
NP_001311335.1,Mus_musculus,13,6720489N17Rik,62605189,62624093,18904,-1
NP_775557.1,Mus_musculus,13,6720489N17Rik,62605189,62624040,18851,-1
NP_001242994.1,Mus_musculus,13,Gm5141,62773607,62785683,12076,-1
NP_032020.2,Mus_musculus,13,Fbp2,62837085,62858297,21212,-1
NP_062268.1,Mus_musculus,13,Fbp1,62864975,62888043,23068,-1
NP_001276853.1,Mus_musculus,13,2010111I01Rik,63015166,63298852,283686,1
NP_001276855.1,Mus_musculus,13,2010111I01Rik,63015166,63298852,283686,1
NP_032011.2,Mus_musculus,13,Fancc,63312665,63403006,90341,-1
NP_001036138.1,Mus_musculus,13,Fancc,63312665,63403006,90341,-1
NP_001269871.1,Mus_musculus,13,Fancc,63312665,63398136,85471,-1
NP_032983.1,Mus_musculus,13,Ptch1,63511532,63565520,53988,-1
NP_001013626.2,Mus_musculus,13,Ercc6l2,63815474,63899503,84029,1
NP_075996.2,Mus_musculus,13,Ercc6l2,63815474,63869184,53710,1
NP_032317.2,Mus_musculus,13,Hsd17b3,64058568,64089128,30560,-1
NP_001001321.2,Mus_musculus,13,Slc35d2,64097581,64129307,31726,-1
NP_780703.1,Mus_musculus,13,Zfp367,64135313,64152989,17676,-1
NP_064370.2,Mus_musculus,13,Habp4,64161985,64185329,23344,1
NP_766175.3,Mus_musculus,13,Cdc14b,64205302,64274750,69448,-1
NP_001116461.1,Mus_musculus,13,Cdc14b,64205302,64248453,43151,-1
NP_079646.1,Mus_musculus,13,Aaed1,64292100,64312684,20584,-1
NP_034114.1,Mus_musculus,13,Ctsl,64364097,64369153,5056,-1
NP_444410.1,Mus_musculus,13,Cdk20,64432595,64438978,6383,1
NP_001182364.1,Mus_musculus,13,1190003K10Rik,64481763,64486000,4237,-1
NP_001074598.1,Mus_musculus,13,Cntnap3,64738546,64903840,165294,-1
NP_084323.2,Mus_musculus,13,Spata31,64917482,64923084,5602,1
NP_001077359.2,Mus_musculus,13,Spata31d1c,65033088,65037207,4119,1
NP_598441.3,Mus_musculus,13,Mfsd14b,65066612,65112617,46005,-1
NP_001077370.1,Mus_musculus,13,Mfsd14b,65066612,65112617,46005,-1
NP_667030.2,Mus_musculus,13,Olfr466,65152225,65153152,927,1
NP_780499.3,Mus_musculus,13,Nlrp4f,65181563,65199442,17879,-1
NP_848141.3,Mus_musculus,13,Zfp369,65278971,65297582,18611,1
XP_017171167.1,Mus_musculus,13,Gm7762,65337304,65348486,11182,-1
XP_006517561.2,Mus_musculus,13,Gm31714,65396979,65415024,18045,-1
XP_017171170.1,Mus_musculus,13,LOC102634499,65511861,65512932,1071,1
XP_017171151.1,Mus_musculus,13,Gm17353,65897274,65907988,10714,1
XP_017171171.1,Mus_musculus,13,LOC108168096,65950686,65958927,8241,1
NP_001171303.1,Mus_musculus,13,Gm10324,66113557,66122836,9279,1
XP_017171144.1,Mus_musculus,13,LOC108167370,66156615,66164048,7433,1
XP_017171152.1,Mus_musculus,13,LOC105245577,66227147,66236670,9523,-1
XP_017171172.1,Mus_musculus,13,LOC108168097,66281715,66284053,2338,-1
NP_898942.1,Mus_musculus,13,2410141K09Rik,66418244,66441022,22778,-1
NP_001277125.1,Mus_musculus,13,2410141K09Rik,66431027,66441022,9995,-1
XP_017171173.1,Mus_musculus,13,LOC108168098,66527952,66529383,1431,1
XP_017171174.1,Mus_musculus,13,LOC108167371,66589282,66598489,9207,1
XP_017171188.1,Mus_musculus,13,LOC105245578,66792582,66802467,9885,-1
XP_017171189.1,Mus_musculus,13,Gm10323,66850721,66862027,11306,-1
NP_080495.1,Mus_musculus,13,Uqcrb,66900748,66905311,4563,-1
NP_001171221.1,Mus_musculus,13,Gm10767,66907944,66908256,312,1
NP_079823.2,Mus_musculus,13,Mterf3,66912183,66930203,18020,-1
NP_032985.2,Mus_musculus,13,Ptdss1,66933507,66997077,63570,1
NP_001159690.1,Mus_musculus,13,Zfp712,67040343,67061068,20725,-1
NP_001012451.2,Mus_musculus,13,Zfp708,67070167,67097834,27667,-1
NP_001012325.2,Mus_musculus,13,Zfp708,67070167,67097834,27667,-1
NP_001012450.2,Mus_musculus,13,Zfp708,67070167,67081455,11288,-1
NP_001278995.1,Mus_musculus,13,Zfp708,67070167,67074866,4699,-1
NP_001242981.1,Mus_musculus,13,Rslcan18,67098163,67113981,15818,-1
NP_765980.3,Mus_musculus,13,Zfp759,67128308,67140552,12244,1
NP_001013791.1,Mus_musculus,13,Rsl1,67173217,67182947,9730,1
NP_001041669.1,Mus_musculus,13,Zfp455,67194588,67208055,13467,1
NP_001001152.1,Mus_musculus,13,Zfp458,67256114,67269036,12922,-1
NP_001003666.2,Mus_musculus,13,Zfp457,67292565,67306355,13790,-1
NP_808290.1,Mus_musculus,13,Zfp595,67316328,67332472,16144,-1
NP_001033740.1,Mus_musculus,13,Zfp953,67342971,67360509,17538,-1
NP_001001186.3,Mus_musculus,13,Zfp456,67366208,67372874,6666,-1
NP_001074410.1,Mus_musculus,13,Zfp429,67389865,67399731,9866,-1
NP_808479.1,Mus_musculus,13,Zfp459,67408158,67413957,5799,-1
NP_808380.1,Mus_musculus,13,Zfp874a,67442219,67451517,9298,-1
NP_001070259.1,Mus_musculus,13,Zfp874b,67473833,67484146,10313,-1
NP_001007576.1,Mus_musculus,13,Zfp58,67490900,67494726,3826,-1
NP_573491.2,Mus_musculus,13,Zfp87,67516718,67526082,9364,-1
NP_001030308.1,Mus_musculus,13,Zfp748,67540472,67553036,12564,-1
NP_001156718.1,Mus_musculus,13,Zfp729b,67591006,67609578,18572,-1
NP_898969.2,Mus_musculus,13,Zfp729a,67619186,67637682,18496,-1
NP_001001187.2,Mus_musculus,13,Zfp738,67669488,67683438,13950,-1
NP_663597.1,Mus_musculus,13,Zfp65,67707985,67729066,21081,-1
NP_001001130.1,Mus_musculus,13,Zfp85,67748529,67755068,6539,-1
NP_082678.2,Mus_musculus,13,Zfp493,67779813,67787084,7271,1
NP_938081.2,Mus_musculus,13,Zfp273,67813890,67826260,12370,1
NP_001296303.1,Mus_musculus,13,Gm10037,67833234,67843070,9836,1
NP_001296302.1,Mus_musculus,13,Gm10037,67833234,67843070,9836,1
NP_001001185.1,Mus_musculus,13,BC048507,67863505,67863775,270,1
XP_017171175.1,Mus_musculus,13,Gm40991,67885468,67889709,4241,-1
XP_987269.2,Mus_musculus,13,Gm7969,67951818,67952544,726,1
XP_017171145.1,Mus_musculus,13,LOC108168045,68444522,68447939,3417,-1
NP_766068.1,Mus_musculus,13,Mtrr,68562287,68580679,18392,-1
NP_001295404.1,Mus_musculus,13,Mtrr,68562287,68580679,18392,-1
NP_081399.3,Mus_musculus,13,Fastkd3,68583561,68592029,8468,1
NP_081311.1,Mus_musculus,13,1700001L19Rik,68597475,68613009,15534,1
NP_705762.2,Mus_musculus,13,Adcy2,68620719,68999295,378576,-1
NP_001162602.1,Mus_musculus,13,Papd7,69499915,69515869,15954,-1
NP_941002.2,Mus_musculus,13,Papd7,69499915,69515869,15954,-1
XP_011242908.2,Mus_musculus,13,LOC105245580,69534560,69535196,636,1
NP_780492.2,Mus_musculus,13,Srd5a1,69575129,69611247,36118,-1
NP_663329.3,Mus_musculus,13,Nsun2,69612092,69633851,21759,1
NP_001138634.1,Mus_musculus,13,Ube2ql1,69704041,69739340,35299,-1
NP_613062.1,Mus_musculus,13,Med10,69809930,69815689,5759,1
NP_659086.2,Mus_musculus,13,Ice1,70589600,70637597,47997,-1
NP_742050.2,Mus_musculus,13,Adamts16,70728851,70841549,112698,-1
NP_084149.1,Mus_musculus,13,8030423J24Rik,70883475,70884239,764,1
NP_034703.2,Mus_musculus,13,Irx1,71958615,71963488,4873,-1
NP_034704.1,Mus_musculus,13,Irx2,72629061,72632638,3577,1
NP_061373.1,Mus_musculus,13,Irx4,73264934,73269034,4100,1
NP_035018.1,Mus_musculus,13,Ndufs6,73319994,73328446,8452,-1
NP_444393.1,Mus_musculus,13,Mrpl36,73331372,73331681,309,1
NP_663351.3,Mus_musculus,13,Lpcat1,73467382,73514538,47156,1
NP_034150.1,Mus_musculus,13,Slc6a3,73538515,73577233,38718,1
NP_666159.2,Mus_musculus,13,Clptm1l,73604237,73620117,15880,1
NP_033380.1,Mus_musculus,13,Tert,73627029,73649013,21984,1
NP_001129559.1,Mus_musculus,13,Slc6a18,73664121,73677929,13808,-1
NP_001162117.1,Mus_musculus,13,Slc6a18,73664121,73677929,13808,-1
NP_001035782.1,Mus_musculus,13,Slc6a18,73664121,73677929,13808,-1
NP_001162116.1,Mus_musculus,13,Slc6a18,73664147,73677929,13782,-1
NP_001162114.1,Mus_musculus,13,Slc6a18,73664147,73677929,13782,-1
NP_001162115.1,Mus_musculus,13,Slc6a18,73664147,73677929,13782,-1
NP_083154.1,Mus_musculus,13,Slc6a19,73681628,73700633,19005,-1
NP_082056.1,Mus_musculus,13,Slc6a19os,73700035,73708960,8925,1
NP_035520.1,Mus_musculus,13,Slc12a7,73763766,73814934,51168,1
NP_082462.3,Mus_musculus,13,Nkd2,73820959,73847427,26468,-1
NP_081458.1,Mus_musculus,13,Trip13,73913243,73937581,24338,-1
NP_001019679.2,Mus_musculus,13,Brd9,73937893,73960338,22445,1
NP_001294970.1,Mus_musculus,13,Brd9,73937893,73960338,22445,1
NP_081980.1,Mus_musculus,13,Zdhhc11,73963920,73992642,28722,1
NP_878259.1,Mus_musculus,13,Tppp,74021142,74031415,10273,1
NP_083235.3,Mus_musculus,13,Cep72,74038162,74062262,24100,-1
NP_001074529.1,Mus_musculus,13,Slc9a3,74121514,74166064,44550,1
NP_796307.2,Mus_musculus,13,Exoc3,74172072,74207080,35008,-1
NP_033774.1,Mus_musculus,13,Ahrr,74213656,74283101,69445,-1
NP_001304280.1,Mus_musculus,13,Ahrr,74213656,74229938,16282,-1
NP_035181.1,Mus_musculus,13,Pdcd6,74303949,74317207,13258,-1
NP_075770.1,Mus_musculus,13,Sdha,74323086,74350208,27122,-1
NP_001162129.1,Mus_musculus,13,Ccdc127,74352865,74360613,7748,1
NP_077163.1,Mus_musculus,13,Ccdc127,74352865,74357117,4252,1
NP_001162130.1,Mus_musculus,13,Ccdc127,74352865,74357117,4252,1
NP_001028214.1,Mus_musculus,13,Lrrc14b,74360753,74363959,3206,-1
NP_001075149.1,Mus_musculus,13,Zfp72,74371649,74376469,4820,-1
NP_666343.1,Mus_musculus,13,Zfp825,74480516,74493852,13336,-1
NP_109636.1,Mus_musculus,13,Erap1,74646223,74690729,44506,1
NP_001288082.1,Mus_musculus,13,Cast,74695898,74808510,112612,-1
NP_033947.1,Mus_musculus,13,Cast,74695898,74807848,111950,-1
NP_001288086.1,Mus_musculus,13,Cast,74695898,74754331,58433,-1
NP_001288085.1,Mus_musculus,13,Cast,74695898,74754331,58433,-1
NP_001288084.1,Mus_musculus,13,Cast,74695898,74754331,58433,-1
NP_001288089.1,Mus_musculus,13,Cast,74695898,74734177,38279,-1
NP_001288087.1,Mus_musculus,13,Cast,74695898,74734177,38279,-1
NP_001288110.1,Mus_musculus,13,Cast,74695898,74734177,38279,-1
NP_038656.1,Mus_musculus,13,Pcsk1,75090061,75132319,42258,1
NP_620403.2,Mus_musculus,13,Ell2,75707650,75770796,63146,1
NP_444338.2,Mus_musculus,13,Glrx,75839968,75847286,7318,1
NP_082769.1,Mus_musculus,13,Rhobtb3,75872345,75943532,71187,-1
NP_083619.1,Mus_musculus,13,Spata9,75967833,75998769,30936,1
NP_849247.3,Mus_musculus,13,Rfesd,76002824,76008285,5461,-1
NP_001124540.1,Mus_musculus,13,Rfesd,76002824,76008285,5461,-1
NP_001124541.1,Mus_musculus,13,Rfesd,76002824,76008285,5461,-1
NP_780704.1,Mus_musculus,13,Gpr150,76055540,76056824,1284,-1
NP_084123.2,Mus_musculus,13,Arsk,76062255,76098508,36253,-1
NP_001074821.1,Mus_musculus,13,Ttc37,76108193,76187674,79481,1
NP_084450.2,Mus_musculus,13,Mctp1,76641765,77029951,388186,1
NP_598832.3,Mus_musculus,13,Slf1,77043548,77126714,83166,-1
NP_001139148.1,Mus_musculus,13,2210408I21Rik,77174853,77612644,437791,1
NP_001074822.1,Mus_musculus,13,2210408I21Rik,77174853,77193228,18375,1
NP_612185.1,Mus_musculus,13,Fam172a,77742780,78163655,420875,1
NP_001156891.1,Mus_musculus,13,Fam172a,77759459,78163655,404196,1
NP_001156892.1,Mus_musculus,13,Fam172a,77759459,78163655,404196,1
NP_083591.1,Mus_musculus,13,Pou5f2,78024940,78025930,990,1
NP_034281.2,Mus_musculus,13,Nr2f1,78189732,78198573,8841,-1
NP_001036056.1,Mus_musculus,13,Arrdc3,80883649,80893426,9777,1
NP_473394.3,Mus_musculus,13,Adgrv1,81095382,81633028,537646,-1
NP_084533.1,Mus_musculus,13,Lysmd3,81665014,81669823,4809,1
NP_001074645.1,Mus_musculus,13,Polr3g,81676035,81699860,23825,-1
NP_082648.1,Mus_musculus,13,Mblac2,81711528,81750346,38818,1
NP_031710.1,Mus_musculus,13,Cetn3,81783340,81796697,13357,1
NP_001164008.1,Mus_musculus,13,Mef2c,83575676,83662631,86955,1
NP_079558.1,Mus_musculus,13,Mef2c,83575676,83662631,86955,1
NP_780396.2,Mus_musculus,13,Tmem161b,84222431,84294880,72449,1
NP_075732.1,Mus_musculus,13,Ccnh,85189535,85212778,23243,1
NP_663427.2,Mus_musculus,13,Rasa1,85216103,85288907,72804,-1
NP_031775.1,Mus_musculus,13,Cox7c,86045752,86046675,923,-1
NP_001033076.1,Mus_musculus,13,Edil3,88821981,89319820,497839,1
NP_034233.1,Mus_musculus,13,Edil3,88821981,89319820,497839,1
NP_038528.3,Mus_musculus,13,Hapln1,89584721,89608149,23428,1
NP_001127947.1,Mus_musculus,13,Vcan,89657230,89731528,74298,-1
NP_062262.2,Mus_musculus,13,Vcan,89657230,89731528,74298,-1
NP_001127946.1,Mus_musculus,13,Vcan,89657230,89731528,74298,-1
NP_001074718.1,Mus_musculus,13,Vcan,89657230,89731528,74298,-1
NP_766543.1,Mus_musculus,13,Vcan,89712139,89731528,19389,-1
NP_082288.1,Mus_musculus,13,Xrcc4,89849357,90071679,222322,-1
NP_079611.2,Mus_musculus,13,Tmem167,90089780,90104445,14665,1
NP_001139351.1,Mus_musculus,13,Atp6ap1l,90883550,90905292,21742,-1
NP_077137.1,Mus_musculus,13,Rps23,90923195,90924683,1488,1
NP_080046.3,Mus_musculus,13,Atg10,90936602,91208422,271820,-1
NP_077234.2,Mus_musculus,13,Ssbp2,91461186,91700695,239509,1
NP_077148.1,Mus_musculus,13,Ssbp2,91461186,91700695,239509,1
NP_083066.1,Mus_musculus,13,Acot12,91741530,91784780,43250,1
NP_663428.2,Mus_musculus,13,Zcchc9,91797135,91806134,8999,-1
NP_940807.1,Mus_musculus,13,Ckmt2,91853528,91865333,11805,-1
NP_033053.2,Mus_musculus,13,Rasgrf2,91884431,92131494,247063,-1
NP_001298049.1,Mus_musculus,13,Msh3,92212434,92354900,142466,-1
NP_034959.2,Mus_musculus,13,Msh3,92212434,92354900,142466,-1
NP_034179.1,Mus_musculus,13,Dhfr,92355258,92384803,29545,1
NP_780664.2,Mus_musculus,13,Ankrd34b,92438261,92439788,1527,1
NP_001157099.1,Mus_musculus,13,Fam151b,92450083,92483952,33869,-1
NP_775568.1,Mus_musculus,13,Zfyve16,92488461,92524299,35838,-1
NP_084513.3,Mus_musculus,13,Spz1,92574829,92575966,1137,-1
NP_766176.1,Mus_musculus,13,Serinc5,92611260,92708137,96877,1
NP_035712.1,Mus_musculus,13,Thbs4,92751750,92794673,42923,-1
NP_001156417.1,Mus_musculus,13,Mtx3,92844786,92852894,8108,1
NP_076310.2,Mus_musculus,13,Cmya5,93041313,93144506,103193,-1
NP_598666.1,Mus_musculus,13,Papd4,93147590,93186439,38849,-1
NP_671705.2,Mus_musculus,13,Homer1,93305297,93402229,96932,1
NP_001271118.1,Mus_musculus,13,Homer1,93305297,93402229,96932,1
NP_036112.1,Mus_musculus,13,Homer1,93305297,93356113,50816,1
NP_687036.1,Mus_musculus,13,Homer1,93308307,93402229,93922,1
NP_067285.2,Mus_musculus,13,Jmy,93439441,93499306,59865,-1
XP_889797.1,Mus_musculus,13,Gm6109,93448487,93448835,348,1
NP_057877.1,Mus_musculus,13,Bhmt,93617475,93637496,20021,-1
NP_075022.2,Mus_musculus,13,Bhmt2,93657062,93674270,17208,-1
NP_083048.1,Mus_musculus,13,Dmgdh,93674446,93752465,78019,1
NP_033842.3,Mus_musculus,13,Arsb,93771777,93940731,168954,1
NP_766177.1,Mus_musculus,13,Lhfpl2,94174223,94192101,17878,1
NP_083429.1,Mus_musculus,13,Scamp1,94203998,94285276,81278,-1
NP_033810.2,Mus_musculus,13,Ap3b1,94359103,94565758,206655,1
NP_033347.1,Mus_musculus,13,Tbca,94788949,94842730,53781,1
NP_035151.1,Mus_musculus,13,Otp,94875769,94883620,7851,1
NP_766178.2,Mus_musculus,13,Wdr41,94976538,95021825,45287,1
XP_017171185.1,Mus_musculus,13,LOC108168108,95012532,95013279,747,1
NP_758467.2,Mus_musculus,13,Pde8b,95026119,95250160,224041,-1
NP_001164140.1,Mus_musculus,13,Pde8b,95026119,95222813,196694,-1
NP_082382.1,Mus_musculus,13,Zbed3,95336069,95336756,687,1
NP_001289467.1,Mus_musculus,13,Zbed3,95336069,95336756,687,1
NP_001289468.1,Mus_musculus,13,Zbed3,95336069,95336756,687,1
NP_079906.2,Mus_musculus,13,Aggf1,95351501,95375058,23557,-1
NP_940800.1,Mus_musculus,13,Crhbp,95431936,95444680,12744,-1
NP_001074628.1,Mus_musculus,13,S100z,95477300,95478655,1355,-1
NP_032000.3,Mus_musculus,13,F2rl1,95513172,95525127,11955,-1
NP_034299.2,Mus_musculus,13,F2r,95603732,95618374,14642,-1
NP_081987.1,Mus_musculus,13,Iqgap2,95628006,95891709,263703,-1
NP_034300.3,Mus_musculus,13,F2rl2,95697063,95701558,4495,1
NP_083486.1,Mus_musculus,13,Sv2c,95961279,96088799,127520,-1
NP_080449.1,Mus_musculus,13,Poc5,96391597,96414619,23022,1
NP_001036179.1,Mus_musculus,13,Ankdd1b,96417838,96470948,53110,-1
NP_036178.1,Mus_musculus,13,Polk,96482169,96519160,36991,-1
NP_075909.1,Mus_musculus,13,Col4a3bp,96543163,96635877,92714,1
NP_001157694.1,Mus_musculus,13,Col4a3bp,96543163,96635877,92714,1
NP_032281.2,Mus_musculus,13,Hmgcr,96650578,96666685,16107,-1
XP_006517860.1,Mus_musculus,13,Ankrd31,96748531,96909641,161110,1
NP_001159537.1,Mus_musculus,13,Gcnt4,96946197,96947565,1368,1
NP_001271134.1,Mus_musculus,13,1700029F12Rik,97022450,97034265,11815,-1
NP_079861.1,Mus_musculus,13,1700029F12Rik,97022450,97034265,11815,-1
NP_001074246.1,Mus_musculus,13,1700029F12Rik,97022450,97034265,11815,-1
NP_001093928.1,Mus_musculus,13,Fam169a,97091820,97127038,35218,1
NP_001139517.1,Mus_musculus,13,Fam169a,97091820,97127038,35218,1
NP_067527.3,Mus_musculus,13,Nsa2,97131160,97137757,6597,-1
NP_001139515.1,Mus_musculus,13,Gfm2,97141947,97179051,37104,1
NP_796240.3,Mus_musculus,13,Gfm2,97141947,97175737,33790,1
NP_001258392.1,Mus_musculus,13,Gfm2,97141947,97175737,33790,1
NP_001258393.1,Mus_musculus,13,Gfm2,97141947,97175737,33790,1
NP_001258394.1,Mus_musculus,13,Gfm2,97141947,97175737,33790,1
NP_034552.1,Mus_musculus,13,Hexb,97176528,97198261,21733,-1
NP_031956.3,Mus_musculus,13,Enc1,97244983,97246753,1770,1
NP_036156.2,Mus_musculus,13,Arhgef28,97899646,98145584,245938,-1
NP_849249.1,Mus_musculus,13,Utp15,98249128,98260888,11760,-1
NP_001258318.1,Mus_musculus,13,Ankra2,98266246,98273966,7720,1
NP_075961.1,Mus_musculus,13,Ankra2,98266246,98273433,7187,1
NP_001258317.1,Mus_musculus,13,Ankra2,98266246,98272884,6638,1
NP_001258321.1,Mus_musculus,13,Ankra2,98268464,98273868,5404,1
NP_001258320.1,Mus_musculus,13,Ankra2,98268464,98273433,4969,1
NP_001258319.1,Mus_musculus,13,Ankra2,98268464,98272884,4420,1
XP_006517862.1,Mus_musculus,13,LOC102637808,98279905,98307092,27187,1
NP_663430.2,Mus_musculus,13,Btf3,98310154,98316750,6596,-1
NP_001164011.1,Mus_musculus,13,Btf3,98310154,98316298,6144,-1
NP_032268.2,Mus_musculus,13,Foxd1,98354619,98355990,1371,1
NP_080961.1,Mus_musculus,13,Tmem174,98636407,98637320,913,-1
NP_001020777.1,Mus_musculus,13,Tmem171,98686320,98692640,6320,-1
NP_766179.2,Mus_musculus,13,Fcho2,98725753,98815108,89355,-1
NP_848831.2,Mus_musculus,13,Tnpo1,98846455,98926265,79810,-1
NP_001041732.1,Mus_musculus,13,Tnpo1,98846455,98890781,44326,-1
NP_081340.1,Mus_musculus,13,1700024P04Rik,98984144,98984516,372,-1
XP_017171186.1,Mus_musculus,13,Gm41035,98988927,98990880,1953,-1
NP_001004149.1,Mus_musculus,13,Zfp366,99228332,99246571,18239,1
NP_081149.1,Mus_musculus,13,Ptcd2,99320168,99344669,24501,-1
NP_776118.2,Mus_musculus,13,Mrps27,99344802,99414978,70176,1
NP_032660.2,Mus_musculus,13,Map1b,99425805,99516487,90682,-1
NP_001074962.1,Mus_musculus,13,Cartpt,99898918,99900634,1716,-1
NP_038760.3,Mus_musculus,13,Cartpt,99898918,99900634,1716,-1
NP_084302.1,Mus_musculus,13,Mccc2,99948838,100015514,66676,-1
NP_001074530.1,Mus_musculus,13,Bdp1,100020278,100103838,83560,-1
NP_035483.1,Mus_musculus,13,Serf1,100108222,100114037,5815,1
NP_035550.1,Mus_musculus,13,Smn1,100124893,100135736,10843,1
NP_001239558.1,Mus_musculus,13,Smn1,100128331,100135736,7405,1
NP_035002.2,Mus_musculus,13,Naip2,100144358,100189398,45040,-1
NP_001119654.1,Mus_musculus,13,Naip2,100144358,100189398,45040,-1
NP_035000.2,Mus_musculus,13,Naip5,100212606,100246199,33593,-1
NP_035001.2,Mus_musculus,13,Naip6,100283548,100316551,33003,-1
NP_032696.2,Mus_musculus,13,Naip1,100408806,100444737,35931,-1
NP_071294.3,Mus_musculus,13,Gtf2h2,100468906,100490131,21225,-1
NP_032782.1,Mus_musculus,13,Ocln,100498813,100541117,42304,-1
NP_848497.2,Mus_musculus,13,Marveld2,100597288,100616910,19622,-1
NP_001033691.1,Mus_musculus,13,Marveld2,100597288,100612569,15281,-1
NP_035363.2,Mus_musculus,13,Rad17,100617643,100649719,32076,-1
NP_001037836.1,Mus_musculus,13,Rad17,100617643,100649719,32076,-1
NP_001269940.1,Mus_musculus,13,Rad17,100617643,100633910,16267,-1
NP_081868.1,Mus_musculus,13,Ak6,100651417,100666019,14602,1
NP_081415.1,Mus_musculus,13,Taf9,100655050,100655845,795,1
NP_001015889.1,Mus_musculus,13,Taf9,100655050,100655845,795,1
NP_898938.4,Mus_musculus,13,Ccdc125,100677913,100696419,18506,1
NP_001161858.1,Mus_musculus,13,Ccdc125,100677913,100696118,18205,1
NP_034004.2,Mus_musculus,13,Cdk7,100703477,100730839,27362,-1
NP_001177193.1,Mus_musculus,13,Mrps36,100736255,100744568,8313,-1
NP_079645.1,Mus_musculus,13,Mrps36,100736255,100744568,8313,-1
NP_068686.1,Mus_musculus,13,Cenph,100760101,100775802,15701,-1
NP_758505.2,Mus_musculus,13,Ccnb1,100779677,100786402,6725,-1
NP_075023.2,Mus_musculus,13,Slc30a5,100803290,100833177,29887,-1
NP_001070963.1,Mus_musculus,13,Pik3r1,101684879,101757659,72780,-1
NP_001020126.1,Mus_musculus,13,Pik3r1,101684879,101692288,7409,-1
NP_032559.2,Mus_musculus,13,Cd180,102693699,102706433,12734,1
NP_780380.2,Mus_musculus,13,Mast4,102735001,103334192,599191,-1
NP_766180.1,Mus_musculus,13,Srek1,103743563,103763953,20390,-1
NP_001276403.1,Mus_musculus,13,Erbb2ip,103820698,103886329,65631,-1
NP_001276402.1,Mus_musculus,13,Erbb2ip,103820698,103886329,65631,-1
NP_001276404.1,Mus_musculus,13,Erbb2ip,103820698,103886329,65631,-1
NP_001005868.1,Mus_musculus,13,Erbb2ip,103820698,103886329,65631,-1
XP_006517866.1,Mus_musculus,13,D130037M23Rik,103920289,103921822,1533,1
NP_083723.1,Mus_musculus,13,Nln,104024945,104109456,84511,-1
NP_659087.1,Mus_musculus,13,Sgtb,104111089,104139851,28762,1
NP_001087229.1,Mus_musculus,13,Trappc13,104144137,104178159,34022,-1
NP_001087228.1,Mus_musculus,13,Trappc13,104144137,104178159,34022,-1
NP_080155.3,Mus_musculus,13,Trappc13,104144137,104178159,34022,-1
NP_109656.1,Mus_musculus,13,Trim23,104181052,104201410,20358,1
NP_766395.2,Mus_musculus,13,Ppwd1,104205503,104228801,23298,-1
NP_068562.1,Mus_musculus,13,Cenpk,104229585,104249519,19934,1
NP_851406.1,Mus_musculus,13,Cenpk,104230762,104246671,15909,1
NP_001074489.1,Mus_musculus,13,Adamts6,104294727,104493704,198977,1
NP_080348.1,Mus_musculus,13,Cwc27,104631575,104816728,185153,-1
NP_080351.2,Mus_musculus,13,Srek1ip1,104817353,104837548,20195,1
NP_084260.1,Mus_musculus,13,Fam159b,104845935,104863713,17778,-1
NP_084155.2,Mus_musculus,13,Rgs7bp,104951490,105054214,102724,-1
NP_080027.1,Mus_musculus,13,4933425L06Rik,105082159,105121421,39262,1
NP_082210.1,Mus_musculus,13,Rnf180,105149351,105271039,121688,-1
NP_032334.2,Mus_musculus,13,Htr1a,105444253,105445519,1266,1
XP_017171187.1,Mus_musculus,13,Gm30411,106737946,106760764,22818,-1
NP_083941.2,Mus_musculus,13,Ipo11,106795630,106925150,129520,-1
NP_079723.1,Mus_musculus,13,Dimt1,106947204,106958697,11493,1
NP_001139251.1,Mus_musculus,13,Kif2a,106962138,107022075,59937,-1
NP_032468.2,Mus_musculus,13,Kif2a,106962138,106993925,31787,-1
NP_663431.2,Mus_musculus,13,Zswim6,107726434,107890049,163615,-1
NP_001041715.1,Mus_musculus,13,Smim15,108047461,108047686,225,1
NP_001120818.1,Mus_musculus,13,Ndufaf2,108052705,108158569,105864,-1
NP_082318.2,Mus_musculus,13,Ercc8,108158793,108194124,35331,1
NP_083277.3,Mus_musculus,13,Elovl7,108256734,108282681,25947,1
NP_848798.1,Mus_musculus,13,Depdc1b,108316421,108388702,72281,1
NP_035186.1,Mus_musculus,13,Pde4d,108860165,109951344,1091179,1
NP_076341.1,Mus_musculus,13,Rab3c,110061814,110280018,218204,-1
NP_808381.1,Mus_musculus,13,Gapt,110353653,110354127,474,-1
NP_690017.2,Mus_musculus,13,Plk2,110395176,110400224,5048,1
NP_780706.1,Mus_musculus,13,Actbl2,111255132,111256263,1131,1
NP_001116435.1,Mus_musculus,13,Gpbp1,111426492,111466913,40421,-1
NP_082763.3,Mus_musculus,13,Gpbp1,111426492,111466913,40421,-1
NP_766181.2,Mus_musculus,13,Mier3,111686345,111715141,28796,1
NP_036075.2,Mus_musculus,13,Map3k1,111748899,111808969,60070,-1
NP_084174.2,Mus_musculus,13,Ankrd55,112288927,112383579,94652,1
NP_001161876.1,Mus_musculus,13,Ankrd55,112288927,112356118,67191,1
NP_001161877.1,Mus_musculus,13,Ankrd55,112288927,112344228,55301,1
NP_001161875.1,Mus_musculus,13,Ankrd55,112318453,112383579,65126,1
NP_034690.3,Mus_musculus,13,Il6st,112475045,112504445,29400,1
NP_647460.2,Mus_musculus,13,Il31ra,112523902,112559202,35300,-1
NP_034159.1,Mus_musculus,13,Ddx4,112598944,112651403,52459,-1
NP_001139357.1,Mus_musculus,13,Ddx4,112598944,112651403,52459,-1
NP_848861.1,Mus_musculus,13,Slc38a9,112669621,112731664,62043,1
NP_032273.1,Mus_musculus,13,Plpp1,112801208,112867568,66360,1
NP_032929.1,Mus_musculus,13,Plpp1,112801208,112867568,66360,1
NP_082427.1,Mus_musculus,13,Skiv2l2,112867942,112927357,59415,-1
NP_766182.2,Mus_musculus,13,Dhx29,112927792,112969187,41395,1
NP_001074531.1,Mus_musculus,13,Ccno,112987897,112990057,2160,1
NP_001033003.1,Mus_musculus,13,Mcidas,112993871,112999184,5313,1
NP_001268416.1,Mus_musculus,13,Cdc20b,113035378,113091135,55757,1
NP_081403.1,Mus_musculus,13,Gpx8,113043135,113046375,3240,-1
NP_034500.1,Mus_musculus,13,Gzma,113093891,113100951,7060,-1
NP_032222.1,Mus_musculus,13,Gzmk,113171873,113180897,9024,-1
NP_076101.1,Mus_musculus,13,Esm1,113209842,113216740,6898,1
NP_570614.2,Mus_musculus,13,Snx18,113594608,113618395,23787,-1
NP_064344.1,Mus_musculus,13,Hspb3,113663027,113663492,465,-1
NP_766183.1,Mus_musculus,13,Arl15,113794648,114154856,360208,1
NP_035017.2,Mus_musculus,13,Ndufs4,114288762,114388056,99294,-1
NP_032072.1,Mus_musculus,13,Fst,114453422,114458586,5164,-1
NP_001288302.1,Mus_musculus,13,Fst,114453422,114458586,5164,-1
NP_001288304.1,Mus_musculus,13,Fst,114453803,114458586,4783,-1
NP_038854.2,Mus_musculus,13,Mocs2,114818305,114820928,2623,1
NP_001106845.1,Mus_musculus,13,Mocs2,114820848,114828357,7509,1
NP_001106846.1,Mus_musculus,13,Mocs2,114820848,114828357,7509,1
NP_032422.2,Mus_musculus,13,Itga2,114836484,114931933,95449,-1
NP_001028400.2,Mus_musculus,13,Itga1,114960089,115101531,141442,-1
NP_598819.2,Mus_musculus,13,Pelo,115088529,115089919,1390,-1
NP_067434.3,Mus_musculus,13,Isl1,116299479,116309422,9943,-1
NP_001074478.1,Mus_musculus,13,Parp8,116855189,117025470,170281,-1
NP_034460.3,Mus_musculus,13,Emb,117220848,117273062,52214,1
NP_034538.2,Mus_musculus,13,Hcn1,117602703,117976234,373531,1
NP_067531.1,Mus_musculus,13,Mrps30,118380352,118387234,6882,-1
NP_032028.1,Mus_musculus,13,Fgf10,118715383,118789316,73933,1
NP_001295435.1,Mus_musculus,13,Nnt,119336256,119404702,68446,-1
NP_663432.1,Mus_musculus,13,Paip1,119429132,119457081,27949,1
NP_001073318.1,Mus_musculus,13,Paip1,119430230,119457081,26851,1
NP_080403.4,Mus_musculus,13,4833420G17Rik,119466103,119485917,19814,1
NP_001107022.1,Mus_musculus,13,4833420G17Rik,119466103,119485917,19814,1
NP_001034333.2,Mus_musculus,13,Gm7120,119492634,119609527,116893,1
NP_001171137.1,Mus_musculus,13,Gm7120,119492634,119495470,2836,1
NP_064675.1,Mus_musculus,13,Ccl28,119623872,119651066,27194,1
NP_666054.2,Mus_musculus,13,Hmgcs1,119699673,119706478,6805,1
NP_001278368.1,Mus_musculus,13,Hmgcs1,119699673,119706478,6805,1
NP_780747.1,Mus_musculus,13,Nim1k,119712045,119727871,15826,-1
NP_082521.1,Mus_musculus,13,Zfp131,119766351,119790272,23921,-1
NP_001289477.1,Mus_musculus,13,Zfp131,119766351,119790272,23921,-1
NP_001289476.1,Mus_musculus,13,Zfp131,119766351,119790272,23921,-1
NP_001289478.1,Mus_musculus,13,Zfp131,119766351,119790272,23921,-1
NP_001289479.1,Mus_musculus,13,Zfp131,119766351,119790272,23921,-1
XP_017171146.1,Mus_musculus,13,LOC108168049,119790270,119791542,1272,1
NP_001001449.1,Mus_musculus,13,AF067063,119828166,119828658,492,-1
NP_061226.1,Mus_musculus,13,Tcstv1,119893578,119894094,516,-1
NP_001297561.1,Mus_musculus,13,LOC106029237,119912236,119912752,516,-1
NP_001028941.1,Mus_musculus,13,B020031M17Rik,119949546,119950068,522,-1
XP_011243021.1,Mus_musculus,13,Gm41080,119968136,119968666,530,1
XP_006517870.1,Mus_musculus,13,Gm36079,120026438,120027011,573,-1
NP_001289895.1,Mus_musculus,13,Gm21188,120034758,120035331,573,-1
NP_001034737.2,Mus_musculus,13,Gm20767,120154626,120155136,510,1
XP_011243019.1,Mus_musculus,13,Gm21818,120173183,120173696,513,1
NP_951015.1,Mus_musculus,13,AF067061,120263801,120264317,516,1
NP_001297556.1,Mus_musculus,13,AF067061,120263801,120264317,516,1
NP_001033014.1,Mus_musculus,13,BC147527,120308145,120308649,504,1
NP_705743.1,Mus_musculus,13,Tcstv3,120317566,120318076,510,1
